"run","tick","Name","RealizedConsumption","DomesticConsumption","ImportedQuantity","MinimumConsumption","MaximumConsumption","Iso3Code","AverageConsumption"
1,1.0,"Western Europe",2788009,2788009,0,2201059,3668432,"NLD",2934746
1,1.0,"Western Africa",201786,0,201786,162462,270771,"NGA",216617
1,1.0,"Oceania",355557,355557,0,292238,487063,"NZL",389651
1,1.0,"South America",1671368,1307196,364172,1271164,2118607,"BRA",1694886
1,1.0,"Northern Africa",1019162,0,1019162,820571,1367618,"EGY",1094095
1,1.0,"Southern Asia",371236,0,371236,298897,498162,"IRN",398530
1,1.0,"Eastern Europe",3799187,3243728,555459,2880021,4800036,"POL",3840029
1,1.0,"Middle Africa",44554,0,44554,35870,59783,"AGO",47827
1,1.0,"Central America",354147,0,354147,285138,475230,"MEX",380184
1,1.0,"Southern Africa",103145,0,103145,83046,138410,"ZAF",110728
1,1.0,"South-Eastern Asia",517428,0,517428,416601,694336,"IDN",555469
1,1.0,"China",9717609,8767947,949662,7340573,12234288,"CPR",9787431
1,1.0,"Pakistan",1549041,1262012,287029,1177605,1962676,"PAK",1570141
1,1.0,"Eastern Asia",897551,0,897551,722660,1204433,"JPN",963547
1,1.0,"Russian Federation",4141193,3471510,669683,3136330,5227217,"RUS",4181774
1,1.0,"Western Asia",182617,0,182617,147031,245052,"IRQ",196042
1,1.0,"Southern Europe",331260,0,331260,266713,444522,"ITA",355618
1,1.0,"Eastern Africa",115871,0,115871,93290,155483,"ETH",124387
1,1.0,"Northern America",712202,712202,0,585372,975620,"CAN",780496
1,1.0,"Northern Europe",1605589,1605589,0,1216355,2027258,"GBR",1621807
1,1.0,"United States of America",2652761,2652761,0,2133588,3555980,"USA",2844784
1,1.0,"Central Asia",1256856,1106855,150001,950910,1584851,"UZB",1267881
1,1.0,"India",5085457,4862968,222489,3817265,6362108,"IND",5089687
1,2.0,"Western Europe",2795346,2788234,7112,2201059,3668432,"NLD",2934746
1,2.0,"Western Africa",203734,0,203734,162462,270771,"NGA",216617
1,2.0,"Oceania",369195,368414,781,292238,487063,"NZL",389651
1,2.0,"South America",1668364,1305761,362603,1271164,2118607,"BRA",1694886
1,2.0,"Northern Africa",1029005,0,1029005,820571,1367618,"EGY",1094095
1,2.0,"Southern Asia",374821,0,374821,298897,498162,"IRN",398530
1,2.0,"Eastern Europe",3788334,3239029,549305,2880021,4800036,"POL",3840029
1,2.0,"Middle Africa",44985,0,44985,35870,59783,"AGO",47827
1,2.0,"Central America",357567,0,357567,285138,475230,"MEX",380184
1,2.0,"Southern Africa",104142,0,104142,83046,138410,"ZAF",110728
1,2.0,"South-Eastern Asia",522426,0,522426,416601,694336,"IDN",555469
1,2.0,"China",9704861,8775389,929472,7340573,12234288,"CPR",9787431
1,2.0,"Pakistan",1548656,1263566,285090,1177605,1962676,"PAK",1570141
1,2.0,"Eastern Asia",906221,0,906221,722660,1204433,"JPN",963547
1,2.0,"Russian Federation",4130346,3466740,663606,3136330,5227217,"RUS",4181774
1,2.0,"Western Asia",184380,0,184380,147031,245052,"IRQ",196042
1,2.0,"Southern Europe",334460,0,334460,266713,444522,"ITA",355618
1,2.0,"Eastern Africa",116991,0,116991,93290,155483,"ETH",124387
1,2.0,"Northern America",714153,713107,1046,585372,975620,"CAN",780496
1,2.0,"Northern Europe",1601535,1601535,0,1216355,2027258,"GBR",1621807
1,2.0,"United States of America",2681208,2681208,0,2133588,3555980,"USA",2844784
1,2.0,"Central Asia",1255536,1107890,147646,950910,1584851,"UZB",1267881
1,2.0,"India",5063350,4853982,209368,3817265,6362108,"IND",5089687
1,3.0,"Western Europe",2795346,2782649,12697,2201059,3668432,"NLD",2934746
1,3.0,"Western Africa",205414,0,205414,162462,270771,"NGA",216617
1,3.0,"Oceania",379910,379910,0,292238,487063,"NZL",389651
1,3.0,"South America",1664877,1304325,360552,1271164,2118607,"BRA",1694886
1,3.0,"Northern Africa",1037493,0,1037493,820571,1367618,"EGY",1094095
1,3.0,"Southern Asia",377913,0,377913,298897,498162,"IRN",398530
1,3.0,"Eastern Europe",3768631,3226221,542410,2880021,4800036,"POL",3840029
1,3.0,"Middle Africa",45356,0,45356,35870,59783,"AGO",47827
1,3.0,"Central America",360517,0,360517,285138,475230,"MEX",380184
1,3.0,"Southern Africa",105001,0,105001,83046,138410,"ZAF",110728
1,3.0,"South-Eastern Asia",526735,0,526735,416601,694336,"IDN",555469
1,3.0,"China",9668930,8760911,908019,7340573,12234288,"CPR",9787431
1,3.0,"Pakistan",1544737,1261966,282771,1177605,1962676,"PAK",1570141
1,3.0,"Eastern Asia",913697,0,913697,722660,1204433,"JPN",963547
1,3.0,"Russian Federation",4127266,3470628,656638,3136330,5227217,"RUS",4181774
1,3.0,"Western Asia",185902,0,185902,147031,245052,"IRQ",196042
1,3.0,"Southern Europe",337219,0,337219,266713,444522,"ITA",355618
1,3.0,"Eastern Africa",117955,0,117955,93290,155483,"ETH",124387
1,3.0,"Northern America",727812,727458,354,585372,975620,"CAN",780496
1,3.0,"Northern Europe",1597480,1597480,0,1216355,2027258,"GBR",1621807
1,3.0,"United States of America",2688320,2688320,0,2133588,3555980,"USA",2844784
1,3.0,"Central Asia",1254018,1108926,145092,950910,1584851,"UZB",1267881
1,3.0,"India",5053077,4857124,195953,3817265,6362108,"IND",5089687
1,4.0,"Western Europe",2802683,2785431,17252,2201059,3668432,"NLD",2934746
1,4.0,"Western Africa",207006,0,207006,162462,270771,"NGA",216617
1,4.0,"Oceania",385755,385755,0,292238,487063,"NZL",389651
1,4.0,"South America",1664490,1306149,358341,1271164,2118607,"BRA",1694886
1,4.0,"Northern Africa",1045534,0,1045534,820571,1367618,"EGY",1094095
1,4.0,"Southern Asia",380843,0,380843,298897,498162,"IRN",398530
1,4.0,"Eastern Europe",3756794,3221522,535272,2880021,4800036,"POL",3840029
1,4.0,"Middle Africa",45707,0,45707,35870,59783,"AGO",47827
1,4.0,"Central America",363311,0,363311,285138,475230,"MEX",380184
1,4.0,"Southern Africa",105814,0,105814,83046,138410,"ZAF",110728
1,4.0,"South-Eastern Asia",530817,0,530817,416601,694336,"IDN",555469
1,4.0,"China",9654502,8768353,886149,7340573,12234288,"CPR",9787431
1,4.0,"Pakistan",1540691,1260366,280325,1177605,1962676,"PAK",1570141
1,4.0,"Eastern Asia",920778,0,920778,722660,1204433,"JPN",963547
1,4.0,"Russian Federation",4115235,3465859,649376,3136330,5227217,"RUS",4181774
1,4.0,"Western Asia",187344,0,187344,147031,245052,"IRQ",196042
1,4.0,"Southern Europe",339832,0,339832,266713,444522,"ITA",355618
1,4.0,"Eastern Africa",118869,0,118869,93290,155483,"ETH",124387
1,4.0,"Northern America",727812,727812,0,585372,975620,"CAN",780496
1,4.0,"Northern Europe",1597480,1597480,0,1216355,2027258,"GBR",1621807
1,4.0,"United States of America",2723880,2723880,0,2133588,3555980,"USA",2844784
1,4.0,"Central Asia",1249668,1107195,142473,950910,1584851,"UZB",1267881
1,4.0,"India",5030578,4848139,182439,3817265,6362108,"IND",5089687
1,5.0,"Western Europe",2802683,2782021,20662,2201059,3668432,"NLD",2934746
1,5.0,"Western Africa",208291,0,208291,162462,270771,"NGA",216617
1,5.0,"Oceania",390626,390626,0,292238,487063,"NZL",389651
1,5.0,"South America",1660290,1304713,355577,1271164,2118607,"BRA",1694886
1,5.0,"Northern Africa",1052025,0,1052025,820571,1367618,"EGY",1094095
1,5.0,"Southern Asia",383207,0,383207,298897,498162,"IRN",398530
1,5.0,"Eastern Europe",3744114,3216824,527290,2880021,4800036,"POL",3840029
1,5.0,"Middle Africa",45991,0,45991,35870,59783,"AGO",47827
1,5.0,"Central America",365566,0,365566,285138,475230,"MEX",380184
1,5.0,"Southern Africa",106471,0,106471,83046,138410,"ZAF",110728
1,5.0,"South-Eastern Asia",534112,0,534112,416601,694336,"IDN",555469
1,5.0,"China",9638630,8775795,862835,7340573,12234288,"CPR",9787431
1,5.0,"Pakistan",1536209,1258766,277443,1177605,1962676,"PAK",1570141
1,5.0,"Eastern Asia",926494,0,926494,722660,1204433,"JPN",963547
1,5.0,"Russian Federation",4110843,3469747,641096,3136330,5227217,"RUS",4181774
1,5.0,"Western Asia",188506,0,188506,147031,245052,"IRQ",196042
1,5.0,"Southern Europe",341941,0,341941,266713,444522,"ITA",355618
1,5.0,"Eastern Africa",119606,0,119606,93290,155483,"ETH",124387
1,5.0,"Northern America",729763,729763,0,585372,975620,"CAN",780496
1,5.0,"Northern Europe",1593426,1593426,0,1216355,2027258,"GBR",1621807
1,5.0,"United States of America",2752328,2752328,0,2133588,3555980,"USA",2844784
1,5.0,"Central Asia",1247855,1108231,139624,950910,1584851,"UZB",1267881
1,5.0,"India",5019868,4851281,168587,3817265,6362108,"IND",5089687
1,6.0,"Western Europe",2802683,2779433,23250,2201059,3668432,"NLD",2934746
1,6.0,"Western Africa",210043,0,210043,162462,270771,"NGA",216617
1,6.0,"Oceania",396470,396470,0,292238,487063,"NZL",389651
1,6.0,"South America",1660191,1306538,353653,1271164,2118607,"BRA",1694886
1,6.0,"Northern Africa",1060870,0,1060870,820571,1367618,"EGY",1094095
1,6.0,"Southern Asia",386430,0,386430,298897,498162,"IRN",398530
1,6.0,"Eastern Europe",3732716,3212125,520591,2880021,4800036,"POL",3840029
1,6.0,"Middle Africa",46378,0,46378,35870,59783,"AGO",47827
1,6.0,"Central America",368641,0,368641,285138,475230,"MEX",380184
1,6.0,"Southern Africa",107366,0,107366,83046,138410,"ZAF",110728
1,6.0,"South-Eastern Asia",538602,0,538602,416601,694336,"IDN",555469
1,6.0,"China",9603033,8761317,841716,7340573,12234288,"CPR",9787431
1,6.0,"Pakistan",1532390,1257166,275224,1177605,1962676,"PAK",1570141
1,6.0,"Eastern Asia",934284,0,934284,722660,1204433,"JPN",963547
1,6.0,"Russian Federation",4099342,3464978,634364,3136330,5227217,"RUS",4181774
1,6.0,"Western Asia",190091,0,190091,147031,245052,"IRQ",196042
1,6.0,"Southern Europe",344816,0,344816,266713,444522,"ITA",355618
1,6.0,"Eastern Africa",120613,0,120613,93290,155483,"ETH",124387
1,6.0,"Northern America",753178,752049,1129,585372,975620,"CAN",780496
1,6.0,"Northern Europe",1589371,1589371,0,1216355,2027258,"GBR",1621807
1,6.0,"United States of America",2752328,2752328,0,2133588,3555980,"USA",2844784
1,6.0,"Central Asia",1243625,1106500,137125,950910,1584851,"UZB",1267881
1,6.0,"India",5009671,4854423,155248,3817265,6362108,"IND",5089687
1,7.0,"Western Europe",2810020,2786770,23250,2201059,3668432,"NLD",2934746
1,7.0,"Western Africa",211517,0,211517,162462,270771,"NGA",216617
1,7.0,"Oceania",400367,400367,0,292238,487063,"NZL",389651
1,7.0,"South America",1656332,1305102,351230,1271164,2118607,"BRA",1694886
1,7.0,"Northern Africa",1068313,0,1068313,820571,1367618,"EGY",1094095
1,7.0,"Southern Asia",389140,0,389140,298897,498162,"IRN",398530
1,7.0,"Eastern Europe",3720554,3207426,513128,2880021,4800036,"POL",3840029
1,7.0,"Middle Africa",46703,0,46703,35870,59783,"AGO",47827
1,7.0,"Central America",371228,0,371228,285138,475230,"MEX",380184
1,7.0,"Southern Africa",108119,0,108119,83046,138410,"ZAF",110728
1,7.0,"South-Eastern Asia",542382,0,542382,416601,694336,"IDN",555469
1,7.0,"China",9588050,8768760,819290,7340573,12234288,"CPR",9787431
1,7.0,"Pakistan",1528177,1255566,272611,1177605,1962676,"PAK",1570141
1,7.0,"Eastern Asia",940839,0,940839,722660,1204433,"JPN",963547
1,7.0,"Russian Federation",4095575,3468865,626710,3136330,5227217,"RUS",4181774
1,7.0,"Western Asia",191423,0,191423,147031,245052,"IRQ",196042
1,7.0,"Southern Europe",347236,0,347236,266713,444522,"ITA",355618
1,7.0,"Eastern Africa",121459,0,121459,93290,155483,"ETH",124387
1,7.0,"Northern America",753178,753178,0,585372,975620,"CAN",780496
1,7.0,"Northern Europe",1589371,1589371,0,1216355,2027258,"GBR",1621807
1,7.0,"United States of America",2787888,2787888,0,2133588,3555980,"USA",2844784
1,7.0,"Central Asia",1239185,1104768,134417,950910,1584851,"UZB",1267881
1,7.0,"India",4999170,4857565,141605,3817265,6362108,"IND",5089687
1,8.0,"Western Europe",2802683,2786648,16035,2201059,3668432,"NLD",2934746
1,8.0,"Western Africa",212712,0,212712,162462,270771,"NGA",216617
1,8.0,"Oceania",402315,402315,0,292238,487063,"NZL",389651
1,8.0,"South America",1655232,1306926,348306,1271164,2118607,"BRA",1694886
1,8.0,"Northern Africa",1074358,0,1074358,820571,1367618,"EGY",1094095
1,8.0,"Southern Asia",391342,0,391342,298897,498162,"IRN",398530
1,8.0,"Eastern Europe",3723848,3218592,505256,2880021,4800036,"POL",3840029
1,8.0,"Middle Africa",46967,0,46967,35870,59783,"AGO",47827
1,8.0,"Central America",373328,0,373328,285138,475230,"MEX",380184
1,8.0,"Southern Africa",108731,0,108731,83046,138410,"ZAF",110728
1,8.0,"South-Eastern Asia",545451,0,545451,416601,694336,"IDN",555469
1,8.0,"China",9549842,8754282,795560,7340573,12234288,"CPR",9787431
1,8.0,"Pakistan",1523568,1253966,269602,1177605,1962676,"PAK",1570141
1,8.0,"Eastern Asia",946163,0,946163,722660,1204433,"JPN",963547
1,8.0,"Russian Federation",4082233,3464096,618137,3136330,5227217,"RUS",4181774
1,8.0,"Western Asia",192507,0,192507,147031,245052,"IRQ",196042
1,8.0,"Southern Europe",349201,0,349201,266713,444522,"ITA",355618
1,8.0,"Eastern Africa",122146,0,122146,93290,155483,"ETH",124387
1,8.0,"Northern America",755129,755129,0,585372,975620,"CAN",780496
1,8.0,"Northern Europe",1585317,1585317,0,1216355,2027258,"GBR",1621807
1,8.0,"United States of America",2823448,2823448,0,2133588,3555980,"USA",2844784
1,8.0,"Central Asia",1237308,1105804,131504,950910,1584851,"UZB",1267881
1,8.0,"India",4976235,4848580,127655,3817265,6362108,"IND",5089687
1,9.0,"Western Europe",2817357,2800800,16557,2201059,3668432,"NLD",2934746
1,9.0,"Western Africa",214099,0,214099,162462,270771,"NGA",216617
1,9.0,"Oceania",402315,402315,0,292238,487063,"NZL",389651
1,9.0,"South America",1651213,1305490,345723,1271164,2118607,"BRA",1694886
1,9.0,"Northern Africa",1081357,0,1081357,820571,1367618,"EGY",1094095
1,9.0,"Southern Asia",393892,0,393892,298897,498162,"IRN",398530
1,9.0,"Eastern Europe",3711446,3213717,497729,2880021,4800036,"POL",3840029
1,9.0,"Middle Africa",47273,0,47273,35870,59783,"AGO",47827
1,9.0,"Central America",375760,0,375760,285138,475230,"MEX",380184
1,9.0,"Southern Africa",109440,0,109440,83046,138410,"ZAF",110728
1,9.0,"South-Eastern Asia",549004,0,549004,416601,694336,"IDN",555469
1,9.0,"China",9534443,8761724,772719,7340573,12234288,"CPR",9787431
1,9.0,"Pakistan",1519230,1252366,266864,1177605,1962676,"PAK",1570141
1,9.0,"Eastern Asia",952327,0,952327,722660,1204433,"JPN",963547
1,9.0,"Russian Federation",4078175,3467984,610191,3136330,5227217,"RUS",4181774
1,9.0,"Western Asia",193761,0,193761,147031,245052,"IRQ",196042
1,9.0,"Southern Europe",351477,0,351477,266713,444522,"ITA",355618
1,9.0,"Eastern Africa",122942,0,122942,93290,155483,"ETH",124387
1,9.0,"Northern America",762934,762934,0,585372,975620,"CAN",780496
1,9.0,"Northern Europe",1581262,1581262,0,1216355,2027258,"GBR",1621807
1,9.0,"United States of America",2844784,2844784,0,2133588,3555980,"USA",2844784
1,9.0,"Central Asia",1232803,1104073,128730,950910,1584851,"UZB",1267881
1,9.0,"India",4965637,4851722,113915,3817265,6362108,"IND",5089687
1,10.0,"Western Europe",2824694,2807076,17618,2201059,3668432,"NLD",2934746
1,10.0,"Western Africa",215469,0,215469,162462,270771,"NGA",216617
1,10.0,"Oceania",402315,402315,0,292238,487063,"NZL",389651
1,10.0,"South America",1647167,1304055,343112,1271164,2118607,"BRA",1694886
1,10.0,"Northern Africa",1088280,0,1088280,820571,1367618,"EGY",1094095
1,10.0,"Southern Asia",396414,0,396414,298897,498162,"IRN",398530
1,10.0,"Eastern Europe",3699000,3208664,490336,2880021,4800036,"POL",3840029
1,10.0,"Middle Africa",47576,0,47576,35870,59783,"AGO",47827
1,10.0,"Central America",378165,0,378165,285138,475230,"MEX",380184
1,10.0,"Southern Africa",110139,0,110139,83046,138410,"ZAF",110728
1,10.0,"South-Eastern Asia",552518,0,552518,416601,694336,"IDN",555469
1,10.0,"China",9497054,8747246,749808,7340573,12234288,"CPR",9787431
1,10.0,"Pakistan",1518025,1253921,264104,1177605,1962676,"PAK",1570141
1,10.0,"Eastern Asia",958423,0,958423,722660,1204433,"JPN",963547
1,10.0,"Russian Federation",4065409,3463215,602194,3136330,5227217,"RUS",4181774
1,10.0,"Western Asia",195003,0,195003,147031,245052,"IRQ",196042
1,10.0,"Southern Europe",353726,0,353726,266713,444522,"ITA",355618
1,10.0,"Eastern Africa",123728,0,123728,93290,155483,"ETH",124387
1,10.0,"Northern America",772691,772691,0,585372,975620,"CAN",780496
1,10.0,"Northern Europe",1577208,1577208,0,1216355,2027258,"GBR",1621807
1,10.0,"United States of America",2866119,2866119,0,2133588,3555980,"USA",2844784
1,10.0,"Central Asia",1228287,1102342,125945,950910,1584851,"UZB",1267881
1,10.0,"India",4955020,4854863,100157,3817265,6362108,"IND",5089687
1,11.0,"Western Europe",2861378,2843053,18325,2201059,3668432,"NLD",2934746
1,11.0,"Western Africa",216528,0,216528,162462,270771,"NGA",216617
1,11.0,"Oceania",401341,401341,0,292238,487063,"NZL",389651
1,11.0,"South America",1645924,1305879,340045,1271164,2118607,"BRA",1694886
1,11.0,"Northern Africa",1093625,0,1093625,820571,1367618,"EGY",1094095
1,11.0,"Southern Asia",398360,0,398360,298897,498162,"IRN",398530
1,11.0,"Eastern Europe",3685858,3203435,482423,2880021,4800036,"POL",3840029
1,11.0,"Middle Africa",47810,0,47810,35870,59783,"AGO",47827
1,11.0,"Central America",380022,0,380022,285138,475230,"MEX",380184
1,11.0,"Southern Africa",110680,0,110680,83046,138410,"ZAF",110728
1,11.0,"South-Eastern Asia",555231,0,555231,416601,694336,"IDN",555469
1,11.0,"China",9480114,8754688,725426,7340573,12234288,"CPR",9787431
1,11.0,"Pakistan",1513220,1252321,260899,1177605,1962676,"PAK",1570141
1,11.0,"Eastern Asia",963130,0,963130,722660,1204433,"JPN",963547
1,11.0,"Russian Federation",4060264,3467103,593161,3136330,5227217,"RUS",4181774
1,11.0,"Western Asia",195960,0,195960,147031,245052,"IRQ",196042
1,11.0,"Southern Europe",355463,0,355463,266713,444522,"ITA",355618
1,11.0,"Eastern Africa",124336,0,124336,93290,155483,"ETH",124387
1,11.0,"Northern America",776593,776593,0,585372,975620,"CAN",780496
1,11.0,"Northern Europe",1577208,1577208,0,1216355,2027258,"GBR",1621807
1,11.0,"United States of America",2873231,2873231,0,2133588,3555980,"USA",2844784
1,11.0,"Central Asia",1223539,1100610,122929,950910,1584851,"UZB",1267881
1,11.0,"India",4931932,4845878,86054,3817265,6362108,"IND",5089687
1,12.0,"Western Europe",2861378,2851857,9521,2201059,3668432,"NLD",2934746
1,12.0,"Western Africa",217621,0,217621,162462,270771,"NGA",216617
1,12.0,"Oceania",400367,400367,0,292238,487063,"NZL",389651
1,12.0,"South America",1641484,1304443,337041,1271164,2118607,"BRA",1694886
1,12.0,"Northern Africa",1099146,0,1099146,820571,1367618,"EGY",1094095
1,12.0,"Southern Asia",400371,0,400371,298897,498162,"IRN",398530
1,12.0,"Eastern Europe",3689029,3210848,478181,2880021,4800036,"POL",3840029
1,12.0,"Middle Africa",48051,0,48051,35870,59783,"AGO",47827
1,12.0,"Central America",381940,0,381940,285138,475230,"MEX",380184
1,12.0,"Southern Africa",111238,0,111238,83046,138410,"ZAF",110728
1,12.0,"South-Eastern Asia",558035,0,558035,416601,694336,"IDN",555469
1,12.0,"China",9463340,8762131,701209,7340573,12234288,"CPR",9787431
1,12.0,"Pakistan",1508465,1250721,257744,1177605,1962676,"PAK",1570141
1,12.0,"Eastern Asia",967993,0,967993,722660,1204433,"JPN",963547
1,12.0,"Russian Federation",4055235,3470991,584244,3136330,5227217,"RUS",4181774
1,12.0,"Western Asia",196948,0,196948,147031,245052,"IRQ",196042
1,12.0,"Southern Europe",357258,0,357258,266713,444522,"ITA",355618
1,12.0,"Eastern Africa",124964,0,124964,93290,155483,"ETH",124387
1,12.0,"Northern America",776593,776593,0,585372,975620,"CAN",780496
1,12.0,"Northern Europe",1593426,1593426,0,1216355,2027258,"GBR",1621807
1,12.0,"United States of America",2908791,2908791,0,2133588,3555980,"USA",2844784
1,12.0,"Central Asia",1221584,1101646,119938,950910,1584851,"UZB",1267881
1,12.0,"India",4920961,4849020,71941,3817265,6362108,"IND",5089687
1,13.0,"Western Europe",2883388,2873336,10052,2201059,3668432,"NLD",2934746
1,13.0,"Western Africa",218782,0,218782,162462,270771,"NGA",216617
1,13.0,"Oceania",405237,405237,0,292238,487063,"NZL",389651
1,13.0,"South America",1640106,1304573,335533,1271164,2118607,"BRA",1694886
1,13.0,"Northern Africa",1105013,0,1105013,820571,1367618,"EGY",1094095
1,13.0,"Southern Asia",402508,0,402508,298897,498162,"IRN",398530
1,13.0,"Eastern Europe",3683790,3209446,474344,2880021,4800036,"POL",3840029
1,13.0,"Middle Africa",48306,0,48306,35870,59783,"AGO",47827
1,13.0,"Central America",383980,0,383980,285138,475230,"MEX",380184
1,13.0,"Southern Africa",111833,0,111833,83046,138410,"ZAF",110728
1,13.0,"South-Eastern Asia",561015,0,561015,416601,694336,"IDN",555469
1,13.0,"China",9424968,8747653,677315,7340573,12234288,"CPR",9787431
1,13.0,"Pakistan",1503806,1249121,254685,1177605,1962676,"PAK",1570141
1,13.0,"Eastern Asia",973161,0,973161,722660,1204433,"JPN",963547
1,13.0,"Russian Federation",4041776,3466221,575555,3136330,5227217,"RUS",4181774
1,13.0,"Western Asia",198000,0,198000,147031,245052,"IRQ",196042
1,13.0,"Southern Europe",359165,0,359165,266713,444522,"ITA",355618
1,13.0,"Eastern Africa",125631,0,125631,93290,155483,"ETH",124387
1,13.0,"Northern America",784398,784398,0,585372,975620,"CAN",780496
1,13.0,"Northern Europe",1593426,1593426,0,1216355,2027258,"GBR",1621807
1,13.0,"United States of America",2908791,2908791,0,2133588,3555980,"USA",2844784
1,13.0,"Central Asia",1216914,1099915,116999,950910,1584851,"UZB",1267881
1,13.0,"India",4910113,4852162,57951,3817265,6362108,"IND",5089687
1,14.0,"Western Europe",2898062,2888010,10052,2201059,3668432,"NLD",2934746
1,14.0,"Western Africa",219768,0,219768,162462,270771,"NGA",216617
1,14.0,"Oceania",406212,406212,0,292238,487063,"NZL",389651
1,14.0,"South America",1638629,1304140,334489,1271164,2118607,"BRA",1694886
1,14.0,"Northern Africa",1109998,0,1109998,820571,1367618,"EGY",1094095
1,14.0,"Southern Asia",404323,0,404323,298897,498162,"IRN",398530
1,14.0,"Eastern Europe",3678399,3206040,472359,2880021,4800036,"POL",3840029
1,14.0,"Middle Africa",48524,0,48524,35870,59783,"AGO",47827
1,14.0,"Central America",385712,0,385712,285138,475230,"MEX",380184
1,14.0,"Southern Africa",112338,0,112338,83046,138410,"ZAF",110728
1,14.0,"South-Eastern Asia",563545,0,563545,416601,694336,"IDN",555469
1,14.0,"China",9407693,8755095,652598,7340573,12234288,"CPR",9787431
1,14.0,"Pakistan",1502056,1250676,251380,1177605,1962676,"PAK",1570141
1,14.0,"Eastern Asia",977550,0,977550,722660,1204433,"JPN",963547
1,14.0,"Russian Federation",4036394,3470109,566285,3136330,5227217,"RUS",4181774
1,14.0,"Western Asia",198893,0,198893,147031,245052,"IRQ",196042
1,14.0,"Southern Europe",360784,0,360784,266713,444522,"ITA",355618
1,14.0,"Eastern Africa",126198,0,126198,93290,155483,"ETH",124387
1,14.0,"Northern America",784398,784398,0,585372,975620,"CAN",780496
1,14.0,"Northern Europe",1593426,1593426,0,1216355,2027258,"GBR",1621807
1,14.0,"United States of America",2930127,2930127,0,2133588,3555980,"USA",2844784
1,14.0,"Central Asia",1212114,1098184,113930,950910,1584851,"UZB",1267881
1,14.0,"India",4886947,4843177,43770,3817265,6362108,"IND",5089687
1,15.0,"Western Europe",2898062,2896814,1248,2201059,3668432,"NLD",2934746
1,15.0,"Western Africa",220543,0,220543,162462,270771,"NGA",216617
1,15.0,"Oceania",410108,410108,0,292238,487063,"NZL",389651
1,15.0,"South America",1640026,1304715,335311,1271164,2118607,"BRA",1694886
1,15.0,"Northern Africa",1113909,0,1113909,820571,1367618,"EGY",1094095
1,15.0,"Southern Asia",405748,0,405748,298897,498162,"IRN",398530
1,15.0,"Eastern Europe",3680530,3209205,471325,2880021,4800036,"POL",3840029
1,15.0,"Middle Africa",48696,0,48696,35870,59783,"AGO",47827
1,15.0,"Central America",387072,0,387072,285138,475230,"MEX",380184
1,15.0,"Southern Africa",112733,0,112733,83046,138410,"ZAF",110728
1,15.0,"South-Eastern Asia",565531,0,565531,416601,694336,"IDN",555469
1,15.0,"China",9389417,8762537,626880,7340573,12234288,"CPR",9787431
1,15.0,"Pakistan",1496847,1249076,247771,1177605,1962676,"PAK",1570141
1,15.0,"Eastern Asia",980993,0,980993,722660,1204433,"JPN",963547
1,15.0,"Russian Federation",4021650,3465340,556310,3136330,5227217,"RUS",4181774
1,15.0,"Western Asia",199594,0,199594,147031,245052,"IRQ",196042
1,15.0,"Southern Europe",362056,0,362056,266713,444522,"ITA",355618
1,15.0,"Eastern Africa",126643,0,126643,93290,155483,"ETH",124387
1,15.0,"Northern America",788300,788300,0,585372,975620,"CAN",780496
1,15.0,"Northern Europe",1621808,1621808,0,1216355,2027258,"GBR",1621807
1,15.0,"United States of America",2937239,2937239,0,2133588,3555980,"USA",2844784
1,15.0,"Central Asia",1209924,1099220,110704,950910,1584851,"UZB",1267881
1,15.0,"India",4875725,4846319,29406,3817265,6362108,"IND",5089687
1,16.0,"Western Europe",2927410,2925278,2132,2201059,3668432,"NLD",2934746
1,16.0,"Western Africa",221508,0,221508,162462,270771,"NGA",216617
1,16.0,"Oceania",414005,414005,0,292238,487063,"NZL",389651
1,16.0,"South America",1641684,1304729,336955,1271164,2118607,"BRA",1694886
1,16.0,"Northern Africa",1118781,0,1118781,820571,1367618,"EGY",1094095
1,16.0,"Southern Asia",407522,0,407522,298897,498162,"IRN",398530
1,16.0,"Eastern Europe",3683185,3211157,472028,2880021,4800036,"POL",3840029
1,16.0,"Middle Africa",48908,0,48908,35870,59783,"AGO",47827
1,16.0,"Central America",388764,0,388764,285138,475230,"MEX",380184
1,16.0,"Southern Africa",113227,0,113227,83046,138410,"ZAF",110728
1,16.0,"South-Eastern Asia",568005,0,568005,416601,694336,"IDN",555469
1,16.0,"China",9350118,8747946,602172,7340573,12234288,"CPR",9787431
1,16.0,"Pakistan",1495063,1250631,244432,1177605,1962676,"PAK",1570141
1,16.0,"Eastern Asia",985286,0,985286,722660,1204433,"JPN",963547
1,16.0,"Russian Federation",4016195,3469228,546967,3136330,5227217,"RUS",4181774
1,16.0,"Western Asia",200468,0,200468,147031,245052,"IRQ",196042
1,16.0,"Southern Europe",363640,0,363640,266713,444522,"ITA",355618
1,16.0,"Eastern Africa",127197,0,127197,93290,155483,"ETH",124387
1,16.0,"Northern America",792203,792203,0,585372,975620,"CAN",780496
1,16.0,"Northern Europe",1609644,1609644,0,1216355,2027258,"GBR",1621807
1,16.0,"United States of America",2937239,2937239,0,2133588,3555980,"USA",2844784
1,16.0,"Central Asia",1207873,1100079,107794,950910,1584851,"UZB",1267881
1,16.0,"India",4864702,4849461,15241,3817265,6362108,"IND",5089687
1,17.0,"Western Europe",2920073,2920073,0,2201059,3668432,"NLD",2934746
1,17.0,"Western Africa",222212,0,222212,162462,270771,"NGA",216617
1,17.0,"Oceania",413030,413030,0,292238,487063,"NZL",389651
1,17.0,"South America",1643147,1304743,338404,1271164,2118607,"BRA",1694886
1,17.0,"Northern Africa",1122340,0,1122340,820571,1367618,"EGY",1094095
1,17.0,"Southern Asia",408819,0,408819,298897,498162,"IRN",398530
1,17.0,"Eastern Europe",3677180,3203718,473462,2880021,4800036,"POL",3840029
1,17.0,"Middle Africa",49063,0,49063,35870,59783,"AGO",47827
1,17.0,"Central America",390001,0,390001,285138,475230,"MEX",380184
1,17.0,"Southern Africa",113587,0,113587,83046,138410,"ZAF",110728
1,17.0,"South-Eastern Asia",569811,0,569811,416601,694336,"IDN",555469
1,17.0,"China",9331515,8754594,576921,7340573,12234288,"CPR",9787431
1,17.0,"Pakistan",1492911,1251845,241066,1177605,1962676,"PAK",1570141
1,17.0,"Eastern Asia",988420,0,988420,722660,1204433,"JPN",963547
1,17.0,"Russian Federation",4001220,3464459,536761,3136330,5227217,"RUS",4181774
1,17.0,"Western Asia",201104,0,201104,147031,245052,"IRQ",196042
1,17.0,"Southern Europe",364797,0,364797,266713,444522,"ITA",355618
1,17.0,"Eastern Africa",127601,0,127601,93290,155483,"ETH",124387
1,17.0,"Northern America",792203,792203,0,585372,975620,"CAN",780496
1,17.0,"Northern Europe",1613698,1613698,0,1216355,2027258,"GBR",1621807
1,17.0,"United States of America",2965687,2965687,0,2133588,3555980,"USA",2844784
1,17.0,"Central Asia",1205629,1100653,104976,950910,1584851,"UZB",1267881
1,17.0,"India",4865611,4849961,15650,3817265,6362108,"IND",5089687
1,18.0,"Western Europe",2942083,2942083,0,2201059,3668432,"NLD",2934746
1,18.0,"Western Africa",223125,0,223125,162462,270771,"NGA",216617
1,18.0,"Oceania",412056,412056,0,292238,487063,"NZL",389651
1,18.0,"South America",1644923,1304743,340180,1271164,2118607,"BRA",1694886
1,18.0,"Northern Africa",1126952,0,1126952,820571,1367618,"EGY",1094095
1,18.0,"Southern Asia",410499,0,410499,298897,498162,"IRN",398530
1,18.0,"Eastern Europe",3679855,3203718,476137,2880021,4800036,"POL",3840029
1,18.0,"Middle Africa",49266,0,49266,35870,59783,"AGO",47827
1,18.0,"Central America",391604,0,391604,285138,475230,"MEX",380184
1,18.0,"Southern Africa",114054,0,114054,83046,138410,"ZAF",110728
1,18.0,"South-Eastern Asia",572153,0,572153,416601,694336,"IDN",555469
1,18.0,"China",9313892,8761241,552651,7340573,12234288,"CPR",9787431
1,18.0,"Pakistan",1487900,1249419,238481,1177605,1962676,"PAK",1570141
1,18.0,"Eastern Asia",992482,0,992482,722660,1204433,"JPN",963547
1,18.0,"Russian Federation",3995593,3468346,527247,3136330,5227217,"RUS",4181774
1,18.0,"Western Asia",201931,0,201931,147031,245052,"IRQ",196042
1,18.0,"Southern Europe",366297,0,366297,266713,444522,"ITA",355618
1,18.0,"Eastern Africa",128124,0,128124,93290,155483,"ETH",124387
1,18.0,"Northern America",801959,801959,0,585372,975620,"CAN",780496
1,18.0,"Northern Europe",1609644,1609644,0,1216355,2027258,"GBR",1621807
1,18.0,"United States of America",2965687,2965687,0,2133588,3555980,"USA",2844784
1,18.0,"Central Asia",1200773,1098284,102489,950910,1584851,"UZB",1267881
1,18.0,"India",4866484,4850708,15776,3817265,6362108,"IND",5089687
1,19.0,"Western Europe",2934747,2934747,0,2201059,3668432,"NLD",2934746
1,19.0,"Western Africa",223482,0,223482,162462,270771,"NGA",216617
1,19.0,"Oceania",412056,412056,0,292238,487063,"NZL",389651
1,19.0,"South America",1645483,1304743,340740,1271164,2118607,"BRA",1694886
1,19.0,"Northern Africa",1128755,0,1128755,820571,1367618,"EGY",1094095
1,19.0,"Southern Asia",411156,0,411156,298897,498162,"IRN",398530
1,19.0,"Eastern Europe",3697056,3208416,488640,2880021,4800036,"POL",3840029
1,19.0,"Middle Africa",49345,0,49345,35870,59783,"AGO",47827
1,19.0,"Central America",392230,0,392230,285138,475230,"MEX",380184
1,19.0,"Southern Africa",114237,0,114237,83046,138410,"ZAF",110728
1,19.0,"South-Eastern Asia",573069,0,573069,416601,694336,"IDN",555469
1,19.0,"China",9293652,8767888,525764,7340573,12234288,"CPR",9787431
1,19.0,"Pakistan",1485253,1249065,236188,1177605,1962676,"PAK",1570141
1,19.0,"Eastern Asia",994070,0,994070,722660,1204433,"JPN",963547
1,19.0,"Russian Federation",3979463,3463351,516112,3136330,5227217,"RUS",4181774
1,19.0,"Western Asia",202254,0,202254,147031,245052,"IRQ",196042
1,19.0,"Southern Europe",366883,0,366883,266713,444522,"ITA",355618
1,19.0,"Eastern Africa",128330,0,128330,93290,155483,"ETH",124387
1,19.0,"Northern America",801959,801959,0,585372,975620,"CAN",780496
1,19.0,"Northern Europe",1625862,1625862,0,1216355,2027258,"GBR",1621807
1,19.0,"United States of America",2979911,2979911,0,2133588,3555980,"USA",2844784
1,19.0,"Central Asia",1201039,1098969,102070,950910,1584851,"UZB",1267881
1,19.0,"India",4866972,4851533,15439,3817265,6362108,"IND",5089687
1,20.0,"Western Europe",2956757,2956580,177,2201059,3668432,"NLD",2934746
1,20.0,"Western Africa",223867,0,223867,162462,270771,"NGA",216617
1,20.0,"Oceania",412056,412056,0,292238,487063,"NZL",389651
1,20.0,"South America",1646199,1304743,341456,1271164,2118607,"BRA",1694886
1,20.0,"Northern Africa",1130700,0,1130700,820571,1367618,"EGY",1094095
1,20.0,"Southern Asia",411865,0,411865,298897,498162,"IRN",398530
1,20.0,"Eastern Europe",3706226,3205006,501220,2880021,4800036,"POL",3840029
1,20.0,"Middle Africa",49430,0,49430,35870,59783,"AGO",47827
1,20.0,"Central America",392906,0,392906,285138,475230,"MEX",380184
1,20.0,"Southern Africa",114433,0,114433,83046,138410,"ZAF",110728
1,20.0,"South-Eastern Asia",574056,0,574056,416601,694336,"IDN",555469
1,20.0,"China",9251624,8752502,499122,7340573,12234288,"CPR",9787431
1,20.0,"Pakistan",1485801,1251268,234533,1177605,1962676,"PAK",1570141
1,20.0,"Eastern Asia",995783,0,995783,722660,1204433,"JPN",963547
1,20.0,"Russian Federation",3972084,3466559,505525,3136330,5227217,"RUS",4181774
1,20.0,"Western Asia",202603,0,202603,147031,245052,"IRQ",196042
1,20.0,"Southern Europe",367515,0,367515,266713,444522,"ITA",355618
1,20.0,"Eastern Africa",128551,0,128551,93290,155483,"ETH",124387
1,20.0,"Northern America",801959,801959,0,585372,975620,"CAN",780496
1,20.0,"Northern Europe",1621808,1621808,0,1216355,2027258,"GBR",1621807
1,20.0,"United States of America",2979911,2979911,0,2133588,3555980,"USA",2844784
1,20.0,"Central Asia",1201325,1099407,101918,950910,1584851,"UZB",1267881
1,20.0,"India",4855138,4839781,15357,3817265,6362108,"IND",5089687
1,21.0,"Western Europe",2942083,2942083,0,2201059,3668432,"NLD",2934746
1,21.0,"Western Africa",224400,0,224400,162462,270771,"NGA",216617
1,21.0,"Oceania",415953,415953,0,292238,487063,"NZL",389651
1,21.0,"South America",1646943,1304743,342200,1271164,2118607,"BRA",1694886
1,21.0,"Northern Africa",1133383,0,1133383,820571,1367618,"EGY",1094095
1,21.0,"Southern Asia",412842,0,412842,298897,498162,"IRN",398530
1,21.0,"Eastern Europe",3707363,3205006,502357,2880021,4800036,"POL",3840029
1,21.0,"Middle Africa",49547,0,49547,35870,59783,"AGO",47827
1,21.0,"Central America",393839,0,393839,285138,475230,"MEX",380184
1,21.0,"Southern Africa",114704,0,114704,83046,138410,"ZAF",110728
1,21.0,"South-Eastern Asia",575418,0,575418,416601,694336,"IDN",555469
1,21.0,"China",9232204,8758810,473394,7340573,12234288,"CPR",9787431
1,21.0,"Pakistan",1483402,1249879,233523,1177605,1962676,"PAK",1570141
1,21.0,"Eastern Asia",998145,0,998145,722660,1204433,"JPN",963547
1,21.0,"Russian Federation",3965190,3468976,496214,3136330,5227217,"RUS",4181774
1,21.0,"Western Asia",203083,0,203083,147031,245052,"IRQ",196042
1,21.0,"Southern Europe",368386,0,368386,266713,444522,"ITA",355618
1,21.0,"Eastern Africa",128856,0,128856,93290,155483,"ETH",124387
1,21.0,"Northern America",803910,803910,0,585372,975620,"CAN",780496
1,21.0,"Northern Europe",1621808,1621808,0,1216355,2027258,"GBR",1621807
1,21.0,"United States of America",2994135,2994135,0,2133588,3555980,"USA",2844784
1,21.0,"Central Asia",1201721,1099407,102314,950910,1584851,"UZB",1267881
1,21.0,"India",4856014,4839847,16167,3817265,6362108,"IND",5089687
1,22.0,"Western Europe",2964094,2964094,0,2201059,3668432,"NLD",2934746
1,22.0,"Western Africa",224726,0,224726,162462,270771,"NGA",216617
1,22.0,"Oceania",414979,414979,0,292238,487063,"NZL",389651
1,22.0,"South America",1647660,1304743,342917,1271164,2118607,"BRA",1694886
1,22.0,"Northern Africa",1135029,0,1135029,820571,1367618,"EGY",1094095
1,22.0,"Southern Asia",413441,0,413441,298897,498162,"IRN",398530
1,22.0,"Eastern Europe",3724641,3210029,514612,2880021,4800036,"POL",3840029
1,22.0,"Middle Africa",49618,0,49618,35870,59783,"AGO",47827
1,22.0,"Central America",394410,0,394410,285138,475230,"MEX",380184
1,22.0,"Southern Africa",114871,0,114871,83046,138410,"ZAF",110728
1,22.0,"South-Eastern Asia",576283,0,576283,416601,694336,"IDN",555469
1,22.0,"China",9211874,8764557,447317,7340573,12234288,"CPR",9787431
1,22.0,"Pakistan",1483865,1251055,232810,1177605,1962676,"PAK",1570141
1,22.0,"Eastern Asia",999595,0,999595,722660,1204433,"JPN",963547
1,22.0,"Russian Federation",3957615,3469019,488596,3136330,5227217,"RUS",4181774
1,22.0,"Western Asia",203378,0,203378,147031,245052,"IRQ",196042
1,22.0,"Southern Europe",368920,0,368920,266713,444522,"ITA",355618
1,22.0,"Eastern Africa",129043,0,129043,93290,155483,"ETH",124387
1,22.0,"Northern America",803910,803910,0,585372,975620,"CAN",780496
1,22.0,"Northern Europe",1617753,1617753,0,1216355,2027258,"GBR",1621807
1,22.0,"United States of America",2994135,2994135,0,2133588,3555980,"USA",2844784
1,22.0,"Central Asia",1201963,1099407,102556,950910,1584851,"UZB",1267881
1,22.0,"India",4856097,4839783,16314,3817265,6362108,"IND",5089687
1,23.0,"Western Europe",2956757,2956757,0,2201059,3668432,"NLD",2934746
1,23.0,"Western Africa",225223,0,225223,162462,270771,"NGA",216617
1,23.0,"Oceania",414005,414005,0,292238,487063,"NZL",389651
1,23.0,"South America",1648644,1304743,343901,1271164,2118607,"BRA",1694886
1,23.0,"Northern Africa",1137542,0,1137542,820571,1367618,"EGY",1094095
1,23.0,"Southern Asia",414356,0,414356,298897,498162,"IRN",398530
1,23.0,"Eastern Europe",3726173,3210601,515572,2880021,4800036,"POL",3840029
1,23.0,"Middle Africa",49728,0,49728,35870,59783,"AGO",47827
1,23.0,"Central America",395283,0,395283,285138,475230,"MEX",380184
1,23.0,"Southern Africa",115125,0,115125,83046,138410,"ZAF",110728
1,23.0,"South-Eastern Asia",577529,0,577529,416601,694336,"IDN",555469
1,23.0,"China",9170320,8748385,421935,7340573,12234288,"CPR",9787431
1,23.0,"Pakistan",1484573,1251055,233518,1177605,1962676,"PAK",1570141
1,23.0,"Eastern Asia",1001807,0,1001807,722660,1204433,"JPN",963547
1,23.0,"Russian Federation",3959226,3466482,492744,3136330,5227217,"RUS",4181774
1,23.0,"Western Asia",203830,0,203830,147031,245052,"IRQ",196042
1,23.0,"Southern Europe",369738,0,369738,266713,444522,"ITA",355618
1,23.0,"Eastern Africa",129329,0,129329,93290,155483,"ETH",124387
1,23.0,"Northern America",807813,807813,0,585372,975620,"CAN",780496
1,23.0,"Northern Europe",1621808,1621808,0,1216355,2027258,"GBR",1621807
1,23.0,"United States of America",3008359,3008359,0,2133588,3555980,"USA",2844784
1,23.0,"Central Asia",1202332,1099407,102925,950910,1584851,"UZB",1267881
1,23.0,"India",4856778,4839362,17416,3817265,6362108,"IND",5089687
1,24.0,"Western Europe",2964094,2964094,0,2201059,3668432,"NLD",2934746
1,24.0,"Western Africa",221129,0,221129,162462,270771,"NGA",216617
1,24.0,"Oceania",398418,398418,0,292238,487063,"NZL",389651
1,24.0,"South America",1666891,1305600,361291,1271164,2118607,"BRA",1694886
1,24.0,"Northern Africa",1116875,0,1116875,820571,1367618,"EGY",1094095
1,24.0,"Southern Asia",406829,0,406829,298897,498162,"IRN",398530
1,24.0,"Eastern Europe",3762912,3207897,555015,2880021,4800036,"POL",3840029
1,24.0,"Middle Africa",48826,0,48826,35870,59783,"AGO",47827
1,24.0,"Central America",388101,0,388101,285138,475230,"MEX",380184
1,24.0,"Southern Africa",113037,0,113037,83046,138410,"ZAF",110728
1,24.0,"South-Eastern Asia",567224,0,567224,416601,694336,"IDN",555469
1,24.0,"China",9216813,8764912,451901,7340573,12234288,"CPR",9787431
1,24.0,"Pakistan",1507140,1254072,253068,1177605,1962676,"PAK",1570141
1,24.0,"Eastern Asia",983608,0,983608,722660,1204433,"JPN",963547
1,24.0,"Russian Federation",4014977,3471032,543945,3136330,5227217,"RUS",4181774
1,24.0,"Western Asia",200123,0,200123,147031,245052,"IRQ",196042
1,24.0,"Southern Europe",363023,0,363023,266713,444522,"ITA",355618
1,24.0,"Eastern Africa",126980,0,126980,93290,155483,"ETH",124387
1,24.0,"Northern America",790252,790252,0,585372,975620,"CAN",780496
1,24.0,"Northern Europe",1617752,1617752,0,1216355,2027258,"GBR",1621807
1,24.0,"United States of America",2937239,2937239,0,2133588,3555980,"USA",2844784
1,24.0,"Central Asia",1213121,1100743,112378,950910,1584851,"UZB",1267881
1,24.0,"India",4864030,4838274,25756,3817265,6362108,"IND",5089687
1,25.0,"Western Europe",2934746,2934746,0,2201059,3668432,"NLD",2934746
1,25.0,"Western Africa",217505,0,217505,162462,270771,"NGA",216617
1,25.0,"Oceania",387702,387702,0,292238,487063,"NZL",389651
1,25.0,"South America",1677039,1304223,372816,1271164,2118607,"BRA",1694886
1,25.0,"Northern Africa",1098560,0,1098560,820571,1367618,"EGY",1094095
1,25.0,"Southern Asia",400161,0,400161,298897,498162,"IRN",398530
1,25.0,"Eastern Europe",3793774,3215674,578100,2880021,4800036,"POL",3840029
1,25.0,"Middle Africa",48027,0,48027,35870,59783,"AGO",47827
1,25.0,"Central America",381738,0,381738,285138,475230,"MEX",380184
1,25.0,"Southern Africa",111181,0,111181,83046,138410,"ZAF",110728
1,25.0,"South-Eastern Asia",557824,0,557824,416601,694336,"IDN",555469
1,25.0,"China",9287430,8767349,520081,7340573,12234288,"CPR",9787431
1,25.0,"Pakistan",1524068,1254888,269180,1177605,1962676,"PAK",1570141
1,25.0,"Eastern Asia",967481,0,967481,722660,1204433,"JPN",963547
1,25.0,"Russian Federation",4046190,3464365,581825,3136330,5227217,"RUS",4181774
1,25.0,"Western Asia",196848,0,196848,147031,245052,"IRQ",196042
1,25.0,"Southern Europe",357073,0,357073,266713,444522,"ITA",355618
1,25.0,"Eastern Africa",124899,0,124899,93290,155483,"ETH",124387
1,25.0,"Northern America",782448,780126,2322,585372,975620,"CAN",780496
1,25.0,"Northern Europe",1621805,1619856,1949,1216355,2027258,"GBR",1621807
1,25.0,"United States of America",2873232,2873232,0,2133588,3555980,"USA",2844784
1,25.0,"Central Asia",1224260,1102222,122038,950910,1584851,"UZB",1267881
1,25.0,"India",4884564,4841842,42722,3817265,6362108,"IND",5089687
1,26.0,"Western Europe",2920072,2920072,0,2201059,3668432,"NLD",2934746
1,26.0,"Western Africa",214600,0,214600,162462,270771,"NGA",216617
1,26.0,"Oceania",378936,378936,0,292238,487063,"NZL",389651
1,26.0,"South America",1685767,1306728,379039,1271164,2118607,"BRA",1694886
1,26.0,"Northern Africa",1083890,0,1083890,820571,1367618,"EGY",1094095
1,26.0,"Southern Asia",394815,0,394815,298897,498162,"IRN",398530
1,26.0,"Eastern Europe",3811710,3219479,592231,2880021,4800036,"POL",3840029
1,26.0,"Middle Africa",47383,0,47383,35870,59783,"AGO",47827
1,26.0,"Central America",376638,0,376638,285138,475230,"MEX",380184
1,26.0,"Southern Africa",109699,0,109699,83046,138410,"ZAF",110728
1,26.0,"South-Eastern Asia",550275,0,550275,416601,694336,"IDN",555469
1,26.0,"China",9339518,8768293,571225,7340573,12234288,"CPR",9787431
1,26.0,"Pakistan",1535712,1257192,278520,1177605,1962676,"PAK",1570141
1,26.0,"Eastern Asia",954558,0,954558,722660,1204433,"JPN",963547
1,26.0,"Russian Federation",4071177,3465051,606126,3136330,5227217,"RUS",4181774
1,26.0,"Western Asia",194215,0,194215,147031,245052,"IRQ",196042
1,26.0,"Southern Europe",352303,0,352303,266713,444522,"ITA",355618
1,26.0,"Eastern Africa",123229,0,123229,93290,155483,"ETH",124387
1,26.0,"Northern America",776595,771940,4655,585372,975620,"CAN",780496
1,26.0,"Northern Europe",1625861,1619708,6153,1216355,2027258,"GBR",1621807
1,26.0,"United States of America",2816336,2816336,0,2133588,3555980,"USA",2844784
1,26.0,"Central Asia",1230404,1101841,128563,950910,1584851,"UZB",1267881
1,26.0,"India",4905548,4845683,59865,3817265,6362108,"IND",5089687
1,27.0,"Western Europe",2890725,2890725,0,2201059,3668432,"NLD",2934746
1,27.0,"Western Africa",212767,0,212767,162462,270771,"NGA",216617
1,27.0,"Oceania",376013,376013,0,292238,487063,"NZL",389651
1,27.0,"South America",1686111,1305575,380536,1271164,2118607,"BRA",1694886
1,27.0,"Northern Africa",1074662,0,1074662,820571,1367618,"EGY",1094095
1,27.0,"Southern Asia",391450,0,391450,298897,498162,"IRN",398530
1,27.0,"Eastern Europe",3823474,3224073,599401,2880021,4800036,"POL",3840029
1,27.0,"Middle Africa",46975,0,46975,35870,59783,"AGO",47827
1,27.0,"Central America",373430,0,373430,285138,475230,"MEX",380184
1,27.0,"Southern Africa",108759,0,108759,83046,138410,"ZAF",110728
1,27.0,"South-Eastern Asia",545534,0,545534,416601,694336,"IDN",555469
1,27.0,"China",9374768,8763445,611323,7340573,12234288,"CPR",9787431
1,27.0,"Pakistan",1536271,1257615,278656,1177605,1962676,"PAK",1570141
1,27.0,"Eastern Asia",946433,0,946433,722660,1204433,"JPN",963547
1,27.0,"Russian Federation",4091090,3469921,621169,3136330,5227217,"RUS",4181774
1,27.0,"Western Asia",192557,0,192557,147031,245052,"IRQ",196042
1,27.0,"Southern Europe",349299,0,349299,266713,444522,"ITA",355618
1,27.0,"Eastern Africa",122176,0,122176,93290,155483,"ETH",124387
1,27.0,"Northern America",772690,765670,7020,585372,975620,"CAN",780496
1,27.0,"Northern Europe",1625863,1619719,6144,1216355,2027258,"GBR",1621807
1,27.0,"United States of America",2787888,2787888,0,2133588,3555980,"USA",2844784
1,27.0,"Central Asia",1237347,1104142,133205,950910,1584851,"UZB",1267881
1,27.0,"India",4915662,4840749,74913,3817265,6362108,"IND",5089687
1,28.0,"Western Europe",2883387,2883030,357,2201059,3668432,"NLD",2934746
1,28.0,"Western Africa",212041,0,212041,162462,270771,"NGA",216617
1,28.0,"Oceania",378936,378936,0,292238,487063,"NZL",389651
1,28.0,"South America",1684387,1304134,380253,1271164,2118607,"BRA",1694886
1,28.0,"Northern Africa",1070996,0,1070996,820571,1367618,"EGY",1094095
1,28.0,"Southern Asia",390114,0,390114,298897,498162,"IRN",398530
1,28.0,"Eastern Europe",3821041,3218571,602470,2880021,4800036,"POL",3840029
1,28.0,"Middle Africa",46816,0,46816,35870,59783,"AGO",47827
1,28.0,"Central America",372156,0,372156,285138,475230,"MEX",380184
1,28.0,"Southern Africa",108388,0,108388,83046,138410,"ZAF",110728
1,28.0,"South-Eastern Asia",543882,0,543882,416601,694336,"IDN",555469
1,28.0,"China",9415188,8768736,646452,7340573,12234288,"CPR",9787431
1,28.0,"Pakistan",1535238,1257570,277668,1177605,1962676,"PAK",1570141
1,28.0,"Eastern Asia",943203,0,943203,722660,1204433,"JPN",963547
1,28.0,"Russian Federation",4097339,3466119,631220,3136330,5227217,"RUS",4181774
1,28.0,"Western Asia",191898,0,191898,147031,245052,"IRQ",196042
1,28.0,"Southern Europe",348108,0,348108,266713,444522,"ITA",355618
1,28.0,"Eastern Africa",121760,0,121760,93290,155483,"ETH",124387
1,28.0,"Northern America",768787,760014,8773,585372,975620,"CAN",780496
1,28.0,"Northern Europe",1593426,1592149,1277,1216355,2027258,"GBR",1621807
1,28.0,"United States of America",2773665,2773665,0,2133588,3555980,"USA",2844784
1,28.0,"Central Asia",1242343,1105665,136678,950910,1584851,"UZB",1267881
1,28.0,"India",4939118,4849863,89255,3817265,6362108,"IND",5089687
1,29.0,"Western Europe",2876050,2875331,719,2201059,3668432,"NLD",2934746
1,29.0,"Western Africa",211135,0,211135,162462,270771,"NGA",216617
1,29.0,"Oceania",378936,378936,0,292238,487063,"NZL",389651
1,29.0,"South America",1683091,1304029,379062,1271164,2118607,"BRA",1694886
1,29.0,"Northern Africa",1066416,0,1066416,820571,1367618,"EGY",1094095
1,29.0,"Southern Asia",388446,0,388446,298897,498162,"IRN",398530
1,29.0,"Eastern Europe",3826644,3223220,603424,2880021,4800036,"POL",3840029
1,29.0,"Middle Africa",46615,0,46615,35870,59783,"AGO",47827
1,29.0,"Central America",370564,0,370564,285138,475230,"MEX",380184
1,29.0,"Southern Africa",107923,0,107923,83046,138410,"ZAF",110728
1,29.0,"South-Eastern Asia",541722,0,541722,416601,694336,"IDN",555469
1,29.0,"China",9454758,8779486,675272,7340573,12234288,"CPR",9787431
1,29.0,"Pakistan",1533949,1256329,277620,1177605,1962676,"PAK",1570141
1,29.0,"Eastern Asia",939168,0,939168,722660,1204433,"JPN",963547
1,29.0,"Russian Federation",4102984,3465448,637536,3136330,5227217,"RUS",4181774
1,29.0,"Western Asia",191080,0,191080,147031,245052,"IRQ",196042
1,29.0,"Southern Europe",346621,0,346621,266713,444522,"ITA",355618
1,29.0,"Eastern Africa",121237,0,121237,93290,155483,"ETH",124387
1,29.0,"Northern America",757081,750584,6497,585372,975620,"CAN",780496
1,29.0,"Northern Europe",1569099,1569099,0,1216355,2027258,"GBR",1621807
1,29.0,"United States of America",2773664,2773664,0,2133588,3555980,"USA",2844784
1,29.0,"Central Asia",1244433,1105416,139017,950910,1584851,"UZB",1267881
1,29.0,"India",4962370,4860064,102306,3817265,6362108,"IND",5089687
1,30.0,"Western Europe",2854040,2854040,0,2201059,3668432,"NLD",2934746
1,30.0,"Western Africa",210648,0,210648,162462,270771,"NGA",216617
1,30.0,"Oceania",380884,380884,0,292238,487063,"NZL",389651
1,30.0,"South America",1678731,1306765,371966,1271164,2118607,"BRA",1694886
1,30.0,"Northern Africa",1063960,0,1063960,820571,1367618,"EGY",1094095
1,30.0,"Southern Asia",387551,0,387551,298897,498162,"IRN",398530
1,30.0,"Eastern Europe",3825003,3223072,601931,2880021,4800036,"POL",3840029
1,30.0,"Middle Africa",46508,0,46508,35870,59783,"AGO",47827
1,30.0,"Central America",369711,0,369711,285138,475230,"MEX",380184
1,30.0,"Southern Africa",107677,0,107677,83046,138410,"ZAF",110728
1,30.0,"South-Eastern Asia",540462,0,540462,416601,694336,"IDN",555469
1,30.0,"China",9474393,8774715,699678,7340573,12234288,"CPR",9787431
1,30.0,"Pakistan",1536414,1256580,279834,1177605,1962676,"PAK",1570141
1,30.0,"Eastern Asia",937006,0,937006,722660,1204433,"JPN",963547
1,30.0,"Russian Federation",4110028,3468449,641579,3136330,5227217,"RUS",4181774
1,30.0,"Western Asia",190639,0,190639,147031,245052,"IRQ",196042
1,30.0,"Southern Europe",345820,0,345820,266713,444522,"ITA",355618
1,30.0,"Eastern Africa",120960,0,120960,93290,155483,"ETH",124387
1,30.0,"Northern America",760982,753778,7204,585372,975620,"CAN",780496
1,30.0,"Northern Europe",1569098,1569098,0,1216355,2027258,"GBR",1621807
1,30.0,"United States of America",2759441,2759441,0,2133588,3555980,"USA",2844784
1,30.0,"Central Asia",1246842,1106018,140824,950910,1584851,"UZB",1267881
1,30.0,"India",4973964,4859511,114453,3817265,6362108,"IND",5089687
1,31.0,"Western Europe",2846704,2846704,0,2201059,3668432,"NLD",2934746
1,31.0,"Western Africa",210340,0,210340,162462,270771,"NGA",216617
1,31.0,"Oceania",381858,381858,0,292238,487063,"NZL",389651
1,31.0,"South America",1671512,1306403,365109,1271164,2118607,"BRA",1694886
1,31.0,"Northern Africa",1062404,0,1062404,820571,1367618,"EGY",1094095
1,31.0,"Southern Asia",386983,0,386983,298897,498162,"IRN",398530
1,31.0,"Eastern Europe",3799661,3217742,581919,2880021,4800036,"POL",3840029
1,31.0,"Middle Africa",46440,0,46440,35870,59783,"AGO",47827
1,31.0,"Central America",369169,0,369169,285138,475230,"MEX",380184
1,31.0,"Southern Africa",107519,0,107519,83046,138410,"ZAF",110728
1,31.0,"South-Eastern Asia",539661,0,539661,416601,694336,"IDN",555469
1,31.0,"China",9494863,8773082,721781,7340573,12234288,"CPR",9787431
1,31.0,"Pakistan",1539128,1257870,281258,1177605,1962676,"PAK",1570141
1,31.0,"Eastern Asia",935636,0,935636,722660,1204433,"JPN",963547
1,31.0,"Russian Federation",4109319,3465292,644027,3136330,5227217,"RUS",4181774
1,31.0,"Western Asia",190361,0,190361,147031,245052,"IRQ",196042
1,31.0,"Southern Europe",345316,0,345316,266713,444522,"ITA",355618
1,31.0,"Eastern Africa",120782,0,120782,93290,155483,"ETH",124387
1,31.0,"Northern America",757080,752137,4943,585372,975620,"CAN",780496
1,31.0,"Northern Europe",1569099,1569099,0,1216355,2027258,"GBR",1621807
1,31.0,"United States of America",2759440,2759440,0,2133588,3555980,"USA",2844784
1,31.0,"Central Asia",1249376,1107191,142185,950910,1584851,"UZB",1267881
1,31.0,"India",4986208,4859608,126600,3817265,6362108,"IND",5089687
1,32.0,"Western Europe",2861377,2861377,0,2201059,3668432,"NLD",2934746
1,32.0,"Western Africa",210720,0,210720,162462,270771,"NGA",216617
1,32.0,"Oceania",377961,377961,0,292238,487063,"NZL",389651
1,32.0,"South America",1666019,1305767,360252,1271164,2118607,"BRA",1694886
1,32.0,"Northern Africa",1064316,0,1064316,820571,1367618,"EGY",1094095
1,32.0,"Southern Asia",387680,0,387680,298897,498162,"IRN",398530
1,32.0,"Eastern Europe",3728251,3165903,562348,2880021,4800036,"POL",3840029
1,32.0,"Middle Africa",46522,0,46522,35870,59783,"AGO",47827
1,32.0,"Central America",369834,0,369834,285138,475230,"MEX",380184
1,32.0,"Southern Africa",107712,0,107712,83046,138410,"ZAF",110728
1,32.0,"South-Eastern Asia",540597,0,540597,416601,694336,"IDN",555469
1,32.0,"China",9518814,8773883,744931,7340573,12234288,"CPR",9787431
1,32.0,"Pakistan",1542821,1260001,282820,1177605,1962676,"PAK",1570141
1,32.0,"Eastern Asia",937322,0,937322,722660,1204433,"JPN",963547
1,32.0,"Russian Federation",4119297,3471271,648026,3136330,5227217,"RUS",4181774
1,32.0,"Western Asia",190705,0,190705,147031,245052,"IRQ",196042
1,32.0,"Southern Europe",345936,0,345936,266713,444522,"ITA",355618
1,32.0,"Eastern Africa",120997,0,120997,93290,155483,"ETH",124387
1,32.0,"Northern America",759032,756380,2652,585372,975620,"CAN",780496
1,32.0,"Northern Europe",1573151,1572681,470,1216355,2027258,"GBR",1621807
1,32.0,"United States of America",2766553,2766553,0,2133588,3555980,"USA",2844784
1,32.0,"Central Asia",1249660,1106066,143594,950910,1584851,"UZB",1267881
1,32.0,"India",4999386,4859766,139620,3817265,6362108,"IND",5089687
1,33.0,"Western Europe",2861378,2861378,0,2201059,3668432,"NLD",2934746
1,33.0,"Western Africa",211129,0,211129,162462,270771,"NGA",216617
1,33.0,"Oceania",378936,378936,0,292238,487063,"NZL",389651
1,33.0,"South America",1660064,1305774,354290,1271164,2118607,"BRA",1694886
1,33.0,"Northern Africa",1066381,0,1066381,820571,1367618,"EGY",1094095
1,33.0,"Southern Asia",388433,0,388433,298897,498162,"IRN",398530
1,33.0,"Eastern Europe",3673959,3117437,556522,2880021,4800036,"POL",3840029
1,33.0,"Middle Africa",46614,0,46614,35870,59783,"AGO",47827
1,33.0,"Central America",370553,0,370553,285138,475230,"MEX",380184
1,33.0,"Southern Africa",107922,0,107922,83046,138410,"ZAF",110728
1,33.0,"South-Eastern Asia",541623,0,541623,416601,694336,"IDN",555469
1,33.0,"China",9542817,8773971,768846,7340573,12234288,"CPR",9787431
1,33.0,"Pakistan",1546558,1262172,284386,1177605,1962676,"PAK",1570141
1,33.0,"Eastern Asia",939142,0,939142,722660,1204433,"JPN",963547
1,33.0,"Russian Federation",4120627,3468631,651996,3136330,5227217,"RUS",4181774
1,33.0,"Western Asia",191074,0,191074,147031,245052,"IRQ",196042
1,33.0,"Southern Europe",346609,0,346609,266713,444522,"ITA",355618
1,33.0,"Eastern Africa",121236,0,121236,93290,155483,"ETH",124387
1,33.0,"Northern America",760982,760666,316,585372,975620,"CAN",780496
1,33.0,"Northern Europe",1577207,1575320,1887,1216355,2027258,"GBR",1621807
1,33.0,"United States of America",2773664,2773664,0,2133588,3555980,"USA",2844784
1,33.0,"Central Asia",1252733,1107425,145308,950910,1584851,"UZB",1267881
1,33.0,"India",5011880,4859126,152754,3817265,6362108,"IND",5089687
1,34.0,"Western Europe",2839367,2839367,0,2201059,3668432,"NLD",2934746
1,34.0,"Western Africa",210434,0,210434,162462,270771,"NGA",216617
1,34.0,"Oceania",377961,377961,0,292238,487063,"NZL",389651
1,34.0,"South America",1654649,1305131,349518,1271164,2118607,"BRA",1694886
1,34.0,"Northern Africa",1062883,0,1062883,820571,1367618,"EGY",1094095
1,34.0,"Southern Asia",387159,0,387159,298897,498162,"IRN",398530
1,34.0,"Eastern Europe",3672579,3111016,561563,2880021,4800036,"POL",3840029
1,34.0,"Middle Africa",46458,0,46458,35870,59783,"AGO",47827
1,34.0,"Central America",369336,0,369336,285138,475230,"MEX",380184
1,34.0,"Southern Africa",107566,0,107566,83046,138410,"ZAF",110728
1,34.0,"South-Eastern Asia",539823,0,539823,416601,694336,"IDN",555469
1,34.0,"China",9561437,8773378,788059,7340573,12234288,"CPR",9787431
1,34.0,"Pakistan",1545574,1261204,284370,1177605,1962676,"PAK",1570141
1,34.0,"Eastern Asia",936058,0,936058,722660,1204433,"JPN",963547
1,34.0,"Russian Federation",4118292,3464755,653537,3136330,5227217,"RUS",4181774
1,34.0,"Western Asia",190448,0,190448,147031,245052,"IRQ",196042
1,34.0,"Southern Europe",346242,0,346242,266713,444522,"ITA",355618
1,34.0,"Eastern Africa",120837,0,120837,93290,155483,"ETH",124387
1,34.0,"Northern America",753179,753179,0,585372,975620,"CAN",780496
1,34.0,"Northern Europe",1581261,1577468,3793,1216355,2027258,"GBR",1621807
1,34.0,"United States of America",2780776,2780776,0,2133588,3555980,"USA",2844784
1,34.0,"Central Asia",1252653,1106020,146633,950910,1584851,"UZB",1267881
1,34.0,"India",5023798,4858392,165406,3817265,6362108,"IND",5089687
1,35.0,"Western Europe",2824693,2824693,0,2201065,3668442,"NLD",2934754
1,35.0,"Western Africa",209991,0,209991,162468,270780,"NGA",216624
1,35.0,"Oceania",379910,379910,0,292239,487065,"NZL",389652
1,35.0,"South America",1650685,1304987,345698,1271166,2118611,"BRA",1694889
1,35.0,"Northern Africa",1060643,0,1060643,820573,1367622,"EGY",1094098
1,35.0,"Southern Asia",386343,0,386343,298901,498168,"IRN",398535
1,35.0,"Eastern Europe",3693719,3112624,581095,2880024,4800041,"POL",3840033
1,35.0,"Middle Africa",46364,0,46364,35875,59792,"AGO",47834
1,35.0,"Central America",368560,0,368560,285144,475241,"MEX",380193
1,35.0,"Southern Africa",107341,0,107341,83051,138418,"ZAF",110735
1,35.0,"South-Eastern Asia",538673,0,538673,416605,694342,"IDN",555474
1,35.0,"China",9581284,8777150,804134,7340574,12234290,"CPR",9787432
1,35.0,"Pakistan",1548099,1264164,283935,1177614,1962690,"PAK",1570152
1,35.0,"Eastern Asia",934088,0,934088,722662,1204437,"JPN",963550
1,35.0,"Russian Federation",4125471,3471412,654059,3136332,5227221,"RUS",4181777
1,35.0,"Western Asia",190046,0,190046,147036,245060,"IRQ",196048
1,35.0,"Southern Europe",345304,0,345304,266718,444530,"ITA",355624
1,35.0,"Eastern Africa",120582,0,120582,93297,155496,"ETH",124397
1,35.0,"Northern America",762934,760628,2306,585372,975621,"CAN",780497
1,35.0,"Northern Europe",1581261,1576944,4317,1216362,2027271,"GBR",1621817
1,35.0,"United States of America",2752329,2752329,0,2133591,3555986,"USA",2844789
1,35.0,"Central Asia",1256519,1107428,149091,950912,1584853,"UZB",1267883
1,35.0,"India",5034829,4858164,176665,3817269,6362115,"IND",5089692
1,36.0,"Western Europe",2817356,2817356,0,2237714,3729523,"NLD",2983619
1,36.0,"Western Africa",209322,0,209322,121468,202447,"NGA",161958
1,36.0,"Oceania",376988,376988,0,241125,401876,"NZL",321501
1,36.0,"South America",1646688,1305920,340768,1217311,2028852,"BRA",1623082
1,36.0,"Northern Africa",1057252,0,1057252,860613,1434355,"EGY",1147484
1,36.0,"Southern Asia",385108,0,385108,306879,511465,"IRN",409172
1,36.0,"Eastern Europe",3709264,3112157,597107,2812445,4687408,"POL",3749927
1,36.0,"Middle Africa",46216,0,46216,37414,62357,"AGO",49886
1,36.0,"Central America",367380,0,367380,262271,437118,"MEX",349695
1,36.0,"Southern Africa",106996,0,106996,54255,90425,"ZAF",72340
1,36.0,"South-Eastern Asia",537003,0,537003,460368,767280,"IDN",613824
1,36.0,"China",9600171,8784218,815953,6843204,11405340,"CPR",9124272
1,36.0,"Pakistan",1547142,1265002,282140,1143795,1906326,"PAK",1525061
1,36.0,"Eastern Asia",931060,0,931060,755292,1258820,"JPN",1007056
1,36.0,"Russian Federation",4114673,3463231,651442,2215581,3692636,"RUS",2954109
1,36.0,"Western Asia",189437,0,189437,563,938,"IRQ",751
1,36.0,"Southern Europe",344452,0,344452,231532,385887,"ITA",308710
1,36.0,"Eastern Africa",120198,0,120198,123050,205083,"ETH",164067
1,36.0,"Northern America",760982,758073,2909,469140,781900,"CAN",625520
1,36.0,"Northern Europe",1573153,1573153,0,1214830,2024717,"GBR",1619774
1,36.0,"United States of America",2745216,2745216,0,2125222,3542037,"USA",2833630
1,36.0,"Central Asia",1259021,1108154,150867,837580,1395967,"UZB",1116774
1,36.0,"India",5046380,4859335,187045,3637043,6061738,"IND",4849391
1,37.0,"Western Europe",2824700,2824157,543,2237714,3729523,"NLD",2983619
1,37.0,"Western Africa",209293,0,209293,121468,202447,"NGA",161958
1,37.0,"Oceania",380885,380885,0,241125,401876,"NZL",321501
1,37.0,"South America",1639389,1303365,336024,1217311,2028852,"BRA",1623082
1,37.0,"Northern Africa",1057089,0,1057089,860613,1434355,"EGY",1147484
1,37.0,"Southern Asia",385051,0,385051,306879,511465,"IRN",409172
1,37.0,"Eastern Europe",3726464,3114727,611737,2812445,4687408,"POL",3749927
1,37.0,"Middle Africa",46215,0,46215,37414,62357,"AGO",49886
1,37.0,"Central America",367330,0,367330,262271,437118,"MEX",349695
1,37.0,"Southern Africa",106988,0,106988,54255,90425,"ZAF",72340
1,37.0,"South-Eastern Asia",537004,0,537004,460368,767280,"IDN",613824
1,37.0,"China",9600196,8775618,824578,6843204,11405340,"CPR",9124272
1,37.0,"Pakistan",1543952,1263581,280371,1143795,1906326,"PAK",1525061
1,37.0,"Eastern Asia",931427,0,931427,755292,1258820,"JPN",1007056
1,37.0,"Russian Federation",4106254,3468078,638176,2215581,3692636,"RUS",2954109
1,37.0,"Western Asia",189415,0,189415,563,938,"IRQ",751
1,37.0,"Southern Europe",343978,0,343978,231532,385887,"ITA",308710
1,37.0,"Eastern Africa",120185,0,120185,123050,205083,"ETH",164067
1,37.0,"Northern America",751228,750180,1048,469140,781900,"CAN",625520
1,37.0,"Northern Europe",1560999,1560999,0,1214830,2024717,"GBR",1619774
1,37.0,"United States of America",2752334,2752334,0,2125222,3542037,"USA",2833630
1,37.0,"Central Asia",1256109,1107700,148409,837580,1395967,"UZB",1116774
1,37.0,"India",5056438,4862169,194269,3637043,6061738,"IND",4849391
1,38.0,"Western Europe",2917586,2916479,1107,2237714,3729523,"NLD",2983619
1,38.0,"Western Africa",165705,0,165705,121468,202447,"NGA",161958
1,38.0,"Oceania",341957,341957,0,241125,401876,"NZL",321501
1,38.0,"South America",1640336,1305058,335278,1217311,2028852,"BRA",1623082
1,38.0,"Northern Africa",1166398,0,1166398,860613,1434355,"EGY",1147484
1,38.0,"Southern Asia",416061,0,416061,306879,511465,"IRN",409172
1,38.0,"Eastern Europe",3763372,3139598,623774,2812445,4687408,"POL",3749927
1,38.0,"Middle Africa",50708,0,50708,37414,62357,"AGO",49886
1,38.0,"Central America",356271,0,356271,262271,437118,"MEX",349695
1,38.0,"Southern Africa",74256,0,74256,54255,90425,"ZAF",72340
1,38.0,"South-Eastern Asia",623293,0,623293,460368,767280,"IDN",613824
1,38.0,"China",9603351,8771550,831801,6843204,11405340,"CPR",9124272
1,38.0,"Pakistan",1543013,1263745,279268,1143795,1906326,"PAK",1525061
1,38.0,"Eastern Asia",1023709,0,1023709,755292,1258820,"JPN",1007056
1,38.0,"Russian Federation",3951524,3471264,480260,2215581,3692636,"RUS",2954109
1,38.0,"Western Asia",5676,0,5676,563,938,"IRQ",751
1,38.0,"Southern Europe",314365,0,314365,231532,385887,"ITA",308710
1,38.0,"Eastern Africa",166214,0,166214,123050,205083,"ETH",164067
1,38.0,"Northern America",686008,686008,0,469140,781900,"CAN",625520
1,38.0,"Northern Europe",1563011,1563011,0,1214830,2024717,"GBR",1619774
1,38.0,"United States of America",2840742,2840742,0,2125222,3542037,"USA",2833630
1,38.0,"Central Asia",1240854,1106427,134427,837580,1395967,"UZB",1116774
1,38.0,"India",5032137,4857723,174414,3637043,6061738,"IND",4849391
1,39.0,"Western Europe",2983618,2974557,9061,2237714,3729523,"NLD",2983619
1,39.0,"Western Africa",167511,0,167511,121468,202447,"NGA",161958
1,39.0,"Oceania",336113,336113,0,241125,401876,"NZL",321501
1,39.0,"South America",1645312,1304391,340921,1217311,2028852,"BRA",1623082
1,39.0,"Northern Africa",1175933,0,1175933,860613,1434355,"EGY",1147484
1,39.0,"Southern Asia",419538,0,419538,306879,511465,"IRN",409172
1,39.0,"Eastern Europe",3782415,3136322,646093,2812445,4687408,"POL",3749927
1,39.0,"Middle Africa",51135,0,51135,37414,62357,"AGO",49886
1,39.0,"Central America",359583,0,359583,262271,437118,"MEX",349695
1,39.0,"Southern Africa",75222,0,75222,54255,90425,"ZAF",72340
1,39.0,"South-Eastern Asia",628457,0,628457,460368,767280,"IDN",613824
1,39.0,"China",9633602,8787188,846414,6843204,11405340,"CPR",9124272
1,39.0,"Pakistan",1548851,1264733,284118,1143795,1906326,"PAK",1525061
1,39.0,"Eastern Asia",1032482,0,1032482,755292,1258820,"JPN",1007056
1,39.0,"Russian Federation",3728887,3370496,358391,2215581,3692636,"RUS",2954109
1,39.0,"Western Asia",5408,0,5408,563,938,"IRQ",751
1,39.0,"Southern Europe",316752,0,316752,231532,385887,"ITA",308710
1,39.0,"Eastern Africa",167305,0,167305,123050,205083,"ETH",164067
1,39.0,"Northern America",668447,668447,0,469140,781900,"CAN",625520
1,39.0,"Northern Europe",1603555,1598601,4954,1214830,2024717,"GBR",1619774
1,39.0,"United States of America",2904752,2899165,5587,2125222,3542037,"USA",2833630
1,39.0,"Central Asia",1232204,1107036,125168,837580,1395967,"UZB",1116774
1,39.0,"India",5023396,4851574,171822,3637043,6061738,"IND",4849391
1,40.0,"Western Europe",3027639,3009628,18011,2237714,3729523,"NLD",2983619
1,40.0,"Western Africa",169027,0,169027,121468,202447,"NGA",161958
1,40.0,"Oceania",336114,335173,941,241125,401876,"NZL",321501
1,40.0,"South America",1656203,1304718,351485,1217311,2028852,"BRA",1623082
1,40.0,"Northern Africa",1183164,0,1183164,860613,1434355,"EGY",1147484
1,40.0,"Southern Asia",422169,0,422169,306879,511465,"IRN",409172
1,40.0,"Eastern Europe",3799522,3141249,658273,2812445,4687408,"POL",3749927
1,40.0,"Middle Africa",51447,0,51447,37414,62357,"AGO",49886
1,40.0,"Central America",362094,0,362094,262271,437118,"MEX",349695
1,40.0,"Southern Africa",75954,0,75954,54255,90425,"ZAF",72340
1,40.0,"South-Eastern Asia",631894,0,631894,460368,767280,"IDN",613824
1,40.0,"China",9639862,8775836,864026,6843204,11405340,"CPR",9124272
1,40.0,"Pakistan",1554044,1264067,289977,1143795,1906326,"PAK",1525061
1,40.0,"Eastern Asia",1038465,0,1038465,755292,1258820,"JPN",1007056
1,40.0,"Russian Federation",3126914,2851196,275718,2215581,3692636,"RUS",2954109
1,40.0,"Western Asia",6271,0,6271,563,938,"IRQ",751
1,40.0,"Southern Europe",319487,0,319487,231532,385887,"ITA",308710
1,40.0,"Eastern Africa",168125,0,168125,123050,205083,"ETH",164067
1,40.0,"Northern America",662595,660789,1806,469140,781900,"CAN",625520
1,40.0,"Northern Europe",1640045,1630179,9866,1214830,2024717,"GBR",1619774
1,40.0,"United States of America",2933199,2919317,13882,2125222,3542037,"USA",2833630
1,40.0,"Central Asia",1224160,1107018,117142,837580,1395967,"UZB",1116774
1,40.0,"India",5233141,5060001,173140,3637043,6061738,"IND",4849391
1,41.0,"Western Europe",3071663,3044922,26741,2237714,3729523,"NLD",2983619
1,41.0,"Western Africa",169677,0,169677,121468,202447,"NGA",161958
1,41.0,"Oceania",338062,336205,1857,241125,401876,"NZL",321501
1,41.0,"South America",1662426,1302986,359440,1217311,2028852,"BRA",1623082
1,41.0,"Northern Africa",1186467,0,1186467,860613,1434355,"EGY",1147484
1,41.0,"Southern Asia",423375,0,423375,306879,511465,"IRN",409172
1,41.0,"Eastern Europe",3817292,3147908,669384,2812445,4687408,"POL",3749927
1,41.0,"Middle Africa",51594,0,51594,37414,62357,"AGO",49886
1,41.0,"Central America",363243,0,363243,262271,437118,"MEX",349695
1,41.0,"Southern Africa",76288,0,76288,54255,90425,"ZAF",72340
1,41.0,"South-Eastern Asia",633354,0,633354,460368,767280,"IDN",613824
1,41.0,"China",9664422,8789742,874680,6843204,11405340,"CPR",9124272
1,41.0,"Pakistan",1558127,1262278,295849,1143795,1906326,"PAK",1525061
1,41.0,"Eastern Asia",1041010,0,1041010,755292,1258820,"JPN",1007056
1,41.0,"Russian Federation",2958939,2695655,263284,2215581,3692636,"RUS",2954109
1,41.0,"Western Asia",7651,0,7651,563,938,"IRQ",751
1,41.0,"Southern Europe",321380,0,321380,231532,385887,"ITA",308710
1,41.0,"Eastern Africa",168502,0,168502,123050,205083,"ETH",164067
1,41.0,"Northern America",656741,653183,3558,469140,781900,"CAN",625520
1,41.0,"Northern Europe",1672484,1657859,14625,1214830,2024717,"GBR",1619774
1,41.0,"United States of America",2933199,2911281,21918,2125222,3542037,"USA",2833630
1,41.0,"Central Asia",1216200,1105834,110366,837580,1395967,"UZB",1116774
1,41.0,"India",5221731,5054380,167351,3637043,6061738,"IND",4849391
1,42.0,"Western Europe",3093673,3058570,35103,2237714,3729523,"NLD",2983619
1,42.0,"Western Africa",169784,0,169784,121468,202447,"NGA",161958
1,42.0,"Oceania",338062,335323,2739,241125,401876,"NZL",321501
1,42.0,"South America",1668505,1302919,365586,1217311,2028852,"BRA",1623082
1,42.0,"Northern Africa",1186988,0,1186988,860613,1434355,"EGY",1147484
1,42.0,"Southern Asia",423564,0,423564,306879,511465,"IRN",409172
1,42.0,"Eastern Europe",3874427,3185147,689280,2812445,4687408,"POL",3749927
1,42.0,"Middle Africa",51614,0,51614,37414,62357,"AGO",49886
1,42.0,"Central America",363424,0,363424,262271,437118,"MEX",349695
1,42.0,"Southern Africa",76342,0,76342,54255,90425,"ZAF",72340
1,42.0,"South-Eastern Asia",633478,0,633478,460368,767280,"IDN",613824
1,42.0,"China",9642731,8778110,864621,6843204,11405340,"CPR",9124272
1,42.0,"Pakistan",1709715,1408567,301148,1143795,1906326,"PAK",1525061
1,42.0,"Eastern Asia",1041438,0,1041438,755292,1258820,"JPN",1007056
1,42.0,"Russian Federation",2952290,2683083,269207,2215581,3692636,"RUS",2954109
1,42.0,"Western Asia",7965,0,7965,563,938,"IRQ",751
1,42.0,"Southern Europe",321553,0,321553,231532,385887,"ITA",308710
1,42.0,"Eastern Africa",168562,0,168562,123050,205083,"ETH",164067
1,42.0,"Northern America",650887,645612,5275,469140,781900,"CAN",625520
1,42.0,"Northern Europe",1692756,1673620,19136,1214830,2024717,"GBR",1619774
1,42.0,"United States of America",2933200,2903426,29774,2125222,3542037,"USA",2833630
1,42.0,"Central Asia",1210600,1106178,104422,837580,1395967,"UZB",1116774
1,42.0,"India",5221774,5059743,162031,3637043,6061738,"IND",4849391
1,43.0,"Western Europe",3115683,3072553,43130,2237714,3729523,"NLD",2983619
1,43.0,"Western Africa",170661,0,170661,121468,202447,"NGA",161958
1,43.0,"Oceania",340010,336419,3591,241125,401876,"NZL",321501
1,43.0,"South America",1675823,1304653,371170,1217311,2028852,"BRA",1623082
1,43.0,"Northern Africa",1191419,0,1191419,860613,1434355,"EGY",1147484
1,43.0,"Southern Asia",425177,0,425177,306879,511465,"IRN",409172
1,43.0,"Eastern Europe",3917323,3214854,702469,2812445,4687408,"POL",3749927
1,43.0,"Middle Africa",51810,0,51810,37414,62357,"AGO",49886
1,43.0,"Central America",364963,0,364963,262271,437118,"MEX",349695
1,43.0,"Southern Africa",76788,0,76788,54255,90425,"ZAF",72340
1,43.0,"South-Eastern Asia",635668,0,635668,460368,767280,"IDN",613824
1,43.0,"China",9646729,8776395,870334,6843204,11405340,"CPR",9124272
1,43.0,"Pakistan",1692031,1411059,280972,1143795,1906326,"PAK",1525061
1,43.0,"Eastern Asia",1045748,0,1045748,755292,1258820,"JPN",1007056
1,43.0,"Russian Federation",2961851,2684843,277008,2215581,3692636,"RUS",2954109
1,43.0,"Western Asia",8491,0,8491,563,938,"IRQ",751
1,43.0,"Southern Europe",322991,0,322991,231532,385887,"ITA",308710
1,43.0,"Eastern Africa",169065,0,169065,123050,205083,"ETH",164067
1,43.0,"Northern America",652838,645863,6975,469140,781900,"CAN",625520
1,43.0,"Northern Europe",1700865,1677474,23391,1214830,2024717,"GBR",1619774
1,43.0,"United States of America",2940311,2902866,37445,2125222,3542037,"USA",2833630
1,43.0,"Central Asia",1152849,1056547,96302,837580,1395967,"UZB",1116774
1,43.0,"India",5210696,5052938,157758,3637043,6061738,"IND",4849391
1,44.0,"Western Europe",3145031,3094288,50743,2237714,3729523,"NLD",2983619
1,44.0,"Western Africa",171695,0,171695,121468,202447,"NGA",161958
1,44.0,"Oceania",340985,336589,4396,241125,401876,"NZL",321501
1,44.0,"South America",1679523,1303977,375546,1217311,2028852,"BRA",1623082
1,44.0,"Northern Africa",1196642,0,1196642,860613,1434355,"EGY",1147484
1,44.0,"Southern Asia",427081,0,427081,306879,511465,"IRN",409172
1,44.0,"Eastern Europe",4415922,3703332,712590,2812445,4687408,"POL",3749927
1,44.0,"Middle Africa",52038,0,52038,37414,62357,"AGO",49886
1,44.0,"Central America",366776,0,366776,262271,437118,"MEX",349695
1,44.0,"Southern Africa",77319,0,77319,54255,90425,"ZAF",72340
1,44.0,"South-Eastern Asia",637495,0,637495,460368,767280,"IDN",613824
1,44.0,"China",9671972,8782154,889818,6843204,11405340,"CPR",9124272
1,44.0,"Pakistan",1674574,1409188,265386,1143795,1906326,"PAK",1525061
1,44.0,"Eastern Asia",1050349,0,1050349,755292,1258820,"JPN",1007056
1,44.0,"Russian Federation",2988779,2704384,284395,2215581,3692636,"RUS",2954109
1,44.0,"Western Asia",9427,0,9427,563,938,"IRQ",751
1,44.0,"Southern Europe",324690,0,324690,231532,385887,"ITA",308710
1,44.0,"Eastern Africa",169657,0,169657,123050,205083,"ETH",164067
1,44.0,"Northern America",654790,646179,8611,469140,781900,"CAN",625520
1,44.0,"Northern Europe",1814393,1786953,27440,1214830,2024717,"GBR",1619774
1,44.0,"United States of America",2940312,2895457,44855,2125222,3542037,"USA",2833630
1,44.0,"Central Asia",1127752,1033282,94470,837580,1395967,"UZB",1116774
1,44.0,"India",5211811,5056798,155013,3637043,6061738,"IND",4849391
1,45.0,"Western Europe",3086336,3028566,57770,2237714,3729523,"NLD",2983619
1,45.0,"Western Africa",169026,0,169026,121468,202447,"NGA",161958
1,45.0,"Oceania",340010,336708,3302,241125,401876,"NZL",321501
1,45.0,"South America",1683945,1303756,380189,1217311,2028852,"BRA",1623082
1,45.0,"Northern Africa",1183157,0,1183157,860613,1434355,"EGY",1147484
1,45.0,"Southern Asia",422169,0,422169,306879,511465,"IRN",409172
1,45.0,"Eastern Europe",4328915,3702263,626652,2812445,4687408,"POL",3749927
1,45.0,"Middle Africa",51448,0,51448,37414,62357,"AGO",49886
1,45.0,"Central America",362092,0,362092,262271,437118,"MEX",349695
1,45.0,"Southern Africa",75952,0,75952,54255,90425,"ZAF",72340
1,45.0,"South-Eastern Asia",631697,0,631697,460368,767280,"IDN",613824
1,45.0,"China",9617298,8724316,892982,6843204,11405340,"CPR",9124272
1,45.0,"Pakistan",1658157,1409077,249080,1143795,1906326,"PAK",1525061
1,45.0,"Eastern Asia",1038471,0,1038471,755292,1258820,"JPN",1007056
1,45.0,"Russian Federation",2659363,2371807,287556,2215581,3692636,"RUS",2954109
1,45.0,"Western Asia",9535,0,9535,563,938,"IRQ",751
1,45.0,"Southern Europe",320307,0,320307,231532,385887,"ITA",308710
1,45.0,"Eastern Africa",168124,0,168124,123050,205083,"ETH",164067
1,45.0,"Northern America",687961,681427,6534,469140,781900,"CAN",625520
1,45.0,"Northern Europe",1810337,1780329,30008,1214830,2024717,"GBR",1619774
1,45.0,"United States of America",2826519,2774462,52057,2125222,3542037,"USA",2833630
1,45.0,"Central Asia",1116854,1021292,95562,837580,1395967,"UZB",1116774
1,45.0,"India",5196742,5054014,142728,3637043,6061738,"IND",4849391
1,46.0,"Western Europe",3108348,3043040,65308,2237714,3729523,"NLD",2983619
1,46.0,"Western Africa",167958,0,167958,121468,202447,"NGA",161958
1,46.0,"Oceania",337088,334837,2251,241125,401876,"NZL",321501
1,46.0,"South America",1685929,1305333,380596,1217311,2028852,"BRA",1623082
1,46.0,"Northern Africa",1177396,0,1177396,860613,1434355,"EGY",1147484
1,46.0,"Southern Asia",420070,0,420070,306879,511465,"IRN",409172
1,46.0,"Eastern Europe",3839214,3297995,541219,2812445,4687408,"POL",3749927
1,46.0,"Middle Africa",51195,0,51195,37414,62357,"AGO",49886
1,46.0,"Central America",360089,0,360089,262271,437118,"MEX",349695
1,46.0,"Southern Africa",75369,0,75369,54255,90425,"ZAF",72340
1,46.0,"South-Eastern Asia",629012,0,629012,460368,767280,"IDN",613824
1,46.0,"China",9612463,8735371,877092,6843204,11405340,"CPR",9124272
1,46.0,"Pakistan",1558729,1328988,229741,1143795,1906326,"PAK",1525061
1,46.0,"Eastern Asia",1033398,0,1033398,755292,1258820,"JPN",1007056
1,46.0,"Russian Federation",2747289,2402032,345257,2215581,3692636,"RUS",2954109
1,46.0,"Western Asia",7909,0,7909,563,938,"IRQ",751
1,46.0,"Southern Europe",318435,0,318435,231532,385887,"ITA",308710
1,46.0,"Eastern Africa",167469,0,167469,123050,205083,"ETH",164067
1,46.0,"Northern America",625521,621169,4352,469140,781900,"CAN",625520
1,46.0,"Northern Europe",1798174,1770409,27765,1214830,2024717,"GBR",1619774
1,46.0,"United States of America",2904748,2852605,52143,2125222,3542037,"USA",2833630
1,46.0,"Central Asia",953509,858543,94966,837580,1395967,"UZB",1116774
1,46.0,"India",5001455,4878658,122797,3637043,6061738,"IND",4849391
1,47.0,"Western Europe",3101010,3028703,72307,2237722,3729537,"NLD",2983630
1,47.0,"Western Africa",166826,0,166826,121476,202460,"NGA",161968
1,47.0,"Oceania",326372,325127,1245,241133,401888,"NZL",321511
1,47.0,"South America",1680766,1305029,375737,1217319,2028865,"BRA",1623092
1,47.0,"Northern Africa",1172059,0,1172059,860618,1434363,"EGY",1147491
1,47.0,"Southern Asia",418125,0,418125,306881,511468,"IRN",409175
1,47.0,"Eastern Europe",3747105,3217500,529605,2812449,4687415,"POL",3749932
1,47.0,"Middle Africa",50964,0,50964,37418,62363,"AGO",49891
1,47.0,"Central America",358236,0,358236,262277,437128,"MEX",349703
1,47.0,"Southern Africa",74831,0,74831,54260,90433,"ZAF",72347
1,47.0,"South-Eastern Asia",626302,0,626302,460374,767291,"IDN",613833
1,47.0,"China",9585569,8728913,856656,6843211,11405352,"CPR",9124282
1,47.0,"Pakistan",1525672,1299379,226293,1143799,1906332,"PAK",1525066
1,47.0,"Eastern Asia",1028699,0,1028699,755300,1258833,"JPN",1007067
1,47.0,"Russian Federation",2840393,2449932,390461,2215590,3692650,"RUS",2954120
1,47.0,"Western Asia",5593,0,5593,563,938,"IRQ",751
1,47.0,"Southern Europe",316699,0,316699,231537,385896,"ITA",308717
1,47.0,"Eastern Africa",166865,0,166865,123055,205092,"ETH",164074
1,47.0,"Northern America",621618,619142,2476,469145,781908,"CAN",625527
1,47.0,"Northern Europe",1631940,1610766,21174,1214838,2024730,"GBR",1619784
1,47.0,"United States of America",2918976,2867697,51279,2125227,3542045,"USA",2833636
1,47.0,"Central Asia",972352,860845,111507,837586,1395977,"UZB",1116782
1,47.0,"India",4830499,4721779,108720,3637047,6061746,"IND",4849397
1,48.0,"Western Europe",3071665,3001193,70472,2709344,4515573,"NLD",3612459
1,48.0,"Western Africa",166325,0,166325,137121,228535,"NGA",182828
1,48.0,"Oceania",324425,324146,279,327156,545261,"NZL",436209
1,48.0,"South America",1676594,1305506,371088,1434723,2391206,"BRA",1912965
1,48.0,"Northern Africa",1169522,0,1169522,1000237,1667062,"EGY",1333650
1,48.0,"Southern Asia",417203,0,417203,382002,636670,"IRN",509336
1,48.0,"Eastern Europe",3786260,3255470,530790,2964260,4940433,"POL",3952347
1,48.0,"Middle Africa",50856,0,50856,35996,59993,"AGO",47995
1,48.0,"Central America",357354,0,357354,224650,374417,"MEX",299534
1,48.0,"Southern Africa",74575,0,74575,70608,117681,"ZAF",94145
1,48.0,"South-Eastern Asia",625014,0,625014,567500,945833,"IDN",756667
1,48.0,"China",9561286,8725041,836245,7715378,12858963,"CPR",10287171
1,48.0,"Pakistan",1540736,1312912,227824,1249488,2082480,"PAK",1665984
1,48.0,"Eastern Asia",1026467,0,1026467,564993,941656,"JPN",753325
1,48.0,"Russian Federation",2890670,2469754,420916,2348455,3914092,"RUS",3131274
1,48.0,"Western Asia",4481,0,4481,98724,164541,"IRQ",131633
1,48.0,"Southern Europe",315874,0,315874,410381,683968,"ITA",547175
1,48.0,"Eastern Africa",166576,0,166576,98163,163605,"ETH",130884
1,48.0,"Northern America",631373,630771,602,526854,878090,"CAN",702472
1,48.0,"Northern Europe",1631939,1615714,16225,1367225,2278708,"GBR",1822967
1,48.0,"United States of America",2904668,2854509,50159,2212836,3688060,"USA",2950448
1,48.0,"Central Asia",1059135,925659,133476,903292,1505487,"UZB",1204390
1,48.0,"India",4890579,4791034,99545,4310892,7184821,"IND",5747857
1,49.0,"Western Europe",3064337,2995241,69096,2709344,4515573,"NLD",3612459
1,49.0,"Western Africa",164816,0,164816,137121,228535,"NGA",182828
1,49.0,"Oceania",319562,319562,0,327156,545261,"NZL",436209
1,49.0,"South America",1439163,1074550,364613,1434723,2391206,"BRA",1912965
1,49.0,"Northern Africa",1161877,0,1161877,1000237,1667062,"EGY",1333650
1,49.0,"Southern Asia",414417,0,414417,382002,636670,"IRN",509336
1,49.0,"Eastern Europe",3741555,3220215,521340,2964260,4940433,"POL",3952347
1,49.0,"Middle Africa",50522,0,50522,35996,59993,"AGO",47995
1,49.0,"Central America",354702,0,354702,224650,374417,"MEX",299534
1,49.0,"Southern Africa",73737,0,73737,70608,117681,"ZAF",94145
1,49.0,"South-Eastern Asia",621140,0,621140,567500,945833,"IDN",756667
1,49.0,"China",9554164,8743306,810858,7715378,12858963,"CPR",10287171
1,49.0,"Pakistan",1522807,1298554,224253,1249488,2082480,"PAK",1665984
1,49.0,"Eastern Asia",1019732,0,1019732,564993,941656,"JPN",753325
1,49.0,"Russian Federation",2998195,2558916,439279,2348455,3914092,"RUS",3131274
1,49.0,"Western Asia",3137,0,3137,98724,164541,"IRQ",131633
1,49.0,"Southern Europe",313395,0,313395,410381,683968,"ITA",547175
1,49.0,"Eastern Africa",165712,0,165712,98163,163605,"ETH",130884
1,49.0,"Northern America",621624,621624,0,526854,878090,"CAN",702472
1,49.0,"Northern Europe",1611676,1600979,10697,1367225,2278708,"GBR",1822967
1,49.0,"United States of America",2890617,2842436,48181,2212836,3688060,"USA",2950448
1,49.0,"Central Asia",1096758,951305,145453,903292,1505487,"UZB",1204390
1,49.0,"India",4828286,4743967,84319,4310892,7184821,"IND",5747857
1,50.0,"Western Europe",3142898,3065224,77674,2709344,4515573,"NLD",3612459
1,50.0,"Western Africa",168662,0,168662,137121,228535,"NGA",182828
1,50.0,"Oceania",435235,435235,0,327156,545261,"NZL",436209
1,50.0,"South America",1515779,1073861,441918,1434723,2391206,"BRA",1912965
1,50.0,"Northern Africa",1262109,0,1262109,1000237,1667062,"EGY",1333650
1,50.0,"Southern Asia",483275,0,483275,382002,636670,"IRN",509336
1,50.0,"Eastern Europe",3905244,3403717,501527,2964260,4940433,"POL",3952347
1,50.0,"Middle Africa",44873,0,44873,35996,59993,"AGO",47995
1,50.0,"Central America",274679,0,274679,224650,374417,"MEX",299534
1,50.0,"Southern Africa",86889,0,86889,70608,117681,"ZAF",94145
1,50.0,"South-Eastern Asia",720343,0,720343,567500,945833,"IDN",756667
1,50.0,"China",9549524,8725670,823854,7715378,12858963,"CPR",10287171
1,50.0,"Pakistan",1557493,1334751,222742,1249488,2082480,"PAK",1665984
1,50.0,"Eastern Asia",690327,0,690327,564993,941656,"JPN",753325
1,50.0,"Russian Federation",3077634,2646345,431289,2348455,3914092,"RUS",3131274
1,50.0,"Western Asia",114576,0,114576,98724,164541,"IRQ",131633
1,50.0,"Southern Europe",523920,0,523920,410381,683968,"ITA",547175
1,50.0,"Eastern Africa",122691,0,122691,98163,163605,"ETH",130884
1,50.0,"Northern America",694667,694667,0,526854,878090,"CAN",702472
1,50.0,"Northern Europe",1717548,1711808,5740,1367225,2278708,"GBR",1822967
1,50.0,"United States of America",2793983,2749430,44553,2212836,3688060,"USA",2950448
1,50.0,"Central Asia",1105309,954904,150405,903292,1505487,"UZB",1204390
1,50.0,"India",5018597,4942574,76023,4310892,7184821,"IND",5747857
1,51.0,"Western Europe",3267624,3170740,96884,2709344,4515573,"NLD",3612459
1,51.0,"Western Africa",169297,0,169297,137121,228535,"NGA",182828
1,51.0,"Oceania",436209,436209,0,327156,545261,"NZL",436209
1,51.0,"South America",1585384,1075114,510270,1434723,2391206,"BRA",1912965
1,51.0,"Northern Africa",1265323,0,1265323,1000237,1667062,"EGY",1333650
1,51.0,"Southern Asia",484444,0,484444,382002,636670,"IRN",509336
1,51.0,"Eastern Europe",3915106,3455847,459259,2964260,4940433,"POL",3952347
1,51.0,"Middle Africa",45005,0,45005,35996,59993,"AGO",47995
1,51.0,"Central America",275791,0,275791,224650,374417,"MEX",299534
1,51.0,"Southern Africa",87223,0,87223,70608,117681,"ZAF",94145
1,51.0,"South-Eastern Asia",721978,0,721978,567500,945833,"IDN",756667
1,51.0,"China",9566907,8725845,841062,7715378,12858963,"CPR",10287171
1,51.0,"Pakistan",1545777,1326884,218893,1249488,2082480,"PAK",1665984
1,51.0,"Eastern Asia",693152,0,693152,564993,941656,"JPN",753325
1,51.0,"Russian Federation",3063164,2649064,414100,2348455,3914092,"RUS",3131274
1,51.0,"Western Asia",119384,0,119384,98724,164541,"IRQ",131633
1,51.0,"Southern Europe",524965,0,524965,410381,683968,"ITA",547175
1,51.0,"Eastern Africa",123110,0,123110,98163,163605,"ETH",130884
1,51.0,"Northern America",659545,659545,0,526854,878090,"CAN",702472
1,51.0,"Northern Europe",1717549,1707807,9742,1367225,2278708,"GBR",1822967
1,51.0,"United States of America",2808207,2753555,54652,2212836,3688060,"USA",2950448
1,51.0,"Central Asia",1111316,956254,155062,903292,1505487,"UZB",1204390
1,51.0,"India",5021392,4938343,83049,4310892,7184821,"IND",5747857
1,52.0,"Western Europe",3355667,3241109,114558,2709344,4515573,"NLD",3612459
1,52.0,"Western Africa",170030,0,170030,137121,228535,"NGA",182828
1,52.0,"Oceania",433287,433287,0,327156,545261,"NZL",436209
1,52.0,"South America",1642592,1076855,565737,1434723,2391206,"BRA",1912965
1,52.0,"Northern Africa",1269022,0,1269022,1000237,1667062,"EGY",1333650
1,52.0,"Southern Asia",485793,0,485793,382002,636670,"IRN",509336
1,52.0,"Eastern Europe",3876575,3459081,417494,2964260,4940433,"POL",3952347
1,52.0,"Middle Africa",45168,0,45168,35996,59993,"AGO",47995
1,52.0,"Central America",277076,0,277076,224650,374417,"MEX",299534
1,52.0,"Southern Africa",87596,0,87596,70608,117681,"ZAF",94145
1,52.0,"South-Eastern Asia",723852,0,723852,567500,945833,"IDN",756667
1,52.0,"China",9584949,8725689,859260,7715378,12858963,"CPR",10287171
1,52.0,"Pakistan",1543664,1323262,220402,1249488,2082480,"PAK",1665984
1,52.0,"Eastern Asia",696405,0,696405,564993,941656,"JPN",753325
1,52.0,"Russian Federation",3034534,2638221,396313,2348455,3914092,"RUS",3131274
1,52.0,"Western Asia",120050,0,120050,98724,164541,"IRQ",131633
1,52.0,"Southern Europe",526165,0,526165,410381,683968,"ITA",547175
1,52.0,"Eastern Africa",123528,0,123528,98163,163605,"ETH",130884
1,52.0,"Northern America",651740,651740,0,526854,878090,"CAN",702472
1,52.0,"Northern Europe",1721603,1705745,15858,1367225,2278708,"GBR",1822967
1,52.0,"United States of America",2801096,2735480,65616,2212836,3688060,"USA",2950448
1,52.0,"Central Asia",1114629,954881,159748,903292,1505487,"UZB",1204390
1,52.0,"India",5420917,5312795,108122,4310892,7184821,"IND",5747857
1,53.0,"Western Europe",3414360,3283393,130967,2709344,4515573,"NLD",3612459
1,53.0,"Western Africa",171274,0,171274,137121,228535,"NGA",182828
1,53.0,"Oceania",428416,428416,0,327156,545261,"NZL",436209
1,53.0,"South America",1687291,1075970,611321,1434723,2391206,"BRA",1912965
1,53.0,"Northern Africa",1275295,0,1275295,1000237,1667062,"EGY",1333650
1,53.0,"Southern Asia",488078,0,488078,382002,636670,"IRN",509336
1,53.0,"Eastern Europe",3725854,3341436,384418,2964260,4940433,"POL",3952347
1,53.0,"Middle Africa",45442,0,45442,35996,59993,"AGO",47995
1,53.0,"Central America",279255,0,279255,224650,374417,"MEX",299534
1,53.0,"Southern Africa",88230,0,88230,70608,117681,"ZAF",94145
1,53.0,"South-Eastern Asia",727040,0,727040,567500,945833,"IDN",756667
1,53.0,"China",9607909,8730984,876925,7715378,12858963,"CPR",10287171
1,53.0,"Pakistan",1545431,1321406,224025,1249488,2082480,"PAK",1665984
1,53.0,"Eastern Asia",701931,0,701931,564993,941656,"JPN",753325
1,53.0,"Russian Federation",3008531,2625963,382568,2348455,3914092,"RUS",3131274
1,53.0,"Western Asia",121172,0,121172,98724,164541,"IRQ",131633
1,53.0,"Southern Europe",528206,0,528206,410381,683968,"ITA",547175
1,53.0,"Eastern Africa",124244,0,124244,98163,163605,"ETH",130884
1,53.0,"Northern America",655641,653429,2212,526854,878090,"CAN",702472
1,53.0,"Northern Europe",1729712,1707548,22164,1367225,2278708,"GBR",1822967
1,53.0,"United States of America",2808207,2731222,76985,2212836,3688060,"USA",2950448
1,53.0,"Central Asia",1121086,955959,165127,903292,1505487,"UZB",1204390
1,53.0,"India",5473594,5346304,127290,4310892,7184821,"IND",5747857
1,54.0,"Western Europe",3451047,3304589,146458,2709344,4515573,"NLD",3612459
1,54.0,"Western Africa",171163,0,171163,137121,228535,"NGA",182828
1,54.0,"Oceania",409908,409908,0,327156,545261,"NZL",436209
1,54.0,"South America",1722731,1075853,646878,1434723,2391206,"BRA",1912965
1,54.0,"Northern Africa",1274737,0,1274737,1000237,1667062,"EGY",1333650
1,54.0,"Southern Asia",487874,0,487874,382002,636670,"IRN",509336
1,54.0,"Eastern Europe",3618842,3240291,378551,2964260,4940433,"POL",3952347
1,54.0,"Middle Africa",45419,0,45419,35996,59993,"AGO",47995
1,54.0,"Central America",279060,0,279060,224650,374417,"MEX",299534
1,54.0,"Southern Africa",88176,0,88176,70608,117681,"ZAF",94145
1,54.0,"South-Eastern Asia",726754,0,726754,567500,945833,"IDN",756667
1,54.0,"China",9627064,8737242,889822,7715378,12858963,"CPR",10287171
1,54.0,"Pakistan",1447467,1220268,227199,1249488,2082480,"PAK",1665984
1,54.0,"Eastern Asia",701526,0,701526,564993,941656,"JPN",753325
1,54.0,"Russian Federation",2988101,2618692,369409,2348455,3914092,"RUS",3131274
1,54.0,"Western Asia",121074,0,121074,98724,164541,"IRQ",131633
1,54.0,"Southern Europe",528023,0,528023,410381,683968,"ITA",547175
1,54.0,"Eastern Africa",124181,0,124181,98163,163605,"ETH",130884
1,54.0,"Northern America",657593,653085,4508,526854,878090,"CAN",702472
1,54.0,"Northern Europe",1733767,1705173,28594,1367225,2278708,"GBR",1822967
1,54.0,"United States of America",2815320,2726810,88510,2212836,3688060,"USA",2950448
1,54.0,"Central Asia",1127652,956730,170922,903292,1505487,"UZB",1204390
1,54.0,"India",5521815,5376646,145169,4310892,7184821,"IND",5747857
1,55.0,"Western Europe",3473056,3311688,161368,2709344,4515573,"NLD",3612459
1,55.0,"Western Africa",170511,0,170511,137121,228535,"NGA",182828
1,55.0,"Oceania",398218,398218,0,327156,545261,"NZL",436209
1,55.0,"South America",1750952,1077305,673647,1434723,2391206,"BRA",1912965
1,55.0,"Northern Africa",1271456,0,1271456,1000237,1667062,"EGY",1333650
1,55.0,"Southern Asia",486678,0,486678,382002,636670,"IRN",509336
1,55.0,"Eastern Europe",3537599,3150956,386643,2964260,4940433,"POL",3952347
1,55.0,"Middle Africa",45274,0,45274,35996,59993,"AGO",47995
1,55.0,"Central America",277920,0,277920,224650,374417,"MEX",299534
1,55.0,"Southern Africa",87944,0,87944,70608,117681,"ZAF",94145
1,55.0,"South-Eastern Asia",725222,0,725222,567500,945833,"IDN",756667
1,55.0,"China",9622317,8726016,896301,7715378,12858963,"CPR",10287171
1,55.0,"Pakistan",1503334,1257819,245515,1249488,2082480,"PAK",1665984
1,55.0,"Eastern Asia",699197,0,699197,564993,941656,"JPN",753325
1,55.0,"Russian Federation",2958247,2602972,355275,2348455,3914092,"RUS",3131274
1,55.0,"Western Asia",120484,0,120484,98724,164541,"IRQ",131633
1,55.0,"Southern Europe",526959,0,526959,410381,683968,"ITA",547175
1,55.0,"Eastern Africa",123809,0,123809,98163,163605,"ETH",130884
1,55.0,"Northern America",655641,653144,2497,526854,878090,"CAN",702472
1,55.0,"Northern Europe",1733767,1698609,35158,1367225,2278708,"GBR",1822967
1,55.0,"United States of America",2808208,2708053,100155,2212836,3688060,"USA",2950448
1,55.0,"Central Asia",1133515,957122,176393,903292,1505487,"UZB",1204390
1,55.0,"India",5533561,5376286,157275,4310892,7184821,"IND",5747857
1,56.0,"Western Europe",3487731,3311773,175958,2709344,4515573,"NLD",3612459
1,56.0,"Western Africa",169888,0,169888,137121,228535,"NGA",182828
1,56.0,"Oceania",394322,394322,0,327156,545261,"NZL",436209
1,56.0,"South America",1769521,1076237,693284,1434723,2391206,"BRA",1912965
1,56.0,"Northern Africa",1268295,0,1268295,1000237,1667062,"EGY",1333650
1,56.0,"Southern Asia",485528,0,485528,382002,636670,"IRN",509336
1,56.0,"Eastern Europe",3900706,3497532,403174,2964260,4940433,"POL",3952347
1,56.0,"Middle Africa",45137,0,45137,35996,59993,"AGO",47995
1,56.0,"Central America",276825,0,276825,224650,374417,"MEX",299534
1,56.0,"Southern Africa",87528,0,87528,70608,117681,"ZAF",94145
1,56.0,"South-Eastern Asia",723863,0,723863,567500,945833,"IDN",756667
1,56.0,"China",9661814,8737146,924668,7715378,12858963,"CPR",10287171
1,56.0,"Pakistan",1521375,1267595,253780,1249488,2082480,"PAK",1665984
1,56.0,"Eastern Asia",696287,0,696287,564993,941656,"JPN",753325
1,56.0,"Russian Federation",2932073,2595541,336532,2348455,3914092,"RUS",3131274
1,56.0,"Western Asia",119920,0,119920,98724,164541,"IRQ",131633
1,56.0,"Southern Europe",525931,0,525931,410381,683968,"ITA",547175
1,56.0,"Eastern Africa",123450,0,123450,98163,163605,"ETH",130884
1,56.0,"Northern America",651739,651334,405,526854,878090,"CAN",702472
1,56.0,"Northern Europe",1741876,1699984,41892,1367225,2278708,"GBR",1822967
1,56.0,"United States of America",2793984,2695530,98454,2212836,3688060,"USA",2950448
1,56.0,"Central Asia",1136251,955009,181242,903292,1505487,"UZB",1204390
1,56.0,"India",5559490,5384205,175285,4310892,7184821,"IND",5747857
1,57.0,"Western Europe",3744520,3554160,190360,2709344,4515573,"NLD",3612459
1,57.0,"Western Africa",168503,0,168503,137121,228535,"NGA",182828
1,57.0,"Oceania",402115,402115,0,327156,545261,"NZL",436209
1,57.0,"South America",1780524,1076924,703600,1434723,2391206,"BRA",1912965
1,57.0,"Northern Africa",1261296,0,1261296,1000237,1667062,"EGY",1333650
1,57.0,"Southern Asia",482978,0,482978,382002,636670,"IRN",509336
1,57.0,"Eastern Europe",3776187,3383895,392292,2964260,4940433,"POL",3952347
1,57.0,"Middle Africa",44828,0,44828,35996,59993,"AGO",47995
1,57.0,"Central America",274391,0,274391,224650,374417,"MEX",299534
1,57.0,"Southern Africa",86818,0,86818,70608,117681,"ZAF",94145
1,57.0,"South-Eastern Asia",720237,0,720237,567500,945833,"IDN",756667
1,57.0,"China",9370722,8442234,928488,7715378,12858963,"CPR",10287171
1,57.0,"Pakistan",1532024,1274910,257114,1249488,2082480,"PAK",1665984
1,57.0,"Eastern Asia",689991,0,689991,564993,941656,"JPN",753325
1,57.0,"Russian Federation",2688305,2380450,307855,2348455,3914092,"RUS",3131274
1,57.0,"Western Asia",118663,0,118663,98724,164541,"IRQ",131633
1,57.0,"Southern Europe",523655,0,523655,410381,683968,"ITA",547175
1,57.0,"Eastern Africa",122653,0,122653,98163,163605,"ETH",130884
1,57.0,"Northern America",528811,528811,0,526854,878090,"CAN",702472
1,57.0,"Northern Europe",1749984,1701323,48661,1367225,2278708,"GBR",1822967
1,57.0,"United States of America",2822431,2713985,108446,2212836,3688060,"USA",2950448
1,57.0,"Central Asia",1140143,955926,184217,903292,1505487,"UZB",1204390
1,57.0,"India",5585199,5390997,194202,4310892,7184821,"IND",5747857
1,58.0,"Western Europe",3656481,3459275,197206,2709344,4515573,"NLD",3612459
1,58.0,"Western Africa",171559,0,171559,137121,228535,"NGA",182828
1,58.0,"Oceania",402115,402115,0,327156,545261,"NZL",436209
1,58.0,"South America",1794832,1075471,719361,1434723,2391206,"BRA",1912965
1,58.0,"Northern Africa",1276742,0,1276742,1000237,1667062,"EGY",1333650
1,58.0,"Southern Asia",488603,0,488603,382002,636670,"IRN",509336
1,58.0,"Eastern Europe",3645648,3256967,388681,2964260,4940433,"POL",3952347
1,58.0,"Middle Africa",45504,0,45504,35996,59993,"AGO",47995
1,58.0,"Central America",281988,0,281988,224650,374417,"MEX",299534
1,58.0,"Southern Africa",88383,0,88383,70608,117681,"ZAF",94145
1,58.0,"South-Eastern Asia",728022,0,728022,567500,945833,"IDN",756667
1,58.0,"China",9389800,8442998,946802,7715378,12858963,"CPR",10287171
1,58.0,"Pakistan",1552149,1283890,268259,1249488,2082480,"PAK",1665984
1,58.0,"Eastern Asia",703478,0,703478,564993,941656,"JPN",753325
1,58.0,"Russian Federation",2696933,2371683,325250,2348455,3914092,"RUS",3131274
1,58.0,"Western Asia",121432,0,121432,98724,164541,"IRQ",131633
1,58.0,"Southern Europe",528675,0,528675,410381,683968,"ITA",547175
1,58.0,"Eastern Africa",124408,0,124408,98163,163605,"ETH",130884
1,58.0,"Northern America",620519,618121,2398,526854,878090,"CAN",702472
1,58.0,"Northern Europe",1754040,1698608,55432,1367225,2278708,"GBR",1822967
1,58.0,"United States of America",2793982,2689791,104191,2212836,3688060,"USA",2950448
1,58.0,"Central Asia",1328543,1138732,189811,903292,1505487,"UZB",1204390
1,58.0,"India",5597698,5384843,212855,4310892,7184821,"IND",5747857
1,59.0,"Western Europe",3590451,3394574,195877,2709348,4515581,"NLD",3612465
1,59.0,"Western Africa",173081,0,173081,137125,228542,"NGA",182834
1,59.0,"Oceania",406011,406011,0,327159,545265,"NZL",436212
1,59.0,"South America",1810644,1075885,734759,1434729,2391216,"BRA",1912973
1,59.0,"Northern Africa",1284499,0,1284499,1000238,1667063,"EGY",1333651
1,59.0,"Southern Asia",491431,0,491431,382005,636675,"IRN",509340
1,59.0,"Eastern Europe",3526032,3130546,395486,2964262,4940437,"POL",3952350
1,59.0,"Middle Africa",45844,0,45844,36001,60002,"AGO",48002
1,59.0,"Central America",284793,0,284793,224652,374420,"MEX",299536
1,59.0,"Southern Africa",89168,0,89168,70614,117690,"ZAF",94152
1,59.0,"South-Eastern Asia",731989,0,731989,567506,945843,"IDN",756675
1,59.0,"China",9424678,8448326,976352,7715379,12858966,"CPR",10287173
1,59.0,"Pakistan",1566955,1288527,278428,1249491,2082485,"PAK",1665988
1,59.0,"Eastern Asia",710392,0,710392,564996,941660,"JPN",753328
1,59.0,"Russian Federation",2740028,2390128,349900,2348459,3914098,"RUS",3131279
1,59.0,"Western Asia",122822,0,122822,98727,164545,"IRQ",131636
1,59.0,"Southern Europe",531198,0,531198,410381,683968,"ITA",547175
1,59.0,"Eastern Africa",125289,0,125289,98168,163613,"ETH",130891
1,59.0,"Northern America",665398,660635,4763,526859,878098,"CAN",702479
1,59.0,"Northern Europe",1758094,1696799,61295,1367229,2278716,"GBR",1822973
1,59.0,"United States of America",2786871,2688701,98170,2212839,3688066,"USA",2950453
1,59.0,"Central Asia",1311061,1137730,173331,903299,1505498,"UZB",1204399
1,59.0,"India",5609691,5384815,224876,4310895,7184825,"IND",5747860
1,60.0,"Western Europe",3553762,3357221,196541,2377932,3963221,"NLD",3170577
1,60.0,"Western Africa",174173,0,174173,128415,214025,"NGA",171220
1,60.0,"Oceania",413804,413804,0,247899,413166,"NZL",330533
1,60.0,"South America",1824143,1077049,747094,1250766,2084610,"BRA",1667688
1,60.0,"Northern Africa",1285791,0,1285791,743211,1238686,"EGY",990949
1,60.0,"Southern Asia",491898,0,491898,366769,611282,"IRN",489026
1,60.0,"Eastern Europe",3489986,3075017,414969,2378127,3963546,"POL",3170837
1,60.0,"Middle Africa",45898,0,45898,29141,48568,"AGO",38855
1,60.0,"Central America",284550,0,284550,275250,458751,"MEX",367001
1,60.0,"Southern Africa",89298,0,89298,72313,120522,"ZAF",96418
1,60.0,"South-Eastern Asia",733003,0,733003,483922,806537,"IDN",645230
1,60.0,"China",9491944,8455556,1036388,6752096,11253493,"CPR",9002795
1,60.0,"Pakistan",1583091,1296464,286627,1115619,1859365,"PAK",1487492
1,60.0,"Eastern Asia",712167,0,712167,516833,861388,"JPN",689111
1,60.0,"Russian Federation",2772547,2406154,366393,2267977,3779962,"RUS",3023970
1,60.0,"Western Asia",123053,0,123053,224647,374412,"IRQ",299530
1,60.0,"Southern Europe",531616,0,531616,364859,608098,"ITA",486479
1,60.0,"Eastern Africa",125439,0,125439,103026,171710,"ETH",137368
1,60.0,"Northern America",671250,664213,7037,493494,822490,"CAN",657992
1,60.0,"Northern Europe",1713494,1656526,56968,1279201,2132002,"GBR",1705602
1,60.0,"United States of America",2793984,2701973,92011,2076839,3461398,"USA",2769119
1,60.0,"Central Asia",1296939,1138229,158710,815854,1359757,"UZB",1087806
1,60.0,"India",5598827,5389645,209182,3674156,6123593,"IND",4898875
1,61.0,"Western Europe",3524419,3328911,195508,2377932,3963221,"NLD",3170577
1,61.0,"Western Africa",173860,0,173860,128415,214025,"NGA",171220
1,61.0,"Oceania",249181,249181,0,247899,413166,"NZL",330533
1,61.0,"South America",2343023,1593327,749696,1250766,2084610,"BRA",1667688
1,61.0,"Northern Africa",1243143,0,1243143,743211,1238686,"EGY",990949
1,61.0,"Southern Asia",472848,0,472848,366769,611282,"IRN",489026
1,61.0,"Eastern Europe",3528877,3081149,447728,2378127,3963546,"POL",3170837
1,61.0,"Middle Africa",43621,0,43621,29141,48568,"AGO",38855
1,61.0,"Central America",283777,0,283777,275250,458751,"MEX",367001
1,61.0,"Southern Africa",84013,0,84013,72313,120522,"ZAF",96418
1,61.0,"South-Eastern Asia",706639,0,706639,483922,806537,"IDN",645230
1,61.0,"China",9493028,8448406,1044622,6752096,11253493,"CPR",9002795
1,61.0,"Pakistan",1578105,1300883,277222,1115619,1859365,"PAK",1487492
1,61.0,"Eastern Asia",666427,0,666427,516833,861388,"JPN",689111
1,61.0,"Russian Federation",2813189,2428858,384331,2267977,3779962,"RUS",3023970
1,61.0,"Western Asia",114403,0,114403,224647,374412,"IRQ",299530
1,61.0,"Southern Europe",530348,0,530348,364859,608098,"ITA",486479
1,61.0,"Eastern Africa",119582,0,119582,103026,171710,"ETH",137368
1,61.0,"Northern America",671256,664079,7177,493494,822490,"CAN",657992
1,61.0,"Northern Europe",1689173,1635568,53605,1279201,2132002,"GBR",1705602
1,61.0,"United States of America",2801100,2715054,86046,2076839,3461398,"USA",2769119
1,61.0,"Central Asia",1237315,1098923,138392,815854,1359757,"UZB",1087806
1,61.0,"India",5551287,5364395,186892,3674156,6123593,"IND",4898875
1,62.0,"Western Europe",3434705,3253486,181219,2377932,3963221,"NLD",3170577
1,62.0,"Western Africa",179634,0,179634,128415,214025,"NGA",171220
1,62.0,"Oceania",319817,318726,1091,247899,413166,"NZL",330533
1,62.0,"South America",2210653,1592357,618296,1250766,2084610,"BRA",1667688
1,62.0,"Northern Africa",1049289,0,1049289,743211,1238686,"EGY",990949
1,62.0,"Southern Asia",503034,0,503034,366769,611282,"IRN",489026
1,62.0,"Eastern Europe",3568538,3132954,435584,2378127,3963546,"POL",3170837
1,62.0,"Middle Africa",40542,0,40542,29141,48568,"AGO",38855
1,62.0,"Central America",377360,0,377360,275250,458751,"MEX",367001
1,62.0,"Southern Africa",100307,0,100307,72313,120522,"ZAF",96418
1,62.0,"South-Eastern Asia",665237,0,665237,483922,806537,"IDN",645230
1,62.0,"China",9458843,8442149,1016694,6752096,11253493,"CPR",9002795
1,62.0,"Pakistan",1577385,1304526,272859,1115619,1859365,"PAK",1487492
1,62.0,"Eastern Asia",722818,0,722818,516833,861388,"JPN",689111
1,62.0,"Russian Federation",2856886,2436916,419970,2267977,3779962,"RUS",3023970
1,62.0,"Western Asia",305710,0,305710,224647,374412,"IRQ",299530
1,62.0,"Southern Europe",501969,0,501969,364859,608098,"ITA",486479
1,62.0,"Eastern Africa",141736,0,141736,103026,171710,"ETH",137368
1,62.0,"Northern America",683361,676242,7119,493494,822490,"CAN",657992
1,62.0,"Northern Europe",1701545,1649286,52259,1279201,2132002,"GBR",1705602
1,62.0,"United States of America",2833130,2754808,78322,2076839,3461398,"USA",2769119
1,62.0,"Central Asia",1157583,1031492,126091,815854,1359757,"UZB",1087806
1,62.0,"India",5513990,5350710,163280,3674156,6123593,"IND",4898875
1,63.0,"Western Europe",3390685,3223212,167473,2377932,3963221,"NLD",3170577
1,63.0,"Western Africa",181210,0,181210,128415,214025,"NGA",171220
1,63.0,"Oceania",363652,361545,2107,247899,413166,"NZL",330533
1,63.0,"South America",2107422,1593517,513905,1250766,2084610,"BRA",1667688
1,63.0,"Northern Africa",1042896,0,1042896,743211,1238686,"EGY",990949
1,63.0,"Southern Asia",510248,0,510248,366769,611282,"IRN",489026
1,63.0,"Eastern Europe",3595715,3183718,411997,2378127,3963546,"POL",3170837
1,63.0,"Middle Africa",41402,0,41402,29141,48568,"AGO",38855
1,63.0,"Central America",384240,0,384240,275250,458751,"MEX",367001
1,63.0,"Southern Africa",102317,0,102317,72313,120522,"ZAF",96418
1,63.0,"South-Eastern Asia",674891,0,674891,483922,806537,"IDN",645230
1,63.0,"China",9458795,8444979,1013816,6752096,11253493,"CPR",9002795
1,63.0,"Pakistan",1579751,1305613,274138,1115619,1859365,"PAK",1487492
1,63.0,"Eastern Asia",740636,0,740636,516833,861388,"JPN",689111
1,63.0,"Russian Federation",2925452,2458748,466704,2267977,3779962,"RUS",3023970
1,63.0,"Western Asia",309969,0,309969,224647,374412,"IRQ",299530
1,63.0,"Southern Europe",502793,0,502793,364859,608098,"ITA",486479
1,63.0,"Eastern Africa",143994,0,143994,103026,171710,"ETH",137368
1,63.0,"Northern America",691165,683186,7979,493494,822490,"CAN",657992
1,63.0,"Northern Europe",1713709,1661388,52321,1279201,2132002,"GBR",1705602
1,63.0,"United States of America",2882911,2811248,71663,2076839,3461398,"USA",2769119
1,63.0,"Central Asia",1091447,970479,120968,815854,1359757,"UZB",1087806
1,63.0,"India",5479998,5338759,141239,3674156,6123593,"IND",4898875
1,64.0,"Western Europe",3354002,3201887,152115,2377932,3963221,"NLD",3170577
1,64.0,"Western Africa",182070,0,182070,128415,214025,"NGA",171220
1,64.0,"Oceania",387034,384049,2985,247899,413166,"NZL",330533
1,64.0,"South America",2026174,1592293,433881,1250766,2084610,"BRA",1667688
1,64.0,"Northern Africa",1046387,0,1046387,743211,1238686,"EGY",990949
1,64.0,"Southern Asia",514280,0,514280,366769,611282,"IRN",489026
1,64.0,"Eastern Europe",3597020,3210799,386221,2378127,3963546,"POL",3170837
1,64.0,"Middle Africa",41889,0,41889,29141,48568,"AGO",38855
1,64.0,"Central America",385942,0,385942,275250,458751,"MEX",367001
1,64.0,"Southern Africa",103436,0,103436,72313,120522,"ZAF",96418
1,64.0,"South-Eastern Asia",680369,0,680369,483922,806537,"IDN",645230
1,64.0,"China",9472224,8447854,1024370,6752096,11253493,"CPR",9002795
1,64.0,"Pakistan",1582754,1304734,278020,1115619,1859365,"PAK",1487492
1,64.0,"Eastern Asia",750194,0,750194,516833,861388,"JPN",689111
1,64.0,"Russian Federation",2995344,2473548,521796,2267977,3779962,"RUS",3023970
1,64.0,"Western Asia",311956,0,311956,224647,374412,"IRQ",299530
1,64.0,"Southern Europe",504104,0,504104,364859,608098,"ITA",486479
1,64.0,"Eastern Africa",145252,0,145252,103026,171710,"ETH",137368
1,64.0,"Northern America",698970,691161,7809,493494,822490,"CAN",657992
1,64.0,"Northern Europe",1742095,1684795,57300,1279201,2132002,"GBR",1705602
1,64.0,"United States of America",2911361,2845612,65749,2076839,3461398,"USA",2769119
1,64.0,"Central Asia",1097739,972834,124905,815854,1359757,"UZB",1087806
1,64.0,"India",5250652,5130269,120383,3674156,6123593,"IND",4898875
1,65.0,"Western Europe",3339328,3199766,139562,2377932,3963221,"NLD",3170577
1,65.0,"Western Africa",182603,0,182603,128415,214025,"NGA",171220
1,65.0,"Oceania",379240,375523,3717,247899,413166,"NZL",330533
1,65.0,"South America",1959964,1589347,370617,1250766,2084610,"BRA",1667688
1,65.0,"Northern Africa",1050980,0,1050980,743211,1238686,"EGY",990949
1,65.0,"Southern Asia",514299,0,514299,366769,611282,"IRN",489026
1,65.0,"Eastern Europe",3589614,3235077,354537,2378127,3963546,"POL",3170837
1,65.0,"Middle Africa",41892,0,41892,29141,48568,"AGO",38855
1,65.0,"Central America",386777,0,386777,275250,458751,"MEX",367001
1,65.0,"Southern Africa",103444,0,103444,72313,120522,"ZAF",96418
1,65.0,"South-Eastern Asia",680255,0,680255,483922,806537,"IDN",645230
1,65.0,"China",9495553,8460468,1035085,6752096,11253493,"CPR",9002795
1,65.0,"Pakistan",1585829,1304518,281311,1115619,1859365,"PAK",1487492
1,65.0,"Eastern Asia",750019,0,750019,516833,861388,"JPN",689111
1,65.0,"Russian Federation",3094154,2523618,570536,2267977,3779962,"RUS",3023970
1,65.0,"Western Asia",311966,0,311966,224647,374412,"IRQ",299530
1,65.0,"Southern Europe",504952,0,504952,364859,608098,"ITA",486479
1,65.0,"Eastern Africa",145260,0,145260,103026,171710,"ETH",137368
1,65.0,"Northern America",702873,693523,9350,493494,822490,"CAN",657992
1,65.0,"Northern Europe",1766422,1704682,61740,1279201,2132002,"GBR",1705602
1,65.0,"United States of America",2925585,2861523,64062,2076839,3461398,"USA",2769119
1,65.0,"Central Asia",1106194,977913,128281,815854,1359757,"UZB",1087806
1,65.0,"India",5161909,5058402,103507,3674156,6123593,"IND",4898875
1,66.0,"Western Europe",3339326,3204013,135313,2377932,3963221,"NLD",3170577
1,66.0,"Western Africa",183285,0,183285,128415,214025,"NGA",171220
1,66.0,"Oceania",367551,363125,4426,247899,413166,"NZL",330533
1,66.0,"South America",1891248,1568296,322952,1250766,2084610,"BRA",1667688
1,66.0,"Northern Africa",1060055,0,1060055,743211,1238686,"EGY",990949
1,66.0,"Southern Asia",514202,0,514202,366769,611282,"IRN",489026
1,66.0,"Eastern Europe",3574106,3251586,322520,2378127,3963546,"POL",3170837
1,66.0,"Middle Africa",41878,0,41878,29141,48568,"AGO",38855
1,66.0,"Central America",388161,0,388161,275250,458751,"MEX",367001
1,66.0,"Southern Africa",103416,0,103416,72313,120522,"ZAF",96418
1,66.0,"South-Eastern Asia",679907,0,679907,483922,806537,"IDN",645230
1,66.0,"China",9497690,8451922,1045768,6752096,11253493,"CPR",9002795
1,66.0,"Pakistan",1677138,1393244,283894,1115619,1859365,"PAK",1487492
1,66.0,"Eastern Asia",749416,0,749416,516833,861388,"JPN",689111
1,66.0,"Russian Federation",3183685,2575725,607960,2267977,3779962,"RUS",3023970
1,66.0,"Western Asia",311915,0,311915,224647,374412,"IRQ",299530
1,66.0,"Southern Europe",506065,0,506065,364859,608098,"ITA",486479
1,66.0,"Eastern Africa",145230,0,145230,103026,171710,"ETH",137368
1,66.0,"Northern America",708726,697748,10978,493494,822490,"CAN",657992
1,66.0,"Northern Europe",1794804,1729169,65635,1279201,2132002,"GBR",1705602
1,66.0,"United States of America",2932697,2870491,62206,2076839,3461398,"USA",2769119
1,66.0,"Central Asia",1121857,989376,132481,815854,1359757,"UZB",1087806
1,66.0,"India",5111331,5023658,87673,3674156,6123593,"IND",4898875
1,67.0,"Western Europe",3331990,3200926,131064,2377932,3963221,"NLD",3170577
1,67.0,"Western Africa",183496,0,183496,128415,214025,"NGA",171220
1,67.0,"Oceania",365605,360450,5155,247899,413166,"NZL",330533
1,67.0,"South America",1755903,1466057,289846,1250766,2084610,"BRA",1667688
1,67.0,"Northern Africa",1060335,0,1060335,743211,1238686,"EGY",990949
1,67.0,"Southern Asia",514304,0,514304,366769,611282,"IRN",489026
1,67.0,"Eastern Europe",3549342,3256070,293272,2378127,3963546,"POL",3170837
1,67.0,"Middle Africa",41894,0,41894,29141,48568,"AGO",38855
1,67.0,"Central America",388440,0,388440,275250,458751,"MEX",367001
1,67.0,"Southern Africa",103443,0,103443,72313,120522,"ZAF",96418
1,67.0,"South-Eastern Asia",679865,0,679865,483922,806537,"IDN",645230
1,67.0,"China",9505846,8441437,1064409,6752096,11253493,"CPR",9002795
1,67.0,"Pakistan",1664660,1393540,271120,1115619,1859365,"PAK",1487492
1,67.0,"Eastern Asia",749341,0,749341,516833,861388,"JPN",689111
1,67.0,"Russian Federation",3245559,2612039,633520,2267977,3779962,"RUS",3023970
1,67.0,"Western Asia",311968,0,311968,224647,374412,"IRQ",299530
1,67.0,"Southern Europe",506399,0,506399,364859,608098,"ITA",486479
1,67.0,"Eastern Africa",145259,0,145259,103026,171710,"ETH",137368
1,67.0,"Northern America",712630,700139,12491,493494,822490,"CAN",657992
1,67.0,"Northern Europe",1819131,1750312,68819,1279201,2132002,"GBR",1705602
1,67.0,"United States of America",2932699,2872433,60266,2076839,3461398,"USA",2769119
1,67.0,"Central Asia",1130861,995332,135529,815854,1359757,"UZB",1087806
1,67.0,"India",5098339,5024784,73555,3674156,6123593,"IND",4898875
1,68.0,"Western Europe",3331992,3204991,127001,2377932,3963221,"NLD",3170577
1,68.0,"Western Africa",183828,0,183828,128415,214025,"NGA",171220
1,68.0,"Oceania",364628,358780,5848,247899,413166,"NZL",330533
1,68.0,"South America",1683592,1399580,284012,1250766,2084610,"BRA",1667688
1,68.0,"Northern Africa",1061638,0,1061638,743211,1238686,"EGY",990949
1,68.0,"Southern Asia",514781,0,514781,366769,611282,"IRN",489026
1,68.0,"Eastern Europe",2690530,2422620,267910,2378127,3963546,"POL",3170837
1,68.0,"Middle Africa",41863,0,41863,29141,48568,"AGO",38855
1,68.0,"Central America",389010,0,389010,275250,458751,"MEX",367001
1,68.0,"Southern Africa",103574,0,103574,72313,120522,"ZAF",96418
1,68.0,"South-Eastern Asia",679412,0,679412,483922,806537,"IDN",645230
1,68.0,"China",9528982,8445475,1083507,6752096,11253493,"CPR",9002795
1,68.0,"Pakistan",1652331,1391576,260755,1115619,1859365,"PAK",1487492
1,68.0,"Eastern Asia",748556,0,748556,516833,861388,"JPN",689111
1,68.0,"Russian Federation",3299038,2647698,651340,2267977,3779962,"RUS",3023970
1,68.0,"Western Asia",312200,0,312200,224647,374412,"IRQ",299530
1,68.0,"Southern Europe",507864,0,507864,364859,608098,"ITA",486479
1,68.0,"Eastern Africa",145409,0,145409,103026,171710,"ETH",137368
1,68.0,"Northern America",710678,698683,11995,493494,822490,"CAN",657992
1,68.0,"Northern Europe",1969150,1897856,71294,1279201,2132002,"GBR",1705602
1,68.0,"United States of America",2932697,2874372,58325,2076839,3461398,"USA",2769119
1,68.0,"Central Asia",1145006,1007188,137818,815854,1359757,"UZB",1087806
1,68.0,"India",5112424,5027141,85283,3674156,6123593,"IND",4898875
1,69.0,"Western Europe",3214601,3095828,118773,2377932,3963221,"NLD",3170577
1,69.0,"Western Africa",181544,0,181544,128415,214025,"NGA",171220
1,69.0,"Oceania",363655,358096,5559,247899,413166,"NZL",330533
1,69.0,"South America",1671944,1379212,292732,1250766,2084610,"BRA",1667688
1,69.0,"Northern Africa",1049178,0,1049178,743211,1238686,"EGY",990949
1,69.0,"Southern Asia",510237,0,510237,366769,611282,"IRN",489026
1,69.0,"Eastern Europe",2798971,2462873,336098,2378127,3963546,"POL",3170837
1,69.0,"Middle Africa",41407,0,41407,29141,48568,"AGO",38855
1,69.0,"Central America",385462,0,385462,275250,458751,"MEX",367001
1,69.0,"Southern Africa",102316,0,102316,72313,120522,"ZAF",96418
1,69.0,"South-Eastern Asia",674405,0,674405,483922,806537,"IDN",645230
1,69.0,"China",9824250,8735407,1088843,6752096,11253493,"CPR",9002795
1,69.0,"Pakistan",1642710,1393538,249172,1115619,1859365,"PAK",1487492
1,69.0,"Eastern Asia",740162,0,740162,516833,861388,"JPN",689111
1,69.0,"Russian Federation",3552094,2897773,654321,2267977,3779962,"RUS",3023970
1,69.0,"Western Asia",309966,0,309966,224647,374412,"IRQ",299530
1,69.0,"Southern Europe",505409,0,505409,364859,608098,"ITA",486479
1,69.0,"Eastern Africa",143991,0,143991,103026,171710,"ETH",137368
1,69.0,"Northern America",710677,698623,12054,493494,822490,"CAN",657992
1,69.0,"Northern Europe",1944821,1879665,65156,1279201,2132002,"GBR",1705602
1,69.0,"United States of America",2925585,2869201,56384,2076839,3461398,"USA",2769119
1,69.0,"Central Asia",1162957,1025945,137012,815854,1359757,"UZB",1087806
1,69.0,"India",5086250,5015734,70516,3674156,6123593,"IND",4898875
1,70.0,"Western Europe",3229275,3113676,115599,2377932,3963221,"NLD",3170577
1,70.0,"Western Africa",182421,0,182421,128415,214025,"NGA",171220
1,70.0,"Oceania",362681,357026,5655,247899,413166,"NZL",330533
1,70.0,"South America",1674642,1371126,303516,1250766,2084610,"BRA",1667688
1,70.0,"Northern Africa",1047508,0,1047508,743211,1238686,"EGY",990949
1,70.0,"Southern Asia",509631,0,509631,366769,611282,"IRN",489026
1,70.0,"Eastern Europe",2929827,2537736,392091,2378127,3963546,"POL",3170837
1,70.0,"Middle Africa",41334,0,41334,29141,48568,"AGO",38855
1,70.0,"Central America",386659,0,386659,275250,458751,"MEX",367001
1,70.0,"Southern Africa",102145,0,102145,72313,120522,"ZAF",96418
1,70.0,"South-Eastern Asia",673945,0,673945,483922,806537,"IDN",645230
1,70.0,"China",9822691,8732071,1090620,6752096,11253493,"CPR",9002795
1,70.0,"Pakistan",1632782,1394024,238758,1115619,1859365,"PAK",1487492
1,70.0,"Eastern Asia",738924,0,738924,516833,861388,"JPN",689111
1,70.0,"Russian Federation",3519964,2898295,621669,2267977,3779962,"RUS",3023970
1,70.0,"Western Asia",309668,0,309668,224647,374412,"IRQ",299530
1,70.0,"Southern Europe",504865,0,504865,364859,608098,"ITA",486479
1,70.0,"Eastern Africa",143802,0,143802,103026,171710,"ETH",137368
1,70.0,"Northern America",710677,697234,13443,493494,822490,"CAN",657992
1,70.0,"Northern Europe",1912385,1856753,55632,1279201,2132002,"GBR",1705602
1,70.0,"United States of America",2911360,2856833,54527,2076839,3461398,"USA",2769119
1,70.0,"Central Asia",1119081,984604,134477,815854,1359757,"UZB",1087806
1,70.0,"India",5038040,4980955,57085,3674156,6123593,"IND",4898875
1,71.0,"Western Europe",3251285,3137088,114197,2377939,3963232,"NLD",3170586
1,71.0,"Western Africa",181750,0,181750,128416,214027,"NGA",171222
1,71.0,"Oceania",357809,351507,6302,247905,413175,"NZL",330540
1,71.0,"South America",1693552,1380488,313064,1250768,2084613,"BRA",1667691
1,71.0,"Northern Africa",1044116,0,1044116,743211,1238686,"EGY",990949
1,71.0,"Southern Asia",508396,0,508396,366772,611287,"IRN",489030
1,71.0,"Eastern Europe",3087566,2641970,445596,2378129,3963548,"POL",3170839
1,71.0,"Middle Africa",41184,0,41184,29145,48575,"AGO",38860
1,71.0,"Central America",385480,0,385480,275253,458755,"MEX",367004
1,71.0,"Southern Africa",101803,0,101803,72316,120527,"ZAF",96422
1,71.0,"South-Eastern Asia",672224,0,672224,483925,806542,"IDN",645234
1,71.0,"China",9797614,8734843,1062771,6752099,11253498,"CPR",9002799
1,71.0,"Pakistan",1622358,1393288,229070,1115623,1859372,"PAK",1487498
1,71.0,"Eastern Asia",735934,0,735934,516837,861396,"JPN",689117
1,71.0,"Russian Federation",3491765,2900817,590948,2267984,3779973,"RUS",3023979
1,71.0,"Western Asia",309061,0,309061,224652,374420,"IRQ",299536
1,71.0,"Southern Europe",503765,0,503765,364861,608102,"ITA",486482
1,71.0,"Eastern Africa",143415,0,143415,103029,171716,"ETH",137373
1,71.0,"Northern America",708727,693980,14747,493497,822496,"CAN",657997
1,71.0,"Northern Europe",1762368,1715936,46432,1279209,2132016,"GBR",1705613
1,71.0,"United States of America",2904248,2851409,52839,2076841,3461402,"USA",2769122
1,71.0,"Central Asia",1126273,990242,136031,815861,1359768,"UZB",1087815
1,71.0,"India",5025086,4980827,44259,3674164,6123607,"IND",4898886
1,72.0,"Western Europe",3258621,3146352,112269,2323173,3871956,"NLD",3097565
1,72.0,"Western Africa",181154,0,181154,155244,258740,"NGA",206992
1,72.0,"Oceania",354888,347932,6956,281041,468402,"NZL",374722
1,72.0,"South America",1673411,1355493,317918,1241361,2068936,"BRA",1655149
1,72.0,"Northern Africa",1041102,0,1041102,915027,1525046,"EGY",1220037
1,72.0,"Southern Asia",507298,0,507298,491879,819798,"IRN",655839
1,72.0,"Eastern Europe",3242374,2753906,488468,2457273,4095456,"POL",3276365
1,72.0,"Middle Africa",41052,0,41052,40604,67673,"AGO",54139
1,72.0,"Central America",384432,0,384432,258303,430505,"MEX",344404
1,72.0,"Southern Africa",101496,0,101496,27311,45518,"ZAF",36415
1,72.0,"South-Eastern Asia",670693,0,670693,483602,806003,"IDN",644803
1,72.0,"China",9772883,8738405,1034478,6833422,11389037,"CPR",9111230
1,72.0,"Pakistan",1583650,1367551,216099,1197997,1996662,"PAK",1597330
1,72.0,"Eastern Asia",733280,0,733280,595878,993130,"JPN",794504
1,72.0,"Russian Federation",3455156,2901732,553424,2215158,3691931,"RUS",2953545
1,72.0,"Western Asia",308521,0,308521,421154,701923,"IRQ",561539
1,72.0,"Southern Europe",502783,0,502783,520632,867720,"ITA",694176
1,72.0,"Eastern Africa",143074,0,143074,90013,150022,"ETH",120018
1,72.0,"Northern America",702873,688771,14102,445551,742586,"CAN",594069
1,72.0,"Northern Europe",1693440,1653120,40320,1354410,2257350,"GBR",1805880
1,72.0,"United States of America",2904247,2850669,53578,1994303,3323838,"USA",2659071
1,72.0,"Central Asia",1128724,992306,136418,815586,1359310,"UZB",1087448
1,72.0,"India",5024691,4993115,31576,3944331,6573885,"IND",5259108
1,73.0,"Western Europe",3265964,3155801,110163,2323173,3871956,"NLD",3097565
1,73.0,"Western Africa",183065,0,183065,155244,258740,"NGA",206992
1,73.0,"Oceania",392885,386231,6654,281041,468402,"NZL",374722
1,73.0,"South America",662247,329126,333121,1241361,2068936,"BRA",1655149
1,73.0,"Northern Africa",1050741,0,1050741,915027,1525046,"EGY",1220037
1,73.0,"Southern Asia",510810,0,510810,491879,819798,"IRN",655839
1,73.0,"Eastern Europe",3384085,2868171,515914,2457273,4095456,"POL",3276365
1,73.0,"Middle Africa",41483,0,41483,40604,67673,"AGO",54139
1,73.0,"Central America",387784,0,387784,258303,430505,"MEX",344404
1,73.0,"Southern Africa",102479,0,102479,27311,45518,"ZAF",36415
1,73.0,"South-Eastern Asia",675593,0,675593,483602,806003,"IDN",644803
1,73.0,"China",9759950,8742448,1017502,6833422,11389037,"CPR",9111230
1,73.0,"Pakistan",1507496,1295275,212221,1197997,1996662,"PAK",1597330
1,73.0,"Eastern Asia",741778,0,741778,595878,993130,"JPN",794504
1,73.0,"Russian Federation",3435527,2907776,527751,2215158,3691931,"RUS",2953545
1,73.0,"Western Asia",310255,0,310255,421154,701923,"IRQ",561539
1,73.0,"Southern Europe",505921,0,505921,520632,867720,"ITA",694176
1,73.0,"Eastern Africa",144175,0,144175,90013,150022,"ETH",120018
1,73.0,"Northern America",697024,683492,13532,445551,742586,"CAN",594069
1,73.0,"Northern Europe",1709664,1674579,35085,1354410,2257350,"GBR",1805880
1,73.0,"United States of America",2897139,2842022,55117,1994303,3323838,"USA",2659071
1,73.0,"Central Asia",1138016,997753,140263,815586,1359310,"UZB",1087448
1,73.0,"India",5015689,4992299,23390,3944331,6573885,"IND",5259108
1,74.0,"Western Europe",3082897,2977389,105508,2323173,3871956,"NLD",3097565
1,74.0,"Western Africa",204090,0,204090,155244,258740,"NGA",206992
1,74.0,"Oceania",380569,375225,5344,281041,468402,"NZL",374722
1,74.0,"South America",952307,402714,549593,1241361,2068936,"BRA",1655149
1,74.0,"Northern Africa",1205395,0,1205395,915027,1525046,"EGY",1220037
1,74.0,"Southern Asia",650503,0,650503,491879,819798,"IRN",655839
1,74.0,"Eastern Europe",3381921,2887707,494214,2457273,4095456,"POL",3276365
1,74.0,"Middle Africa",53478,0,53478,40604,67673,"AGO",54139
1,74.0,"Central America",339327,0,339327,258303,430505,"MEX",344404
1,74.0,"Southern Africa",34940,0,34940,27311,45518,"ZAF",36415
1,74.0,"South-Eastern Asia",637378,0,637378,483602,806003,"IDN",644803
1,74.0,"China",9689432,8746799,942633,6833422,11389037,"CPR",9111230
1,74.0,"Pakistan",1533257,1315275,217982,1197997,1996662,"PAK",1597330
1,74.0,"Eastern Asia",781609,0,781609,595878,993130,"JPN",794504
1,74.0,"Russian Federation",3350818,2905300,445518,2215158,3691931,"RUS",2953545
1,74.0,"Western Asia",558884,0,558884,421154,701923,"IRQ",561539
1,74.0,"Southern Europe",689414,0,689414,520632,867720,"ITA",694176
1,74.0,"Eastern Africa",118360,0,118360,90013,150022,"ETH",120018
1,74.0,"Northern America",582362,570141,12221,445551,742586,"CAN",594069
1,74.0,"Northern Europe",1704514,1673610,30904,1354410,2257350,"GBR",1805880
1,74.0,"United States of America",2595064,2550610,44454,1994303,3323838,"USA",2659071
1,74.0,"Central Asia",1127058,994685,132373,815586,1359310,"UZB",1087448
1,74.0,"India",4989775,4979662,10113,3944331,6573885,"IND",5259108
1,75.0,"Western Europe",3075553,2976167,99386,2323173,3871956,"NLD",3097565
1,75.0,"Western Africa",203572,0,203572,155244,258740,"NGA",206992
1,75.0,"Oceania",376671,372498,4173,281041,468402,"NZL",374722
1,75.0,"South America",1153478,450625,702853,1241361,2068936,"BRA",1655149
1,75.0,"Northern Africa",1202772,0,1202772,915027,1525046,"EGY",1220037
1,75.0,"Southern Asia",649548,0,649548,491879,819798,"IRN",655839
1,75.0,"Eastern Europe",3412929,2940884,472045,2457273,4095456,"POL",3276365
1,75.0,"Middle Africa",53378,0,53378,40604,67673,"AGO",54139
1,75.0,"Central America",338403,0,338403,258303,430505,"MEX",344404
1,75.0,"Southern Africa",34623,0,34623,27311,45518,"ZAF",36415
1,75.0,"South-Eastern Asia",636035,0,636035,483602,806003,"IDN",644803
1,75.0,"China",9599311,8727333,871978,6833422,11389037,"CPR",9111230
1,75.0,"Pakistan",1516745,1298089,218656,1197997,1996662,"PAK",1597330
1,75.0,"Eastern Asia",779300,0,779300,595878,993130,"JPN",794504
1,75.0,"Russian Federation",3201922,2835773,366149,2215158,3691931,"RUS",2953545
1,75.0,"Western Asia",558443,0,558443,421154,701923,"IRQ",561539
1,75.0,"Southern Europe",688560,0,688560,520632,867720,"ITA",694176
1,75.0,"Eastern Africa",118050,0,118050,90013,150022,"ETH",120018
1,75.0,"Northern America",584311,573746,10565,445551,742586,"CAN",594069
1,75.0,"Northern Europe",1688297,1661736,26561,1354410,2257350,"GBR",1805880
1,75.0,"United States of America",2587950,2550881,37069,1994303,3323838,"USA",2659071
1,75.0,"Central Asia",1123232,995743,127489,815586,1359310,"UZB",1087448
1,75.0,"India",5001821,4989532,12289,3944331,6573885,"IND",5259108
1,76.0,"Western Europe",3075551,2977873,97678,2323173,3871956,"NLD",3097565
1,76.0,"Western Africa",203990,0,203990,155244,258740,"NGA",206992
1,76.0,"Oceania",377645,374607,3038,281041,468402,"NZL",374722
1,76.0,"South America",1281377,468096,813281,1241361,2068936,"BRA",1655149
1,76.0,"Northern Africa",1204898,0,1204898,915027,1525046,"EGY",1220037
1,76.0,"Southern Asia",650323,0,650323,491879,819798,"IRN",655839
1,76.0,"Eastern Europe",3470855,3014867,455988,2457273,4095456,"POL",3276365
1,76.0,"Middle Africa",53562,0,53562,40604,67673,"AGO",54139
1,76.0,"Central America",339213,0,339213,258303,430505,"MEX",344404
1,76.0,"Southern Africa",35016,0,35016,27311,45518,"ZAF",36415
1,76.0,"South-Eastern Asia",637417,0,637417,483602,806003,"IDN",644803
1,76.0,"China",9535533,8736720,798813,6833422,11389037,"CPR",9111230
1,76.0,"Pakistan",1526807,1299426,227381,1197997,1996662,"PAK",1597330
1,76.0,"Eastern Asia",781170,0,781170,595878,993130,"JPN",794504
1,76.0,"Russian Federation",2969884,2658760,311124,2215158,3691931,"RUS",2953545
1,76.0,"Western Asia",558888,0,558888,421154,701923,"IRQ",561539
1,76.0,"Southern Europe",689252,0,689252,520632,867720,"ITA",694176
1,76.0,"Eastern Africa",118296,0,118296,90013,150022,"ETH",120018
1,76.0,"Northern America",586261,575592,10669,445551,742586,"CAN",594069
1,76.0,"Northern Europe",1696405,1668599,27806,1354410,2257350,"GBR",1805880
1,76.0,"United States of America",2595062,2561059,34003,1994303,3323838,"USA",2659071
1,76.0,"Central Asia",1117776,994638,123138,815586,1359310,"UZB",1087448
1,76.0,"India",5123305,5093861,29444,3944331,6573885,"IND",5259108
1,77.0,"Western Europe",3075552,2977755,97797,2323173,3871956,"NLD",3097565
1,77.0,"Western Africa",203893,0,203893,155244,258740,"NGA",206992
1,77.0,"Oceania",371801,369897,1904,281041,468402,"NZL",374722
1,77.0,"South America",1378995,483323,895672,1241361,2068936,"BRA",1655149
1,77.0,"Northern Africa",1204403,0,1204403,915027,1525046,"EGY",1220037
1,77.0,"Southern Asia",650140,0,650140,491879,819798,"IRN",655839
1,77.0,"Eastern Europe",3503021,3071177,431844,2457273,4095456,"POL",3276365
1,77.0,"Middle Africa",53442,0,53442,40604,67673,"AGO",54139
1,77.0,"Central America",338971,0,338971,258303,430505,"MEX",344404
1,77.0,"Southern Africa",34952,0,34952,27311,45518,"ZAF",36415
1,77.0,"South-Eastern Asia",637536,0,637536,483602,806003,"IDN",644803
1,77.0,"China",9474505,8744583,729922,6833422,11389037,"CPR",9111230
1,77.0,"Pakistan",1542444,1308099,234345,1197997,1996662,"PAK",1597330
1,77.0,"Eastern Asia",780737,0,780737,595878,993130,"JPN",794504
1,77.0,"Russian Federation",2918931,2627680,291251,2215158,3691931,"RUS",2953545
1,77.0,"Western Asia",558734,0,558734,421154,701923,"IRQ",561539
1,77.0,"Southern Europe",689093,0,689093,520632,867720,"ITA",694176
1,77.0,"Eastern Africa",118234,0,118234,90013,150022,"ETH",120018
1,77.0,"Northern America",586214,575510,10704,445551,742586,"CAN",594069
1,77.0,"Northern Europe",1708569,1679604,28965,1354410,2257350,"GBR",1805880
1,77.0,"United States of America",2602173,2567970,34203,1994303,3323838,"USA",2659071
1,77.0,"Central Asia",1114679,995577,119102,815586,1359310,"UZB",1087448
1,77.0,"India",5135842,5096123,39719,3944331,6573885,"IND",5259108
1,78.0,"Western Europe",3075551,2977278,98273,2323173,3871956,"NLD",3097565
1,78.0,"Western Africa",204890,0,204890,155244,258740,"NGA",206992
1,78.0,"Oceania",377642,376859,783,281041,468402,"NZL",374722
1,78.0,"South America",1452509,494049,958460,1241361,2068936,"BRA",1655149
1,78.0,"Northern Africa",1209437,0,1209437,915027,1525046,"EGY",1220037
1,78.0,"Southern Asia",651974,0,651974,491879,819798,"IRN",655839
1,78.0,"Eastern Europe",3466103,3068814,397289,2457273,4095456,"POL",3276365
1,78.0,"Middle Africa",53669,0,53669,40604,67673,"AGO",54139
1,78.0,"Central America",340718,0,340718,258303,430505,"MEX",344404
1,78.0,"Southern Africa",35361,0,35361,27311,45518,"ZAF",36415
1,78.0,"South-Eastern Asia",639578,0,639578,483602,806003,"IDN",644803
1,78.0,"China",9413230,8747067,666163,6833422,11389037,"CPR",9111230
1,78.0,"Pakistan",1606983,1366756,240227,1197997,1996662,"PAK",1597330
1,78.0,"Eastern Asia",785391,0,785391,595878,993130,"JPN",794504
1,78.0,"Russian Federation",2938595,2657542,281053,2215158,3691931,"RUS",2953545
1,78.0,"Western Asia",559634,0,559634,421154,701923,"IRQ",561539
1,78.0,"Southern Europe",690727,0,690727,520632,867720,"ITA",694176
1,78.0,"Eastern Africa",118808,0,118808,90013,150022,"ETH",120018
1,78.0,"Northern America",586261,575474,10787,445551,742586,"CAN",594069
1,78.0,"Northern Europe",1777495,1746197,31298,1354410,2257350,"GBR",1805880
1,78.0,"United States of America",2616397,2581725,34672,1994303,3323838,"USA",2659071
1,78.0,"Central Asia",1109496,994641,114855,815586,1359310,"UZB",1087448
1,78.0,"India",5172778,5116093,56685,3944331,6573885,"IND",5259108
1,79.0,"Western Europe",3082889,2984139,98750,2323173,3871956,"NLD",3097565
1,79.0,"Western Africa",205707,0,205707,155244,258740,"NGA",206992
1,79.0,"Oceania",373748,373748,0,281041,468402,"NZL",374722
1,79.0,"South America",1502883,496367,1006516,1241361,2068936,"BRA",1655149
1,79.0,"Northern Africa",1213567,0,1213567,915027,1525046,"EGY",1220037
1,79.0,"Southern Asia",653477,0,653477,491879,819798,"IRN",655839
1,79.0,"Eastern Europe",3438372,3066099,372273,2457273,4095456,"POL",3276365
1,79.0,"Middle Africa",53853,0,53853,40604,67673,"AGO",54139
1,79.0,"Central America",342153,0,342153,258303,430505,"MEX",344404
1,79.0,"Southern Africa",35711,0,35711,27311,45518,"ZAF",36415
1,79.0,"South-Eastern Asia",641327,0,641327,483602,806003,"IDN",644803
1,79.0,"China",9262545,8652398,610147,6833422,11389037,"CPR",9111230
1,79.0,"Pakistan",1604911,1368125,236786,1197997,1996662,"PAK",1597330
1,79.0,"Eastern Asia",788579,0,788579,595878,993130,"JPN",794504
1,79.0,"Russian Federation",2880636,2609984,270652,2215158,3691931,"RUS",2953545
1,79.0,"Western Asia",560374,0,560374,421154,701923,"IRQ",561539
1,79.0,"Southern Europe",692071,0,692071,520632,867720,"ITA",694176
1,79.0,"Eastern Africa",119278,0,119278,90013,150022,"ETH",120018
1,79.0,"Northern America",588213,577343,10870,445551,742586,"CAN",594069
1,79.0,"Northern Europe",1826151,1789069,37082,1354410,2257350,"GBR",1805880
1,79.0,"United States of America",2637735,2602711,35024,1994303,3323838,"USA",2659071
1,79.0,"Central Asia",1095675,986712,108963,815586,1359310,"UZB",1087448
1,79.0,"India",5185135,5111875,73260,3944331,6573885,"IND",5259108
1,80.0,"Western Europe",3082889,2983822,99067,2323173,3871956,"NLD",3097565
1,80.0,"Western Africa",207145,0,207145,155244,258740,"NGA",206992
1,80.0,"Oceania",373748,373748,0,281041,468402,"NZL",374722
1,80.0,"South America",1544592,498575,1046017,1241361,2068936,"BRA",1655149
1,80.0,"Northern Africa",1220817,0,1220817,915027,1525046,"EGY",1220037
1,80.0,"Southern Asia",656123,0,656123,491879,819798,"IRN",655839
1,80.0,"Eastern Europe",3571404,3217234,354170,2457273,4095456,"POL",3276365
1,80.0,"Middle Africa",54165,0,54165,40604,67673,"AGO",54139
1,80.0,"Central America",344675,0,344675,258303,430505,"MEX",344404
1,80.0,"Southern Africa",36229,0,36229,27311,45518,"ZAF",36415
1,80.0,"South-Eastern Asia",644255,0,644255,483602,806003,"IDN",644803
1,80.0,"China",9094273,8519480,574793,6833422,11389037,"CPR",9111230
1,80.0,"Pakistan",1603911,1368077,235834,1197997,1996662,"PAK",1597330
1,80.0,"Eastern Asia",795194,0,795194,595878,993130,"JPN",794504
1,80.0,"Russian Federation",2858356,2586374,271982,2215158,3691931,"RUS",2953545
1,80.0,"Western Asia",561677,0,561677,421154,701923,"IRQ",561539
1,80.0,"Southern Europe",694428,0,694428,520632,867720,"ITA",694176
1,80.0,"Eastern Africa",120103,0,120103,90013,150022,"ETH",120018
1,80.0,"Northern America",590165,579233,10932,445551,742586,"CAN",594069
1,80.0,"Northern Europe",1976172,1933972,42200,1354410,2257350,"GBR",1805880
1,80.0,"United States of America",2666181,2629267,36914,1994303,3323838,"USA",2659071
1,80.0,"Central Asia",1065425,960547,104878,815586,1359310,"UZB",1087448
1,80.0,"India",5221678,5131825,89853,3944331,6573885,"IND",5259108
1,81.0,"Western Europe",3075551,2976167,99384,2323173,3871956,"NLD",3097565
1,81.0,"Western Africa",199741,0,199741,155244,258740,"NGA",206992
1,81.0,"Oceania",374722,374722,0,281041,468402,"NZL",374722
1,81.0,"South America",1560558,497698,1062860,1241361,2068936,"BRA",1655149
1,81.0,"Northern Africa",1183403,0,1183403,915027,1525046,"EGY",1220037
1,81.0,"Southern Asia",642497,0,642497,491879,819798,"IRN",655839
1,81.0,"Eastern Europe",3269367,2986285,283082,2457273,4095456,"POL",3276365
1,81.0,"Middle Africa",52542,0,52542,40604,67673,"AGO",54139
1,81.0,"Central America",331678,0,331678,258303,430505,"MEX",344404
1,81.0,"Southern Africa",32766,0,32766,27311,45518,"ZAF",36415
1,81.0,"South-Eastern Asia",626195,0,626195,483602,806003,"IDN",644803
1,81.0,"China",9126352,8562351,564001,6833422,11389037,"CPR",9111230
1,81.0,"Pakistan",1600596,1368867,231729,1197997,1996662,"PAK",1597330
1,81.0,"Eastern Asia",762241,0,762241,595878,993130,"JPN",794504
1,81.0,"Russian Federation",2790500,2533502,256998,2215158,3691931,"RUS",2953545
1,81.0,"Western Asia",554979,0,554979,421154,701923,"IRQ",561539
1,81.0,"Southern Europe",682270,0,682270,520632,867720,"ITA",694176
1,81.0,"Eastern Africa",115858,0,115858,90013,150022,"ETH",120018
1,81.0,"Northern America",640852,629924,10928,445551,742586,"CAN",594069
1,81.0,"Northern Europe",1976172,1931413,44759,1354410,2257350,"GBR",1805880
1,81.0,"United States of America",2331922,2287105,44817,1994303,3323838,"USA",2659071
1,81.0,"Central Asia",1069849,960692,109157,815586,1359310,"UZB",1087448
1,81.0,"India",5237617,5128209,109408,3944331,6573885,"IND",5259108
1,82.0,"Western Europe",3068215,2959018,109197,2323173,3871956,"NLD",3097565
1,82.0,"Western Africa",200668,0,200668,155244,258740,"NGA",206992
1,82.0,"Oceania",371800,371800,0,281041,468402,"NZL",374722
1,82.0,"South America",1578541,500678,1077863,1241361,2068936,"BRA",1655149
1,82.0,"Northern Africa",1188110,0,1188110,915027,1525046,"EGY",1220037
1,82.0,"Southern Asia",644208,0,644208,491879,819798,"IRN",655839
1,82.0,"Eastern Europe",3251154,2977896,273258,2457273,4095456,"POL",3276365
1,82.0,"Middle Africa",52738,0,52738,40604,67673,"AGO",54139
1,82.0,"Central America",333307,0,333307,258303,430505,"MEX",344404
1,82.0,"Southern Africa",33099,0,33099,27311,45518,"ZAF",36415
1,82.0,"South-Eastern Asia",628592,0,628592,483602,806003,"IDN",644803
1,82.0,"China",9047758,8510035,537723,6833422,11389037,"CPR",9111230
1,82.0,"Pakistan",1597252,1366128,231124,1197997,1996662,"PAK",1597330
1,82.0,"Eastern Asia",766383,0,766383,595878,993130,"JPN",794504
1,82.0,"Russian Federation",2792778,2535463,257315,2215158,3691931,"RUS",2953545
1,82.0,"Western Asia",555814,0,555814,421154,701923,"IRQ",561539
1,82.0,"Southern Europe",683796,0,683796,520632,867720,"ITA",694176
1,82.0,"Eastern Africa",116384,0,116384,90013,150022,"ETH",120018
1,82.0,"Northern America",597977,587552,10425,445551,742586,"CAN",594069
1,82.0,"Northern Europe",1923462,1881562,41900,1354410,2257350,"GBR",1805880
1,82.0,"United States of America",2459935,2403080,56855,1994303,3323838,"USA",2659071
1,82.0,"Central Asia",1150677,1039931,110746,815586,1359310,"UZB",1087448
1,82.0,"India",5283590,5160502,123088,3944331,6573885,"IND",5259108
1,83.0,"Western Europe",3060877,2950985,109892,2323180,3871967,"NLD",3097574
1,83.0,"Western Africa",201562,0,201562,155250,258751,"NGA",207001
1,83.0,"Oceania",376670,376670,0,281043,468405,"NZL",374724
1,83.0,"South America",1589936,499466,1090470,1241367,2068946,"BRA",1655157
1,83.0,"Northern Africa",1192635,0,1192635,915033,1525055,"EGY",1220044
1,83.0,"Southern Asia",645854,0,645854,491884,819807,"IRN",655846
1,83.0,"Eastern Europe",3289515,3026008,263507,2457279,4095465,"POL",3276372
1,83.0,"Middle Africa",52935,0,52935,40605,67675,"AGO",54140
1,83.0,"Central America",334880,0,334880,258303,430505,"MEX",344404
1,83.0,"Southern Africa",33635,0,33635,27316,45527,"ZAF",36422
1,83.0,"South-Eastern Asia",630891,0,630891,483606,806010,"IDN",644808
1,83.0,"China",9150706,8639645,511061,6833424,11389041,"CPR",9111233
1,83.0,"Pakistan",1595582,1366193,229389,1198003,1996672,"PAK",1597338
1,83.0,"Eastern Asia",770373,0,770373,595883,993138,"JPN",794511
1,83.0,"Russian Federation",2825468,2561432,264036,2215167,3691945,"RUS",2953556
1,83.0,"Western Asia",556624,0,556624,421155,701925,"IRQ",561540
1,83.0,"Southern Europe",685266,0,685266,520638,867730,"ITA",694184
1,83.0,"Eastern Africa",116899,0,116899,90015,150026,"ETH",120021
1,83.0,"Northern America",582364,571980,10384,445557,742596,"CAN",594077
1,83.0,"Northern Europe",1813991,1779226,34765,1354413,2257356,"GBR",1805885
1,83.0,"United States of America",2523941,2456292,67649,1994303,3323838,"USA",2659071
1,83.0,"Central Asia",1093199,992569,100630,815594,1359323,"UZB",1087459
1,83.0,"India",5332338,5194075,138263,3944336,6573893,"IND",5259115
1,84.0,"Western Europe",3053542,2942780,110762,2255854,3759757,"NLD",3007806
1,84.0,"Western Africa",202899,0,202899,193263,322106,"NGA",257685
1,84.0,"Oceania",378618,378618,0,261248,435413,"NZL",348331
1,84.0,"South America",1602128,499176,1102952,1124795,1874658,"BRA",1499727
1,84.0,"Northern Africa",1199382,0,1199382,727215,1212026,"EGY",969621
1,84.0,"Southern Asia",648312,0,648312,293304,488841,"IRN",391073
1,84.0,"Eastern Europe",3307433,3056739,250694,2201805,3669675,"POL",2935740
1,84.0,"Middle Africa",53233,0,53233,40744,67907,"AGO",54326
1,84.0,"Central America",337224,0,337224,296888,494813,"MEX",395851
1,84.0,"Southern Africa",34317,0,34317,34012,56687,"ZAF",45350
1,84.0,"South-Eastern Asia",634313,0,634313,399810,666350,"IDN",533080
1,84.0,"China",9197995,8718227,479768,6053438,10089063,"CPR",8071251
1,84.0,"Pakistan",1592389,1364504,227885,1092838,1821397,"PAK",1457118
1,84.0,"Eastern Asia",776311,0,776311,570050,950083,"JPN",760067
1,84.0,"Russian Federation",2857344,2585208,272136,1979139,3298565,"RUS",2638852
1,84.0,"Western Asia",557833,0,557833,346746,577910,"IRQ",462328
1,84.0,"Southern Europe",687461,0,687461,480413,800688,"ITA",640551
1,84.0,"Eastern Africa",117663,0,117663,109601,182668,"ETH",146135
1,84.0,"Northern America",582358,571849,10509,433824,723040,"CAN",578432
1,84.0,"Northern Europe",1822101,1792851,29250,1205406,2009010,"GBR",1607208
1,84.0,"United States of America",2566614,2488851,77763,1978305,3297175,"USA",2637740
1,84.0,"Central Asia",1097623,1001781,95842,660966,1101611,"UZB",881289
1,84.0,"India",5381614,5228712,152902,3620392,6033987,"IND",4827190
1,85.0,"Western Europe",3060888,2949081,111807,2255854,3759757,"NLD",3007806
1,85.0,"Western Africa",204582,0,204582,193263,322106,"NGA",257685
1,85.0,"Oceania",379595,379595,0,261248,435413,"NZL",348331
1,85.0,"South America",2954731,1839486,1115245,1124795,1874658,"BRA",1499727
1,85.0,"Northern Africa",1207846,0,1207846,727215,1212026,"EGY",969621
1,85.0,"Southern Asia",651401,0,651401,293304,488841,"IRN",391073
1,85.0,"Eastern Europe",3317303,3078785,238518,2201805,3669675,"POL",2935740
1,85.0,"Middle Africa",53601,0,53601,40744,67907,"AGO",54326
1,85.0,"Central America",340164,0,340164,296888,494813,"MEX",395851
1,85.0,"Southern Africa",35181,0,35181,34012,56687,"ZAF",45350
1,85.0,"South-Eastern Asia",638611,0,638611,399810,666350,"IDN",533080
1,85.0,"China",9224285,8771807,452478,6053438,10089063,"CPR",8071251
1,85.0,"Pakistan",1593417,1365500,227917,1092838,1821397,"PAK",1457118
1,85.0,"Eastern Asia",783765,0,783765,570050,950083,"JPN",760067
1,85.0,"Russian Federation",2904870,2624815,280055,1979139,3298565,"RUS",2638852
1,85.0,"Western Asia",559350,0,559350,346746,577910,"IRQ",462328
1,85.0,"Southern Europe",690215,0,690215,480413,800688,"ITA",640551
1,85.0,"Eastern Africa",118628,0,118628,109601,182668,"ETH",146135
1,85.0,"Northern America",592123,581489,10634,433824,723040,"CAN",578432
1,85.0,"Northern Europe",1826159,1801896,24263,1205406,2009010,"GBR",1607208
1,85.0,"United States of America",2595061,2507774,87287,1978305,3297175,"USA",2637740
1,85.0,"Central Asia",1101368,1009194,92174,660966,1101611,"UZB",881289
1,85.0,"India",5394445,5243580,150865,3620392,6033987,"IND",4827190
1,86.0,"Western Europe",3198566,3088019,110547,2255854,3759757,"NLD",3007806
1,86.0,"Western Africa",273429,0,273429,193263,322106,"NGA",257685
1,86.0,"Oceania",349305,349305,0,261248,435413,"NZL",348331
1,86.0,"South America",2656061,1842520,813541,1124795,1874658,"BRA",1499727
1,86.0,"Northern Africa",1049175,0,1049175,727215,1212026,"EGY",969621
1,86.0,"Southern Asia",420052,0,420052,293304,488841,"IRN",391073
1,86.0,"Eastern Europe",2975668,2759531,216137,2201805,3669675,"POL",2935740
1,86.0,"Middle Africa",57796,0,57796,40744,67907,"AGO",54326
1,86.0,"Central America",423489,0,423489,296888,494813,"MEX",395851
1,86.0,"Southern Africa",53388,0,53388,34012,56687,"ZAF",45350
1,86.0,"South-Eastern Asia",573472,0,573472,399810,666350,"IDN",533080
1,86.0,"China",8148853,7749448,399405,6053438,10089063,"CPR",8071251
1,86.0,"Pakistan",1606302,1383685,222617,1092838,1821397,"PAK",1457118
1,86.0,"Eastern Asia",830128,0,830128,570050,950083,"JPN",760067
1,86.0,"Russian Federation",2949463,2663992,285471,1979139,3298565,"RUS",2638852
1,86.0,"Western Asia",476589,0,476589,346746,577910,"IRQ",462328
1,86.0,"Southern Europe",666410,0,666410,480413,800688,"ITA",640551
1,86.0,"Eastern Africa",155171,0,155171,109601,182668,"ETH",146135
1,86.0,"Northern America",664264,653802,10462,433824,723040,"CAN",578432
1,86.0,"Northern Europe",1611264,1593630,17634,1205406,2009010,"GBR",1607208
1,86.0,"United States of America",2865320,2769311,96009,1978305,3297175,"USA",2637740
1,86.0,"Central Asia",894222,817920,76302,660966,1101611,"UZB",881289
1,86.0,"India",5393942,5252550,141392,3620392,6033987,"IND",4827190
1,87.0,"Western Europe",3213240,3102851,110389,2255854,3759757,"NLD",3007806
1,87.0,"Western Africa",274458,0,274458,193263,322106,"NGA",257685
1,87.0,"Oceania",350279,350279,0,261248,435413,"NZL",348331
1,87.0,"South America",2423195,1841984,581211,1124795,1874658,"BRA",1499727
1,87.0,"Northern Africa",1054325,0,1054325,727215,1212026,"EGY",969621
1,87.0,"Southern Asia",421929,0,421929,293304,488841,"IRN",391073
1,87.0,"Eastern Europe",2973814,2749297,224517,2201805,3669675,"POL",2935740
1,87.0,"Middle Africa",58035,0,58035,40744,67907,"AGO",54326
1,87.0,"Central America",425284,0,425284,296888,494813,"MEX",395851
1,87.0,"Southern Africa",53932,0,53932,34012,56687,"ZAF",45350
1,87.0,"South-Eastern Asia",576083,0,576083,399810,666350,"IDN",533080
1,87.0,"China",8134978,7745424,389554,6053438,10089063,"CPR",8071251
1,87.0,"Pakistan",1598710,1384753,213957,1092838,1821397,"PAK",1457118
1,87.0,"Eastern Asia",834667,0,834667,570050,950083,"JPN",760067
1,87.0,"Russian Federation",2997510,2699378,298132,1979139,3298565,"RUS",2638852
1,87.0,"Western Asia",477508,0,477508,346746,577910,"IRQ",462328
1,87.0,"Southern Europe",668087,0,668087,480413,800688,"ITA",640551
1,87.0,"Eastern Africa",155770,0,155770,109601,182668,"ETH",146135
1,87.0,"Northern America",638932,630974,7958,433824,723040,"CAN",578432
1,87.0,"Northern Europe",1615318,1602529,12789,1205406,2009010,"GBR",1607208
1,87.0,"United States of America",2936443,2837205,99238,1978305,3297175,"USA",2637740
1,87.0,"Central Asia",892620,814513,78107,660966,1101611,"UZB",881289
1,87.0,"India",5346152,5213498,132654,3620392,6033987,"IND",4827190
1,88.0,"Western Europe",3220578,3106663,113915,2255854,3759757,"NLD",3007806
1,88.0,"Western Africa",271694,0,271694,193263,322106,"NGA",257685
1,88.0,"Oceania",348331,348331,0,261248,435413,"NZL",348331
1,88.0,"South America",1834693,1441514,393179,1124795,1874658,"BRA",1499727
1,88.0,"Northern Africa",1040362,0,1040362,727215,1212026,"EGY",969621
1,88.0,"Southern Asia",416841,0,416841,293304,488841,"IRN",391073
1,88.0,"Eastern Europe",2962402,2724404,237998,2201805,3669675,"POL",2935740
1,88.0,"Middle Africa",57422,0,57422,40744,67907,"AGO",54326
1,88.0,"Central America",420434,0,420434,296888,494813,"MEX",395851
1,88.0,"Southern Africa",52521,0,52521,34012,56687,"ZAF",45350
1,88.0,"South-Eastern Asia",568997,0,568997,399810,666350,"IDN",533080
1,88.0,"China",8082103,7710312,371791,6053438,10089063,"CPR",8071251
1,88.0,"Pakistan",1495471,1297466,198005,1092838,1821397,"PAK",1457118
1,88.0,"Eastern Asia",822367,0,822367,570050,950083,"JPN",760067
1,88.0,"Russian Federation",2910421,2615453,294968,1979139,3298565,"RUS",2638852
1,88.0,"Western Asia",475008,0,475008,346746,577910,"IRQ",462328
1,88.0,"Southern Europe",663545,0,663545,480413,800688,"ITA",640551
1,88.0,"Eastern Africa",154183,0,154183,109601,182668,"ETH",146135
1,88.0,"Northern America",578440,572641,5799,433824,723040,"CAN",578432
1,88.0,"Northern Europe",1607209,1599271,7938,1205406,2009010,"GBR",1607208
1,88.0,"United States of America",2964892,2864378,100514,1978305,3297175,"USA",2637740
1,88.0,"Central Asia",884348,806984,77364,660966,1101611,"UZB",881289
1,88.0,"India",4836460,4724755,111705,3620392,6033987,"IND",4827190
1,89.0,"Western Europe",3095850,2986097,109753,2255854,3759757,"NLD",3007806
1,89.0,"Western Africa",267299,0,267299,193263,322106,"NGA",257685
1,89.0,"Oceania",346383,346383,0,261248,435413,"NZL",348331
1,89.0,"South America",1510558,1181277,329281,1124795,1874658,"BRA",1499727
1,89.0,"Northern Africa",1018169,0,1018169,727215,1212026,"EGY",969621
1,89.0,"Southern Asia",408761,0,408761,293304,488841,"IRN",391073
1,89.0,"Eastern Europe",2946430,2693339,253091,2201805,3669675,"POL",2935740
1,89.0,"Middle Africa",56453,0,56453,40744,67907,"AGO",54326
1,89.0,"Central America",412723,0,412723,296888,494813,"MEX",395851
1,89.0,"Southern Africa",50273,0,50273,34012,56687,"ZAF",45350
1,89.0,"South-Eastern Asia",557731,0,557731,399810,666350,"IDN",533080
1,89.0,"China",8051300,7680561,370739,6053438,10089063,"CPR",8071251
1,89.0,"Pakistan",1459801,1263216,196585,1092838,1821397,"PAK",1457118
1,89.0,"Eastern Asia",802823,0,802823,570050,950083,"JPN",760067
1,89.0,"Russian Federation",2653442,2371581,281861,1979139,3298565,"RUS",2638852
1,89.0,"Western Asia",471030,0,471030,346746,577910,"IRQ",462328
1,89.0,"Southern Europe",656333,0,656333,480413,800688,"ITA",640551
1,89.0,"Eastern Africa",151661,0,151661,109601,182668,"ETH",146135
1,89.0,"Northern America",574531,570467,4064,433824,723040,"CAN",578432
1,89.0,"Northern Europe",1599100,1595983,3117,1205406,2009010,"GBR",1607208
1,89.0,"United States of America",2907997,2807412,100585,1978305,3297175,"USA",2637740
1,89.0,"Central Asia",876715,801341,75374,660966,1101611,"UZB",881289
1,89.0,"India",4804780,4705973,98807,3620392,6033987,"IND",4827190
1,90.0,"Western Europe",3037154,2938617,98537,2255854,3759757,"NLD",3007806
1,90.0,"Western Africa",264942,0,264942,193263,322106,"NGA",257685
1,90.0,"Oceania",352227,352227,0,261248,435413,"NZL",348331
1,90.0,"South America",1525858,1190444,335414,1124795,1874658,"BRA",1499727
1,90.0,"Northern Africa",1006249,0,1006249,727215,1212026,"EGY",969621
1,90.0,"Southern Asia",404414,0,404414,293304,488841,"IRN",391073
1,90.0,"Eastern Europe",2987538,2725077,262461,2201805,3669675,"POL",2935740
1,90.0,"Middle Africa",55932,0,55932,40744,67907,"AGO",54326
1,90.0,"Central America",408580,0,408580,296888,494813,"MEX",395851
1,90.0,"Southern Africa",49065,0,49065,34012,56687,"ZAF",45350
1,90.0,"South-Eastern Asia",551675,0,551675,399810,666350,"IDN",533080
1,90.0,"China",8193047,7811111,381936,6053438,10089063,"CPR",8071251
1,90.0,"Pakistan",1480057,1277941,202116,1092838,1821397,"PAK",1457118
1,90.0,"Eastern Asia",792325,0,792325,570050,950083,"JPN",760067
1,90.0,"Russian Federation",2697549,2401500,296049,1979139,3298565,"RUS",2638852
1,90.0,"Western Asia",468895,0,468895,346746,577910,"IRQ",462328
1,90.0,"Southern Europe",652457,0,652457,480413,800688,"ITA",640551
1,90.0,"Eastern Africa",150304,0,150304,109601,182668,"ETH",146135
1,90.0,"Northern America",586235,583896,2339,433824,723040,"CAN",578432
1,90.0,"Northern Europe",1623426,1623426,0,1205406,2009010,"GBR",1607208
1,90.0,"United States of America",2829765,2728255,101510,1978305,3297175,"USA",2637740
1,90.0,"Central Asia",893223,819176,74047,660966,1101611,"UZB",881289
1,90.0,"India",4877829,4790792,87037,3620392,6033987,"IND",4827190
1,91.0,"Western Europe",3000470,2911620,88850,2255854,3759757,"NLD",3007806
1,91.0,"Western Africa",261789,0,261789,193263,322106,"NGA",257685
1,91.0,"Oceania",347356,347356,0,261248,435413,"NZL",348331
1,91.0,"South America",1503871,1171426,332445,1124795,1874658,"BRA",1499727
1,91.0,"Northern Africa",990335,0,990335,727215,1212026,"EGY",969621
1,91.0,"Southern Asia",398621,0,398621,293304,488841,"IRN",391073
1,91.0,"Eastern Europe",2939321,2679602,259719,2201805,3669675,"POL",2935740
1,91.0,"Middle Africa",55234,0,55234,40744,67907,"AGO",54326
1,91.0,"Central America",403051,0,403051,296888,494813,"MEX",395851
1,91.0,"Southern Africa",47454,0,47454,34012,56687,"ZAF",45350
1,91.0,"South-Eastern Asia",543600,0,543600,399810,666350,"IDN",533080
1,91.0,"China",8068634,7699236,369398,6053438,10089063,"CPR",8071251
1,91.0,"Pakistan",1459800,1259731,200069,1092838,1821397,"PAK",1457118
1,91.0,"Eastern Asia",778312,0,778312,570050,950083,"JPN",760067
1,91.0,"Russian Federation",2643810,2349850,293960,1979139,3298565,"RUS",2638852
1,91.0,"Western Asia",466044,0,466044,346746,577910,"IRQ",462328
1,91.0,"Southern Europe",647290,0,647290,480413,800688,"ITA",640551
1,91.0,"Eastern Africa",148494,0,148494,109601,182668,"ETH",146135
1,91.0,"Northern America",576482,575883,599,433824,723040,"CAN",578432
1,91.0,"Northern Europe",1603153,1603153,0,1205406,2009010,"GBR",1607208
1,91.0,"United States of America",2779982,2687043,92939,1978305,3297175,"USA",2637740
1,91.0,"Central Asia",879484,808266,71218,660966,1101611,"UZB",881289
1,91.0,"India",4820274,4743703,76571,3620392,6033987,"IND",4827190
1,92.0,"Western Europe",3015141,2935166,79975,2255854,3759757,"NLD",3007806
1,92.0,"Western Africa",260003,0,260003,193263,322106,"NGA",257685
1,92.0,"Oceania",349306,349306,0,261248,435413,"NZL",348331
1,92.0,"South America",1507082,1175964,331118,1124795,1874658,"BRA",1499727
1,92.0,"Northern Africa",981294,0,981294,727215,1212026,"EGY",969621
1,92.0,"Southern Asia",395330,0,395330,293304,488841,"IRN",391073
1,92.0,"Eastern Europe",2950068,2693320,256748,2201805,3669675,"POL",2935740
1,92.0,"Middle Africa",54844,0,54844,40744,67907,"AGO",54326
1,92.0,"Central America",399909,0,399909,296888,494813,"MEX",395851
1,92.0,"Southern Africa",46538,0,46538,34012,56687,"ZAF",45350
1,92.0,"South-Eastern Asia",539007,0,539007,399810,666350,"IDN",533080
1,92.0,"China",8104038,7747827,356211,6053438,10089063,"CPR",8071251
1,92.0,"Pakistan",1463565,1264980,198585,1092838,1821397,"PAK",1457118
1,92.0,"Eastern Asia",770347,0,770347,570050,950083,"JPN",760067
1,92.0,"Russian Federation",2655181,2362113,293068,1979139,3298565,"RUS",2638852
1,92.0,"Western Asia",464423,0,464423,346746,577910,"IRQ",462328
1,92.0,"Southern Europe",644346,0,644346,480413,800688,"ITA",640551
1,92.0,"Eastern Africa",147466,0,147466,109601,182668,"ETH",146135
1,92.0,"Northern America",580383,580383,0,433824,723040,"CAN",578432
1,92.0,"Northern Europe",1611263,1611263,0,1205406,2009010,"GBR",1607208
1,92.0,"United States of America",2701749,2619962,81787,1978305,3297175,"USA",2637740
1,92.0,"Central Asia",885606,815311,70295,660966,1101611,"UZB",881289
1,92.0,"India",4841464,4777079,64385,3620392,6033987,"IND",4827190
1,93.0,"Western Europe",2985797,2914976,70821,2255854,3759757,"NLD",3007806
1,93.0,"Western Africa",256065,0,256065,193263,322106,"NGA",257685
1,93.0,"Oceania",345408,345408,0,261248,435413,"NZL",348331
1,93.0,"South America",1487387,1164949,322438,1124795,1874658,"BRA",1499727
1,93.0,"Northern Africa",961422,0,961422,727215,1212026,"EGY",969621
1,93.0,"Southern Asia",388089,0,388089,293304,488841,"IRN",391073
1,93.0,"Eastern Europe",2907495,2664967,242528,2201805,3669675,"POL",2935740
1,93.0,"Middle Africa",53972,0,53972,40744,67907,"AGO",54326
1,93.0,"Central America",393003,0,393003,296888,494813,"MEX",395851
1,93.0,"Southern Africa",44526,0,44526,34012,56687,"ZAF",45350
1,93.0,"South-Eastern Asia",528919,0,528919,399810,666350,"IDN",533080
1,93.0,"China",8001353,7675404,325949,6053438,10089063,"CPR",8071251
1,93.0,"Pakistan",1445348,1254398,190950,1092838,1821397,"PAK",1457118
1,93.0,"Eastern Asia",752844,0,752844,570050,950083,"JPN",760067
1,93.0,"Russian Federation",2608186,2329831,278355,1979139,3298565,"RUS",2638852
1,93.0,"Western Asia",460860,0,460860,346746,577910,"IRQ",462328
1,93.0,"Southern Europe",637888,0,637888,480413,800688,"ITA",640551
1,93.0,"Eastern Africa",145206,0,145206,109601,182668,"ETH",146135
1,93.0,"Northern America",572579,572579,0,433824,723040,"CAN",578432
1,93.0,"Northern Europe",1595044,1595044,0,1205406,2009010,"GBR",1607208
1,93.0,"United States of America",2616406,2543847,72559,1978305,3297175,"USA",2637740
1,93.0,"Central Asia",872824,805734,67090,660966,1101611,"UZB",881289
1,93.0,"India",4790973,4741178,49795,3620392,6033987,"IND",4827190
1,94.0,"Western Europe",3015142,2952998,62144,2255854,3759757,"NLD",3007806
1,94.0,"Western Africa",258220,0,258220,193263,322106,"NGA",257685
1,94.0,"Oceania",349305,349305,0,261248,435413,"NZL",348331
1,94.0,"South America",1503774,1182355,321419,1124795,1874658,"BRA",1499727
1,94.0,"Northern Africa",972351,0,972351,727215,1212026,"EGY",969621
1,94.0,"Southern Asia",392067,0,392067,293304,488841,"IRN",391073
1,94.0,"Eastern Europe",2945043,2707240,237803,2201805,3669675,"POL",2935740
1,94.0,"Middle Africa",54440,0,54440,40744,67907,"AGO",54326
1,94.0,"Central America",396797,0,396797,296888,494813,"MEX",395851
1,94.0,"Southern Africa",45623,0,45623,34012,56687,"ZAF",45350
1,94.0,"South-Eastern Asia",534464,0,534464,399810,666350,"IDN",533080
1,94.0,"China",8093762,7787513,306249,6053438,10089063,"CPR",8071251
1,94.0,"Pakistan",1461037,1271970,189067,1092838,1821397,"PAK",1457118
1,94.0,"Eastern Asia",762470,0,762470,570050,950083,"JPN",760067
1,94.0,"Russian Federation",2648918,2373185,275733,1979139,3298565,"RUS",2638852
1,94.0,"Western Asia",462814,0,462814,346746,577910,"IRQ",462328
1,94.0,"Southern Europe",641437,0,641437,480413,800688,"ITA",640551
1,94.0,"Eastern Africa",146439,0,146439,109601,182668,"ETH",146135
1,94.0,"Northern America",580382,580382,0,433824,723040,"CAN",578432
1,94.0,"Northern Europe",1611263,1611263,0,1205406,2009010,"GBR",1607208
1,94.0,"United States of America",2644849,2579814,65035,1978305,3297175,"USA",2637740
1,94.0,"Central Asia",883900,818847,65053,660966,1101611,"UZB",881289
1,94.0,"India",4838906,4803393,35513,3620392,6033987,"IND",4827190
1,95.0,"Western Europe",3029818,2970310,59508,2255859,3759766,"NLD",3007813
1,95.0,"Western Africa",259314,0,259314,193271,322118,"NGA",257695
1,95.0,"Oceania",351254,351254,0,261254,435423,"NZL",348339
1,95.0,"South America",1512337,1193460,318877,1124798,1874663,"BRA",1499731
1,95.0,"Northern Africa",977831,0,977831,727217,1212028,"EGY",969623
1,95.0,"Southern Asia",394068,0,394068,293313,488855,"IRN",391084
1,95.0,"Eastern Europe",2964099,2732004,232095,2201811,3669686,"POL",2935749
1,95.0,"Middle Africa",54687,0,54687,40745,67908,"AGO",54327
1,95.0,"Central America",398706,0,398706,296895,494826,"MEX",395861
1,95.0,"Southern Africa",46186,0,46186,34017,56696,"ZAF",45357
1,95.0,"South-Eastern Asia",537249,0,537249,399813,666355,"IDN",533084
1,95.0,"China",8143113,7856190,286923,6053446,10089077,"CPR",8071262
1,95.0,"Pakistan",1468900,1282453,186447,1092846,1821410,"PAK",1457128
1,95.0,"Eastern Asia",767298,0,767298,570057,950096,"JPN",760077
1,95.0,"Russian Federation",2669915,2398262,271653,1979139,3298566,"RUS",2638853
1,95.0,"Western Asia",463803,0,463803,346747,577912,"IRQ",462330
1,95.0,"Southern Europe",643222,0,643222,480417,800696,"ITA",640557
1,95.0,"Eastern Africa",147075,0,147075,109609,182682,"ETH",146146
1,95.0,"Northern America",584287,584287,0,433827,723045,"CAN",578436
1,95.0,"Northern Europe",1619371,1619371,0,1205411,2009018,"GBR",1607215
1,95.0,"United States of America",2659077,2602068,57009,1978312,3297187,"USA",2637750
1,95.0,"Central Asia",890156,827410,62746,660968,1101613,"UZB",881291
1,95.0,"India",4863996,4842710,21286,3620393,6033988,"IND",4827191
1,96.0,"Western Europe",3029817,2970641,59176,2622333,4370555,"NLD",3496444
1,96.0,"Western Africa",259314,0,259314,205152,341920,"NGA",273536
1,96.0,"Oceania",351253,351253,0,340412,567353,"NZL",453883
1,96.0,"South America",1512444,1197825,314619,1381279,2302132,"BRA",1841706
1,96.0,"Northern Africa",977830,0,977830,836379,1393965,"EGY",1115172
1,96.0,"Southern Asia",394067,0,394067,621149,1035248,"IRN",828199
1,96.0,"Eastern Europe",2964186,2739560,224626,2514905,4191508,"POL",3353207
1,96.0,"Middle Africa",54691,0,54691,54690,91151,"AGO",72921
1,96.0,"Central America",398706,0,398706,357577,595962,"MEX",476770
1,96.0,"Southern Africa",46185,0,46185,39159,65265,"ZAF",52212
1,96.0,"South-Eastern Asia",537251,0,537251,502791,837985,"IDN",670388
1,96.0,"China",8144660,7878021,266639,7335534,12225891,"CPR",9780713
1,96.0,"Pakistan",1468901,1286180,182721,1343872,2239787,"PAK",1791830
1,96.0,"Eastern Asia",767299,0,767299,676590,1127650,"JPN",902120
1,96.0,"Russian Federation",2670221,2404898,265323,2253341,3755568,"RUS",3004455
1,96.0,"Western Asia",463801,0,463801,417959,696598,"IRQ",557279
1,96.0,"Southern Europe",643221,0,643221,534516,890860,"ITA",712688
1,96.0,"Eastern Africa",147075,0,147075,126057,210096,"ETH",168077
1,96.0,"Northern America",584286,584286,0,537508,895847,"CAN",716678
1,96.0,"Northern Europe",1619372,1619372,0,1513668,2522780,"GBR",2018224
1,96.0,"United States of America",2659077,2610276,48801,2234649,3724416,"USA",2979533
1,96.0,"Central Asia",890805,830249,60556,851304,1418841,"UZB",1135073
1,96.0,"India",4864932,4857221,7711,4492856,7488093,"IND",5990475
1,97.0,"Western Europe",2993141,2934297,58844,2622333,4370555,"NLD",3496444
1,97.0,"Western Africa",256617,0,256617,205152,341920,"NGA",273536
1,97.0,"Oceania",346391,346391,0,340412,567353,"NZL",453883
1,97.0,"South America",1491554,1186800,304754,1381279,2302132,"BRA",1841706
1,97.0,"Northern Africa",964157,0,964157,836379,1393965,"EGY",1115172
1,97.0,"Southern Asia",389098,0,389098,621149,1035248,"IRN",828199
1,97.0,"Eastern Europe",2918732,2707681,211051,2514905,4191508,"POL",3353207
1,97.0,"Middle Africa",54095,0,54095,54690,91151,"AGO",72921
1,97.0,"Central America",393966,0,393966,357577,595962,"MEX",476770
1,97.0,"Southern Africa",44807,0,44807,39159,65265,"ZAF",52212
1,97.0,"South-Eastern Asia",530310,0,530310,502791,837985,"IDN",670388
1,97.0,"China",8028690,7793733,234957,7335534,12225891,"CPR",9780713
1,97.0,"Pakistan",1450143,1275111,175032,1343872,2239787,"PAK",1791830
1,97.0,"Eastern Asia",755264,0,755264,676590,1127650,"JPN",902120
1,97.0,"Russian Federation",2618533,2369006,249527,2253341,3755568,"RUS",3004455
1,97.0,"Western Asia",461355,0,461355,417959,696598,"IRQ",557279
1,97.0,"Southern Europe",638784,0,638784,534516,890860,"ITA",712688
1,97.0,"Eastern Africa",145530,0,145530,126057,210096,"ETH",168077
1,97.0,"Northern America",574535,574535,0,537508,895847,"CAN",716678
1,97.0,"Northern Europe",1599106,1599106,0,1513668,2522780,"GBR",2018224
1,97.0,"United States of America",2623528,2583905,39623,2234649,3724416,"USA",2979533
1,97.0,"Central Asia",875842,819398,56444,851304,1418841,"UZB",1135073
1,97.0,"India",4803358,4803358,0,4492856,7488093,"IND",5990475
1,98.0,"Western Europe",3320358,3253912,66446,2622333,4370555,"NLD",3496444
1,98.0,"Western Africa",268144,0,268144,205152,341920,"NGA",273536
1,98.0,"Oceania",454857,454857,0,340412,567353,"NZL",453883
1,98.0,"South America",1834947,1472806,362141,1381279,2302132,"BRA",1841706
1,98.0,"Northern Africa",1087956,0,1087956,836379,1393965,"EGY",1115172
1,98.0,"Southern Asia",818281,0,818281,621149,1035248,"IRN",828199
1,98.0,"Eastern Europe",3343554,3119871,223683,2514905,4191508,"POL",3353207
1,98.0,"Middle Africa",71723,0,71723,54690,91151,"AGO",72921
1,98.0,"Central America",467312,0,467312,357577,595962,"MEX",476770
1,98.0,"Southern Africa",49449,0,49449,39159,65265,"ZAF",52212
1,98.0,"South-Eastern Asia",656568,0,656568,502791,837985,"IDN",670388
1,98.0,"China",9469817,9208709,261108,7335534,12225891,"CPR",9780713
1,98.0,"Pakistan",1600310,1392574,207736,1343872,2239787,"PAK",1791830
1,98.0,"Eastern Asia",878152,0,878152,676590,1127650,"JPN",902120
1,98.0,"Russian Federation",2994645,2727025,267620,2253341,3755568,"RUS",3004455
1,98.0,"Western Asia",552400,0,552400,417959,696598,"IRQ",557279
1,98.0,"Southern Europe",703840,0,703840,534516,890860,"ITA",712688
1,98.0,"Eastern Africa",164979,0,164979,126057,210096,"ETH",168077
1,98.0,"Northern America",718611,718611,0,537508,895847,"CAN",716678
1,98.0,"Northern Europe",1880370,1880370,0,1513668,2522780,"GBR",2018224
1,98.0,"United States of America",2915524,2881718,33806,2234649,3724416,"USA",2979533
1,98.0,"Central Asia",1097160,1027970,69190,851304,1418841,"UZB",1135073
1,98.0,"India",5412891,5407273,5618,4492856,7488093,"IND",5990475
1,99.0,"Western Europe",3357041,3290940,66101,2622333,4370555,"NLD",3496444
1,99.0,"Western Africa",268086,0,268086,205152,341920,"NGA",273536
1,99.0,"Oceania",449012,449012,0,340412,567353,"NZL",453883
1,99.0,"South America",1816072,1467399,348673,1381279,2302132,"BRA",1841706
1,99.0,"Northern Africa",1087662,0,1087662,836379,1393965,"EGY",1115172
1,99.0,"Southern Asia",818174,0,818174,621149,1035248,"IRN",828199
1,99.0,"Eastern Europe",3303135,3098158,204977,2514905,4191508,"POL",3353207
1,99.0,"Middle Africa",71716,0,71716,54690,91151,"AGO",72921
1,99.0,"Central America",467205,0,467205,357577,595962,"MEX",476770
1,99.0,"Southern Africa",49499,0,49499,39159,65265,"ZAF",52212
1,99.0,"South-Eastern Asia",657065,0,657065,502791,837985,"IDN",670388
1,99.0,"China",9437139,9206412,230727,7335534,12225891,"CPR",9780713
1,99.0,"Pakistan",1664369,1436965,227404,1343872,2239787,"PAK",1791830
1,99.0,"Eastern Asia",877892,0,877892,676590,1127650,"JPN",902120
1,99.0,"Russian Federation",2943091,2701424,241667,2253341,3755568,"RUS",3004455
1,99.0,"Western Asia",552346,0,552346,417959,696598,"IRQ",557279
1,99.0,"Southern Europe",703675,0,703675,534516,890860,"ITA",712688
1,99.0,"Eastern Africa",164944,0,164944,126057,210096,"ETH",168077
1,99.0,"Northern America",706923,706923,0,537508,895847,"CAN",716678
1,99.0,"Northern Europe",1920915,1914530,6385,1513668,2522780,"GBR",2018224
1,99.0,"United States of America",2922636,2897356,25280,2234649,3724416,"USA",2979533
1,99.0,"Central Asia",1089690,1021325,68365,851304,1418841,"UZB",1135073
1,99.0,"India",5440139,5418321,21818,4492856,7488093,"IND",5990475
1,100.0,"Western Europe",3386388,3318275,68113,2622333,4370555,"NLD",3496444
1,100.0,"Western Africa",268731,0,268731,205152,341920,"NGA",273536
1,100.0,"Oceania",449013,449013,0,340412,567353,"NZL",453883
1,100.0,"South America",1817134,1477039,340095,1381279,2302132,"BRA",1841706
1,100.0,"Northern Africa",1090926,0,1090926,836379,1393965,"EGY",1115172
1,100.0,"Southern Asia",819366,0,819366,621149,1035248,"IRN",828199
1,100.0,"Eastern Europe",3304019,3113303,190716,2514905,4191508,"POL",3353207
1,100.0,"Middle Africa",71843,0,71843,54690,91151,"AGO",72921
1,100.0,"Central America",468345,0,468345,357577,595962,"MEX",476770
1,100.0,"Southern Africa",49751,0,49751,39159,65265,"ZAF",52212
1,100.0,"South-Eastern Asia",658424,0,658424,502791,837985,"IDN",670388
1,100.0,"China",9396327,9189128,207199,7335534,12225891,"CPR",9780713
1,100.0,"Pakistan",1680967,1442866,238101,1343872,2239787,"PAK",1791830
1,100.0,"Eastern Asia",880764,0,880764,676590,1127650,"JPN",902120
1,100.0,"Russian Federation",2954877,2721526,233351,2253341,3755568,"RUS",3004455
1,100.0,"Western Asia",552931,0,552931,417959,696598,"IRQ",557279
1,100.0,"Southern Europe",705154,0,705154,534516,890860,"ITA",712688
1,100.0,"Eastern Africa",165316,0,165316,126057,210096,"ETH",168077
1,100.0,"Northern America",706920,706920,0,537508,895847,"CAN",716678
1,100.0,"Northern Europe",1961460,1948566,12894,1513668,2522780,"GBR",2018224
1,100.0,"United States of America",2922636,2896828,25808,2234649,3724416,"USA",2979533
1,100.0,"Central Asia",1084544,1016015,68529,851304,1418841,"UZB",1135073
1,100.0,"India",5658470,5614932,43538,4492856,7488093,"IND",5990475
1,101.0,"Western Europe",3401062,3331361,69701,2622333,4370555,"NLD",3496444
1,101.0,"Western Africa",269457,0,269457,205152,341920,"NGA",273536
1,101.0,"Oceania",452909,452909,0,340412,567353,"NZL",453883
1,101.0,"South America",1831061,1498929,332132,1381279,2302132,"BRA",1841706
1,101.0,"Northern Africa",1094583,0,1094583,836379,1393965,"EGY",1115172
1,101.0,"Southern Asia",820697,0,820697,621149,1035248,"IRN",828199
1,101.0,"Eastern Europe",3337820,3160186,177634,2514905,4191508,"POL",3353207
1,101.0,"Middle Africa",71996,0,71996,54690,91151,"AGO",72921
1,101.0,"Central America",469615,0,469615,357577,595962,"MEX",476770
1,101.0,"Southern Africa",50125,0,50125,39159,65265,"ZAF",52212
1,101.0,"South-Eastern Asia",660019,0,660019,502791,837985,"IDN",670388
1,101.0,"China",9398433,9205588,192845,7335534,12225891,"CPR",9780713
1,101.0,"Pakistan",1710263,1457232,253031,1343872,2239787,"PAK",1791830
1,101.0,"Eastern Asia",883987,0,883987,676590,1127650,"JPN",902120
1,101.0,"Russian Federation",2991830,2765916,225914,2253341,3755568,"RUS",3004455
1,101.0,"Western Asia",553586,0,553586,417959,696598,"IRQ",557279
1,101.0,"Southern Europe",705979,0,705979,534516,890860,"ITA",712688
1,101.0,"Eastern Africa",165731,0,165731,126057,210096,"ETH",168077
1,101.0,"Northern America",708871,708871,0,537508,895847,"CAN",716678
1,101.0,"Northern Europe",1997951,1978613,19338,1513668,2522780,"GBR",2018224
1,101.0,"United States of America",2922637,2895368,27269,2234649,3724416,"USA",2979533
1,101.0,"Central Asia",1082230,1012669,69561,851304,1418841,"UZB",1135073
1,101.0,"India",5720152,5656462,63690,4492856,7488093,"IND",5990475
1,102.0,"Western Europe",3415736,3344658,71078,2622333,4370555,"NLD",3496444
1,102.0,"Western Africa",269860,0,269860,205152,341920,"NGA",273536
1,102.0,"Oceania",453883,453883,0,340412,567353,"NZL",453883
1,102.0,"South America",1835018,1512980,322038,1381279,2302132,"BRA",1841706
1,102.0,"Northern Africa",1096622,0,1096622,836379,1393965,"EGY",1115172
1,102.0,"Southern Asia",821439,0,821439,621149,1035248,"IRN",828199
1,102.0,"Eastern Europe",3347740,3184334,163406,2514905,4191508,"POL",3353207
1,102.0,"Middle Africa",72105,0,72105,54690,91151,"AGO",72921
1,102.0,"Central America",470322,0,470322,357577,595962,"MEX",476770
1,102.0,"Southern Africa",50331,0,50331,39159,65265,"ZAF",52212
1,102.0,"South-Eastern Asia",660821,0,660821,502791,837985,"IDN",670388
1,102.0,"China",9397647,9207262,190385,7335534,12225891,"CPR",9780713
1,102.0,"Pakistan",1692222,1427279,264943,1343872,2239787,"PAK",1791830
1,102.0,"Eastern Asia",885782,0,885782,676590,1127650,"JPN",902120
1,102.0,"Russian Federation",3001673,2786168,215505,2253341,3755568,"RUS",3004455
1,102.0,"Western Asia",553948,0,553948,417959,696598,"IRQ",557279
1,102.0,"Southern Europe",706556,0,706556,534516,890860,"ITA",712688
1,102.0,"Eastern Africa",165964,0,165964,126057,210096,"ETH",168077
1,102.0,"Northern America",704969,704969,0,537508,895847,"CAN",716678
1,102.0,"Northern Europe",2030386,2004811,25575,1513668,2522780,"GBR",2018224
1,102.0,"United States of America",2929748,2900132,29616,2234649,3724416,"USA",2979533
1,102.0,"Central Asia",1096394,1025288,71106,851304,1418841,"UZB",1135073
1,102.0,"India",5756953,5673212,83741,4492856,7488093,"IND",5990475
1,103.0,"Western Europe",3445083,3362180,82903,2622333,4370555,"NLD",3496444
1,103.0,"Western Africa",270108,0,270108,205152,341920,"NGA",273536
1,103.0,"Oceania",449012,449012,0,340412,567353,"NZL",453883
1,103.0,"South America",1819717,1507578,312139,1381279,2302132,"BRA",1841706
1,103.0,"Northern Africa",1097864,0,1097864,836379,1393965,"EGY",1115172
1,103.0,"Southern Asia",821890,0,821890,621149,1035248,"IRN",828199
1,103.0,"Eastern Europe",3310064,3158864,151200,2514905,4191508,"POL",3353207
1,103.0,"Middle Africa",72160,0,72160,54690,91151,"AGO",72921
1,103.0,"Central America",470753,0,470753,357577,595962,"MEX",476770
1,103.0,"Southern Africa",50456,0,50456,39159,65265,"ZAF",52212
1,103.0,"South-Eastern Asia",661426,0,661426,502791,837985,"IDN",670388
1,103.0,"China",9440082,9221647,218435,7335534,12225891,"CPR",9780713
1,103.0,"Pakistan",1711433,1431564,279869,1343872,2239787,"PAK",1791830
1,103.0,"Eastern Asia",886875,0,886875,676590,1127650,"JPN",902120
1,103.0,"Russian Federation",2958523,2754378,204145,2253341,3755568,"RUS",3004455
1,103.0,"Western Asia",554175,0,554175,417959,696598,"IRQ",557279
1,103.0,"Southern Europe",707453,0,707453,534516,890860,"ITA",712688
1,103.0,"Eastern Africa",166102,0,166102,126057,210096,"ETH",168077
1,103.0,"Northern America",704969,704969,0,537508,895847,"CAN",716678
1,103.0,"Northern Europe",2034443,2002949,31494,1513668,2522780,"GBR",2018224
1,103.0,"United States of America",2929748,2897598,32150,2234649,3724416,"USA",2979533
1,103.0,"Central Asia",1116401,1044252,72149,851304,1418841,"UZB",1135073
1,103.0,"India",5781517,5677670,103847,4492856,7488093,"IND",5990475
1,104.0,"Western Europe",3467095,3372745,94350,2622333,4370555,"NLD",3496444
1,104.0,"Western Africa",270456,0,270456,205152,341920,"NGA",273536
1,104.0,"Oceania",450961,450961,0,340412,567353,"NZL",453883
1,104.0,"South America",1827068,1521035,306033,1381279,2302132,"BRA",1841706
1,104.0,"Northern Africa",1099624,0,1099624,836379,1393965,"EGY",1115172
1,104.0,"Southern Asia",822531,0,822531,621149,1035248,"IRN",828199
1,104.0,"Eastern Europe",3292996,3151849,141147,2514905,4191508,"POL",3353207
1,104.0,"Middle Africa",72236,0,72236,54690,91151,"AGO",72921
1,104.0,"Central America",471365,0,471365,357577,595962,"MEX",476770
1,104.0,"Southern Africa",50635,0,50635,39159,65265,"ZAF",52212
1,104.0,"South-Eastern Asia",663013,0,663013,502791,837985,"IDN",670388
1,104.0,"China",9462795,9211131,251664,7335534,12225891,"CPR",9780713
1,104.0,"Pakistan",1728148,1435007,293141,1343872,2239787,"PAK",1791830
1,104.0,"Eastern Asia",888426,0,888426,676590,1127650,"JPN",902120
1,104.0,"Russian Federation",2973521,2778495,195026,2253341,3755568,"RUS",3004455
1,104.0,"Western Asia",554488,0,554488,417959,696598,"IRQ",557279
1,104.0,"Southern Europe",707845,0,707845,534516,890860,"ITA",712688
1,104.0,"Eastern Africa",166305,0,166305,126057,210096,"ETH",168077
1,104.0,"Northern America",703017,703017,0,537508,895847,"CAN",716678
1,104.0,"Northern Europe",1941189,1903857,37332,1513668,2522780,"GBR",2018224
1,104.0,"United States of America",2936861,2901934,34927,2234649,3724416,"USA",2979533
1,104.0,"Central Asia",1125324,1053120,72204,851304,1418841,"UZB",1135073
1,104.0,"India",5805947,5681942,124005,4492856,7488093,"IND",5990475
1,105.0,"Western Europe",3591821,3486374,105447,2622333,4370555,"NLD",3496444
1,105.0,"Western Africa",269414,0,269414,205152,341920,"NGA",273536
1,105.0,"Oceania",449012,449012,0,340412,567353,"NZL",453883
1,105.0,"South America",1817923,1522085,295838,1381279,2302132,"BRA",1841706
1,105.0,"Northern Africa",1094367,0,1094367,836379,1393965,"EGY",1115172
1,105.0,"Southern Asia",820616,0,820616,621149,1035248,"IRN",828199
1,105.0,"Eastern Europe",3242009,3103900,138109,2514905,4191508,"POL",3353207
1,105.0,"Middle Africa",72009,0,72009,54690,91151,"AGO",72921
1,105.0,"Central America",469538,0,469538,357577,595962,"MEX",476770
1,105.0,"Southern Africa",50012,0,50012,39159,65265,"ZAF",52212
1,105.0,"South-Eastern Asia",660236,0,660236,502791,837985,"IDN",670388
1,105.0,"China",9569751,9287872,281879,7335534,12225891,"CPR",9780713
1,105.0,"Pakistan",1744269,1439812,304457,1343872,2239787,"PAK",1791830
1,105.0,"Eastern Asia",883796,0,883796,676590,1127650,"JPN",902120
1,105.0,"Russian Federation",2413182,2235206,177976,2253341,3755568,"RUS",3004455
1,105.0,"Western Asia",553546,0,553546,417959,696598,"IRQ",557279
1,105.0,"Southern Europe",706336,0,706336,534516,890860,"ITA",712688
1,105.0,"Eastern Africa",165708,0,165708,126057,210096,"ETH",168077
1,105.0,"Northern America",667895,667895,0,537508,895847,"CAN",716678
1,105.0,"Northern Europe",1957406,1912827,44579,1513668,2522780,"GBR",2018224
1,105.0,"United States of America",2901300,2863848,37452,2234649,3724416,"USA",2979533
1,105.0,"Central Asia",1134769,1062084,72685,851304,1418841,"UZB",1135073
1,105.0,"India",5830505,5686260,144245,4492856,7488093,"IND",5990475
1,106.0,"Western Europe",3540467,3436998,103469,2622333,4370555,"NLD",3496444
1,106.0,"Western Africa",270285,0,270285,205152,341920,"NGA",273536
1,106.0,"Oceania",455831,455831,0,340412,567353,"NZL",453883
1,106.0,"South America",1842018,1553394,288624,1381279,2302132,"BRA",1841706
1,106.0,"Northern Africa",1098765,0,1098765,836379,1393965,"EGY",1115172
1,106.0,"Southern Asia",822221,0,822221,621149,1035248,"IRN",828199
1,106.0,"Eastern Europe",3148951,3014001,134950,2514905,4191508,"POL",3353207
1,106.0,"Middle Africa",72211,0,72211,54690,91151,"AGO",72921
1,106.0,"Central America",471065,0,471065,357577,595962,"MEX",476770
1,106.0,"Southern Africa",50552,0,50552,39159,65265,"ZAF",52212
1,106.0,"South-Eastern Asia",662180,0,662180,502791,837985,"IDN",670388
1,106.0,"China",9600711,9284068,316643,7335534,12225891,"CPR",9780713
1,106.0,"Pakistan",1757977,1443395,314582,1343872,2239787,"PAK",1791830
1,106.0,"Eastern Asia",887670,0,887670,676590,1127650,"JPN",902120
1,106.0,"Russian Federation",2434745,2228431,206314,2253341,3755568,"RUS",3004455
1,106.0,"Western Asia",554338,0,554338,417959,696598,"IRQ",557279
1,106.0,"Southern Europe",707064,0,707064,534516,890860,"ITA",712688
1,106.0,"Eastern Africa",166204,0,166204,126057,210096,"ETH",168077
1,106.0,"Northern America",685452,685452,0,537508,895847,"CAN",716678
1,106.0,"Northern Europe",1993896,1942193,51703,1513668,2522780,"GBR",2018224
1,106.0,"United States of America",2908412,2879371,29041,2234649,3724416,"USA",2979533
1,106.0,"Central Asia",1246424,1173048,73376,851304,1418841,"UZB",1135073
1,106.0,"India",5855710,5690594,165116,4492856,7488093,"IND",5990475
1,107.0,"Western Europe",3503784,3407465,96319,2622336,4370561,"NLD",3496449
1,107.0,"Western Africa",270181,0,270181,205159,341932,"NGA",273546
1,107.0,"Oceania",449013,449013,0,340416,567360,"NZL",453888
1,107.0,"South America",1819893,1542366,277527,1381283,2302138,"BRA",1841711
1,107.0,"Northern Africa",1098238,0,1098238,836382,1393971,"EGY",1115177
1,107.0,"Southern Asia",822026,0,822026,621153,1035256,"IRN",828205
1,107.0,"Eastern Europe",3119956,2985671,134285,2514906,4191511,"POL",3353209
1,107.0,"Middle Africa",72175,0,72175,54692,91153,"AGO",72923
1,107.0,"Central America",470883,0,470883,357585,595976,"MEX",476781
1,107.0,"Southern Africa",50578,0,50578,39166,65277,"ZAF",52222
1,107.0,"South-Eastern Asia",661773,0,661773,502798,837997,"IDN",670398
1,107.0,"China",9599044,9280123,318921,7335534,12225891,"CPR",9780713
1,107.0,"Pakistan",1766849,1444709,322140,1343877,2239795,"PAK",1791836
1,107.0,"Eastern Asia",887205,0,887205,676596,1127661,"JPN",902129
1,107.0,"Russian Federation",2525785,2270223,255562,2253345,3755576,"RUS",3004461
1,107.0,"Western Asia",554242,0,554242,417960,696600,"IRQ",557280
1,107.0,"Southern Europe",707583,0,707583,534518,890863,"ITA",712691
1,107.0,"Eastern Africa",166147,0,166147,126063,210106,"ETH",168085
1,107.0,"Northern America",693260,693260,0,537511,895852,"CAN",716682
1,107.0,"Northern Europe",2014167,1955933,58234,1513671,2522786,"GBR",2018229
1,107.0,"United States of America",2922636,2901017,21619,2234650,3724417,"USA",2979534
1,107.0,"Central Asia",1179215,1115353,63862,851310,1418851,"UZB",1135081
1,107.0,"India",5879745,5694409,185336,4492857,7488095,"IND",5990476
1,108.0,"Western Europe",3474435,3385587,88848,2587444,4312407,"NLD",3449926
1,108.0,"Western Africa",270343,0,270343,224116,373527,"NGA",298822
1,108.0,"Oceania",451934,451934,0,308911,514852,"NZL",411882
1,108.0,"South America",1829526,1559137,270389,1222872,2038120,"BRA",1630496
1,108.0,"Northern Africa",1099070,0,1099070,916770,1527950,"EGY",1222360
1,108.0,"Southern Asia",822329,0,822329,578572,964287,"IRN",771430
1,108.0,"Eastern Europe",3133950,2980620,153330,2152313,3587188,"POL",2869751
1,108.0,"Middle Africa",72213,0,72213,55424,92373,"AGO",73899
1,108.0,"Central America",471172,0,471172,314858,524763,"MEX",419811
1,108.0,"Southern Africa",50577,0,50577,45507,75845,"ZAF",60676
1,108.0,"South-Eastern Asia",662074,0,662074,541857,903095,"IDN",722476
1,108.0,"China",9591260,9277765,313495,6498409,10830682,"CPR",8664546
1,108.0,"Pakistan",1776651,1447903,328748,1223474,2039123,"PAK",1631299
1,108.0,"Eastern Asia",887939,0,887939,573415,955692,"JPN",764554
1,108.0,"Russian Federation",2615968,2316384,299584,2113923,3523206,"RUS",2818565
1,108.0,"Western Asia",554390,0,554390,407164,678607,"IRQ",542886
1,108.0,"Southern Europe",707570,0,707570,437342,728903,"ITA",583123
1,108.0,"Eastern Africa",166242,0,166242,161103,268505,"ETH",214804
1,108.0,"Northern America",701114,698970,2144,431936,719893,"CAN",575915
1,108.0,"Northern Europe",2030386,1966011,64375,1385539,2309232,"GBR",1847386
1,108.0,"United States of America",2922636,2908022,14614,2054424,3424041,"USA",2739233
1,108.0,"Central Asia",1102579,1044787,57792,791430,1319050,"UZB",1055240
1,108.0,"India",5892290,5686805,205485,4267422,7112371,"IND",5689897
1,109.0,"Western Europe",3452426,3371529,80897,2587444,4312407,"NLD",3449926
1,109.0,"Western Africa",270521,0,270521,224116,373527,"NGA",298822
1,109.0,"Oceania",453888,453888,0,308911,514852,"NZL",411882
1,109.0,"South America",1549257,1287109,262148,1222872,2038120,"BRA",1630496
1,109.0,"Northern Africa",1099903,0,1099903,916770,1527950,"EGY",1222360
1,109.0,"Southern Asia",822641,0,822641,578572,964287,"IRN",771430
1,109.0,"Eastern Europe",3157599,2987800,169799,2152313,3587188,"POL",2869751
1,109.0,"Middle Africa",72188,0,72188,55424,92373,"AGO",73899
1,109.0,"Central America",471475,0,471475,314858,524763,"MEX",419811
1,109.0,"Southern Africa",50650,0,50650,45507,75845,"ZAF",60676
1,109.0,"South-Eastern Asia",662541,0,662541,541857,903095,"IDN",722476
1,109.0,"China",9593695,9282821,310874,6498409,10830682,"CPR",8664546
1,109.0,"Pakistan",1779941,1451318,328623,1223474,2039123,"PAK",1631299
1,109.0,"Eastern Asia",888683,0,888683,573415,955692,"JPN",764554
1,109.0,"Russian Federation",2713188,2377273,335915,2113923,3523206,"RUS",2818565
1,109.0,"Western Asia",554540,0,554540,407164,678607,"IRQ",542886
1,109.0,"Southern Europe",707648,0,707648,437342,728903,"ITA",583123
1,109.0,"Eastern Africa",166344,0,166344,161103,268505,"ETH",214804
1,109.0,"Northern America",704972,701048,3924,431936,719893,"CAN",575915
1,109.0,"Northern Europe",2026340,1962227,64113,1385539,2309232,"GBR",1847386
1,109.0,"United States of America",2929748,2920336,9412,2054424,3424041,"USA",2739233
1,109.0,"Central Asia",1036837,981182,55655,791430,1319050,"UZB",1055240
1,109.0,"India",5892539,5685007,207532,4267422,7112371,"IND",5689897
1,110.0,"Western Europe",3457264,3386751,70513,2587444,4312407,"NLD",3449926
1,110.0,"Western Africa",306697,0,306697,224116,373527,"NGA",298822
1,110.0,"Oceania",407986,407986,0,308911,514852,"NZL",411882
1,110.0,"South America",1580673,1291493,289180,1222872,2038120,"BRA",1630496
1,110.0,"Northern Africa",1262152,0,1262152,916770,1527950,"EGY",1222360
1,110.0,"Southern Asia",785929,0,785929,578572,964287,"IRN",771430
1,110.0,"Eastern Europe",3180643,3014095,166548,2152313,3587188,"POL",2869751
1,110.0,"Middle Africa",75633,0,75633,55424,92373,"AGO",73899
1,110.0,"Central America",433643,0,433643,314858,524763,"MEX",419811
1,110.0,"Southern Africa",64700,0,64700,45507,75845,"ZAF",60676
1,110.0,"South-Eastern Asia",741105,0,741105,541857,903095,"IDN",722476
1,110.0,"China",9557185,9274794,282391,6498409,10830682,"CPR",8664546
1,110.0,"Pakistan",1765562,1451434,314128,1223474,2039123,"PAK",1631299
1,110.0,"Eastern Asia",799605,0,799605,573415,955692,"JPN",764554
1,110.0,"Russian Federation",2814472,2436661,377811,2113923,3523206,"RUS",2818565
1,110.0,"Western Asia",550020,0,550020,407164,678607,"IRQ",542886
1,110.0,"Southern Europe",598302,0,598302,437342,728903,"ITA",583123
1,110.0,"Eastern Africa",219323,0,219323,161103,268505,"ETH",214804
1,110.0,"Northern America",634461,632513,1948,431936,719893,"CAN",575915
1,110.0,"Northern Europe",2013622,1953391,60231,1385539,2309232,"GBR",1847386
1,110.0,"United States of America",2867250,2866105,1145,2054424,3424041,"USA",2739233
1,110.0,"Central Asia",1035336,982043,53293,791430,1319050,"UZB",1055240
1,110.0,"India",5897694,5694649,203045,4267422,7112371,"IND",5689897
1,111.0,"Western Europe",3486612,3423083,63529,2587444,4312407,"NLD",3449926
1,111.0,"Western Africa",305061,0,305061,224116,373527,"NGA",298822
1,111.0,"Oceania",411882,411882,0,308911,514852,"NZL",411882
1,111.0,"South America",1609144,1294584,314560,1222872,2038120,"BRA",1630496
1,111.0,"Northern Africa",1253849,0,1253849,916770,1527950,"EGY",1222360
1,111.0,"Southern Asia",782903,0,782903,578572,964287,"IRN",771430
1,111.0,"Eastern Europe",3239274,3076440,162834,2152313,3587188,"POL",2869751
1,111.0,"Middle Africa",75279,0,75279,55424,92373,"AGO",73899
1,111.0,"Central America",430755,0,430755,314858,524763,"MEX",419811
1,111.0,"Southern Africa",63866,0,63866,45507,75845,"ZAF",60676
1,111.0,"South-Eastern Asia",738483,0,738483,541857,903095,"IDN",722476
1,111.0,"China",9520685,9274448,246237,6498409,10830682,"CPR",8664546
1,111.0,"Pakistan",1751799,1451126,300673,1223474,2039123,"PAK",1631299
1,111.0,"Eastern Asia",792287,0,792287,573415,955692,"JPN",764554
1,111.0,"Russian Federation",2882536,2475130,407406,2113923,3523206,"RUS",2818565
1,111.0,"Western Asia",548531,0,548531,407164,678607,"IRQ",542886
1,111.0,"Southern Europe",593586,0,593586,437342,728903,"ITA",583123
1,111.0,"Eastern Africa",218387,0,218387,161103,268505,"ETH",214804
1,111.0,"Northern America",611043,610834,209,431936,719893,"CAN",575915
1,111.0,"Northern Europe",1973077,1921662,51415,1385539,2309232,"GBR",1847386
1,111.0,"United States of America",2838800,2838800,0,2054424,3424041,"USA",2739233
1,111.0,"Central Asia",1041402,989868,51534,791430,1319050,"UZB",1055240
1,111.0,"India",5886196,5687164,199032,4267422,7112371,"IND",5689897
1,112.0,"Western Europe",3508623,3441964,66659,2587444,4312407,"NLD",3449926
1,112.0,"Western Africa",304812,0,304812,224116,373527,"NGA",298822
1,112.0,"Oceania",419675,419675,0,308911,514852,"NZL",411882
1,112.0,"South America",1631631,1297266,334365,1222872,2038120,"BRA",1630496
1,112.0,"Northern Africa",1252912,0,1252912,916770,1527950,"EGY",1222360
1,112.0,"Southern Asia",782562,0,782562,578572,964287,"IRN",771430
1,112.0,"Eastern Europe",3152348,3008496,143852,2152313,3587188,"POL",2869751
1,112.0,"Middle Africa",75239,0,75239,55424,92373,"AGO",73899
1,112.0,"Central America",430430,0,430430,314858,524763,"MEX",419811
1,112.0,"Southern Africa",63771,0,63771,45507,75845,"ZAF",60676
1,112.0,"South-Eastern Asia",737986,0,737986,541857,903095,"IDN",722476
1,112.0,"China",9500210,9293602,206608,6498409,10830682,"CPR",8664546
1,112.0,"Pakistan",1738980,1449874,289106,1223474,2039123,"PAK",1631299
1,112.0,"Eastern Asia",791462,0,791462,573415,955692,"JPN",764554
1,112.0,"Russian Federation",2933869,2505114,428755,2113923,3523206,"RUS",2818565
1,112.0,"Western Asia",548364,0,548364,407164,678607,"IRQ",542886
1,112.0,"Southern Europe",592435,0,592435,437342,728903,"ITA",583123
1,112.0,"Eastern Africa",218283,0,218283,161103,268505,"ETH",214804
1,112.0,"Northern America",601284,601284,0,431936,719893,"CAN",575915
1,112.0,"Northern Europe",1887934,1844269,43665,1385539,2309232,"GBR",1847386
1,112.0,"United States of America",2831690,2831089,601,2054424,3424041,"USA",2739233
1,112.0,"Central Asia",1094927,1041467,53460,791430,1319050,"UZB",1055240
1,112.0,"India",6480600,6285058,195542,4267422,7112371,"IND",5689897
1,113.0,"Western Europe",3530633,3454545,76088,2587444,4312407,"NLD",3449926
1,113.0,"Western Africa",302849,0,302849,224116,373527,"NGA",298822
1,113.0,"Oceania",404089,404089,0,308911,514852,"NZL",411882
1,113.0,"South America",1644281,1297975,346306,1222872,2038120,"BRA",1630496
1,113.0,"Northern Africa",1242692,0,1242692,916770,1527950,"EGY",1222360
1,113.0,"Southern Asia",778838,0,778838,578572,964287,"IRN",771430
1,113.0,"Eastern Europe",2817613,2691597,126016,2152313,3587188,"POL",2869751
1,113.0,"Middle Africa",74794,0,74794,55424,92373,"AGO",73899
1,113.0,"Central America",427291,0,427291,314858,524763,"MEX",419811
1,113.0,"Southern Africa",62740,0,62740,45507,75845,"ZAF",60676
1,113.0,"South-Eastern Asia",732800,0,732800,541857,903095,"IDN",722476
1,113.0,"China",8728004,8563493,164511,6498409,10830682,"CPR",8664546
1,113.0,"Pakistan",1730188,1453186,277002,1223474,2039123,"PAK",1631299
1,113.0,"Eastern Asia",782462,0,782462,573415,955692,"JPN",764554
1,113.0,"Russian Federation",2970441,2532963,437478,2113923,3523206,"RUS",2818565
1,113.0,"Western Asia",546531,0,546531,407164,678607,"IRQ",542886
1,113.0,"Southern Europe",590648,0,590648,437342,728903,"ITA",583123
1,113.0,"Eastern Africa",217121,0,217121,161103,268505,"ETH",214804
1,113.0,"Northern America",587624,587624,0,431936,719893,"CAN",575915
1,113.0,"Northern Europe",1814951,1777449,37502,1385539,2309232,"GBR",1847386
1,113.0,"United States of America",2817465,2816276,1189,2054424,3424041,"USA",2739233
1,113.0,"Central Asia",1115247,1062697,52550,791430,1319050,"UZB",1055240
1,113.0,"India",6460484,6282253,178231,4267422,7112371,"IND",5689897
1,114.0,"Western Europe",3530632,3445632,85000,2587444,4312407,"NLD",3449926
1,114.0,"Western Africa",300224,0,300224,224116,373527,"NGA",298822
1,114.0,"Oceania",407011,407011,0,308911,514852,"NZL",411882
1,114.0,"South America",1652581,1301491,351090,1222872,2038120,"BRA",1630496
1,114.0,"Northern Africa",1229428,0,1229428,916770,1527950,"EGY",1222360
1,114.0,"Southern Asia",774009,0,774009,578572,964287,"IRN",771430
1,114.0,"Eastern Europe",2831389,2707850,123539,2152313,3587188,"POL",2869751
1,114.0,"Middle Africa",74198,0,74198,55424,92373,"AGO",73899
1,114.0,"Central America",422987,0,422987,314858,524763,"MEX",419811
1,114.0,"Southern Africa",61397,0,61397,45507,75845,"ZAF",60676
1,114.0,"South-Eastern Asia",726066,0,726066,541857,903095,"IDN",722476
1,114.0,"China",8555217,8419010,136207,6498409,10830682,"CPR",8664546
1,114.0,"Pakistan",1914637,1649636,265001,1223474,2039123,"PAK",1631299
1,114.0,"Eastern Asia",770777,0,770777,573415,955692,"JPN",764554
1,114.0,"Russian Federation",2987695,2554561,433134,2113923,3523206,"RUS",2818565
1,114.0,"Western Asia",544156,0,544156,407164,678607,"IRQ",542886
1,114.0,"Southern Europe",586019,0,586019,437342,728903,"ITA",583123
1,114.0,"Eastern Africa",215611,0,215611,161103,268505,"ETH",214804
1,114.0,"Northern America",566160,566160,0,431936,719893,"CAN",575915
1,114.0,"Northern Europe",1827113,1794729,32384,1385539,2309232,"GBR",1847386
1,114.0,"United States of America",2767681,2767681,0,2054424,3424041,"USA",2739233
1,114.0,"Central Asia",1101949,1051209,50740,791430,1319050,"UZB",1055240
1,114.0,"India",6217994,6056415,161579,4267422,7112371,"IND",5689897
1,115.0,"Western Europe",3523296,3436600,86696,2587444,4312407,"NLD",3449926
1,115.0,"Western Africa",301375,0,301375,224116,373527,"NGA",298822
1,115.0,"Oceania",414804,414804,0,308911,514852,"NZL",411882
1,115.0,"South America",1657921,1301592,356329,1222872,2038120,"BRA",1630496
1,115.0,"Northern Africa",1235246,0,1235246,916770,1527950,"EGY",1222360
1,115.0,"Southern Asia",776129,0,776129,578572,964287,"IRN",771430
1,115.0,"Eastern Europe",2896596,2776320,120276,2152313,3587188,"POL",2869751
1,115.0,"Middle Africa",74466,0,74466,55424,92373,"AGO",73899
1,115.0,"Central America",424064,0,424064,314858,524763,"MEX",419811
1,115.0,"Southern Africa",61986,0,61986,45507,75845,"ZAF",60676
1,115.0,"South-Eastern Asia",729018,0,729018,541857,903095,"IDN",722476
1,115.0,"China",8733043,8615873,117170,6498409,10830682,"CPR",8664546
1,115.0,"Pakistan",1648624,1423162,225462,1223474,2039123,"PAK",1631299
1,115.0,"Eastern Asia",775905,0,775905,573415,955692,"JPN",764554
1,115.0,"Russian Federation",3008835,2578429,430406,2113923,3523206,"RUS",2818565
1,115.0,"Western Asia",545196,0,545196,407164,678607,"IRQ",542886
1,115.0,"Southern Europe",587065,0,587065,437342,728903,"ITA",583123
1,115.0,"Eastern Africa",216271,0,216271,161103,268505,"ETH",214804
1,115.0,"Northern America",581768,581768,0,431936,719893,"CAN",575915
1,115.0,"Northern Europe",1859548,1832487,27061,1385539,2309232,"GBR",1847386
1,115.0,"United States of America",2760569,2760569,0,2054424,3424041,"USA",2739233
1,115.0,"Central Asia",1065858,1019178,46680,791430,1319050,"UZB",1055240
1,115.0,"India",5731322,5596632,134690,4267422,7112371,"IND",5689897
1,116.0,"Western Europe",3449928,3374169,75759,2587444,4312407,"NLD",3449926
1,116.0,"Western Africa",298006,0,298006,224116,373527,"NGA",298822
1,116.0,"Oceania",409933,409933,0,308911,514852,"NZL",411882
1,116.0,"South America",1655101,1300694,354407,1222872,2038120,"BRA",1630496
1,116.0,"Northern Africa",1218229,0,1218229,916770,1527950,"EGY",1222360
1,116.0,"Southern Asia",769928,0,769928,578572,964287,"IRN",771430
1,116.0,"Eastern Europe",2473186,2362655,110531,2152313,3587188,"POL",2869751
1,116.0,"Middle Africa",73724,0,73724,55424,92373,"AGO",73899
1,116.0,"Central America",418699,0,418699,314858,524763,"MEX",419811
1,116.0,"Southern Africa",60288,0,60288,45507,75845,"ZAF",60676
1,116.0,"South-Eastern Asia",720381,0,720381,541857,903095,"IDN",722476
1,116.0,"China",8622712,8532031,90681,6498409,10830682,"CPR",8664546
1,116.0,"Pakistan",1624775,1406982,217793,1223474,2039123,"PAK",1631299
1,116.0,"Eastern Asia",760918,0,760918,573415,955692,"JPN",764554
1,116.0,"Russian Federation",2997650,2583874,413776,2113923,3523206,"RUS",2818565
1,116.0,"Western Asia",542148,0,542148,407164,678607,"IRQ",542886
1,116.0,"Southern Europe",582035,0,582035,437342,728903,"ITA",583123
1,116.0,"Eastern Africa",214339,0,214339,161103,268505,"ETH",214804
1,116.0,"Northern America",572013,572013,0,431936,719893,"CAN",575915
1,116.0,"Northern Europe",1839278,1817863,21415,1385539,2309232,"GBR",1847386
1,116.0,"United States of America",2725009,2725009,0,2054424,3424041,"USA",2739233
1,116.0,"Central Asia",1050094,1006900,43194,791430,1319050,"UZB",1055240
1,116.0,"India",5665867,5549097,116770,4267422,7112371,"IND",5689897
1,117.0,"Western Europe",3405906,3340279,65627,2587444,4312407,"NLD",3449926
1,117.0,"Western Africa",295570,0,295570,224116,373527,"NGA",298822
1,117.0,"Oceania",406038,406038,0,308911,514852,"NZL",411882
1,117.0,"South America",1650712,1302113,348599,1222872,2038120,"BRA",1630496
1,117.0,"Northern Africa",1205945,0,1205945,916770,1527950,"EGY",1222360
1,117.0,"Southern Asia",765448,0,765448,578572,964287,"IRN",771430
1,117.0,"Eastern Europe",2570932,2437544,133388,2152313,3587188,"POL",2869751
1,117.0,"Middle Africa",73180,0,73180,55424,92373,"AGO",73899
1,117.0,"Central America",414698,0,414698,314858,524763,"MEX",419811
1,117.0,"Southern Africa",59010,0,59010,45507,75845,"ZAF",60676
1,117.0,"South-Eastern Asia",714143,0,714143,541857,903095,"IDN",722476
1,117.0,"China",8531803,8466899,64904,6498409,10830682,"CPR",8664546
1,117.0,"Pakistan",1609509,1398518,210991,1223474,2039123,"PAK",1631299
1,117.0,"Eastern Asia",750097,0,750097,573415,955692,"JPN",764554
1,117.0,"Russian Federation",3275272,2885130,390142,2113923,3523206,"RUS",2818565
1,117.0,"Western Asia",539942,0,539942,407164,678607,"IRQ",542886
1,117.0,"Southern Europe",578353,0,578353,437342,728903,"ITA",583123
1,117.0,"Eastern Africa",212933,0,212933,161103,268505,"ETH",214804
1,117.0,"Northern America",564207,564207,0,431936,719893,"CAN",575915
1,117.0,"Northern Europe",1823058,1807134,15924,1385539,2309232,"GBR",1847386
1,117.0,"United States of America",2696561,2696561,0,2054424,3424041,"USA",2739233
1,117.0,"Central Asia",1038389,998275,40114,791430,1319050,"UZB",1055240
1,117.0,"India",5616444,5516863,99581,4267422,7112371,"IND",5689897
1,118.0,"Western Europe",3464597,3408574,56023,2587444,4312407,"NLD",3449926
1,118.0,"Western Africa",299901,0,299901,224116,373527,"NGA",298822
1,118.0,"Oceania",413830,413830,0,308911,514852,"NZL",411882
1,118.0,"South America",1655274,1303837,351437,1222872,2038120,"BRA",1630496
1,118.0,"Northern Africa",1227827,0,1227827,916770,1527950,"EGY",1222360
1,118.0,"Southern Asia",773417,0,773417,578572,964287,"IRN",771430
1,118.0,"Eastern Europe",2666414,2510554,155860,2152313,3587188,"POL",2869751
1,118.0,"Middle Africa",74133,0,74133,55424,92373,"AGO",73899
1,118.0,"Central America",421366,0,421366,314858,524763,"MEX",419811
1,118.0,"Southern Africa",61225,0,61225,45507,75845,"ZAF",60676
1,118.0,"South-Eastern Asia",725250,0,725250,541857,903095,"IDN",722476
1,118.0,"China",8704503,8665180,39323,6498409,10830682,"CPR",8664546
1,118.0,"Pakistan",1638121,1428384,209737,1223474,2039123,"PAK",1631299
1,118.0,"Eastern Asia",769366,0,769366,573415,955692,"JPN",764554
1,118.0,"Russian Federation",3220393,2880998,339395,2113923,3523206,"RUS",2818565
1,118.0,"Western Asia",543862,0,543862,407164,678607,"IRQ",542886
1,118.0,"Southern Europe",584634,0,584634,437342,728903,"ITA",583123
1,118.0,"Eastern Africa",215422,0,215422,161103,268505,"ETH",214804
1,118.0,"Northern America",579816,579816,0,431936,719893,"CAN",575915
1,118.0,"Northern Europe",1855494,1845011,10483,1385539,2309232,"GBR",1847386
1,118.0,"United States of America",2753457,2753457,0,2054424,3424041,"USA",2739233
1,118.0,"Central Asia",1060151,1022769,37382,791430,1319050,"UZB",1055240
1,118.0,"India",5713636,5630060,83576,4267422,7112371,"IND",5689897
1,119.0,"Western Europe",3435255,3389507,45748,2587447,4312412,"NLD",3449930
1,119.0,"Western Africa",297742,0,297742,224117,373528,"NGA",298823
1,119.0,"Oceania",409934,409934,0,308916,514860,"NZL",411888
1,119.0,"South America",1651315,1301951,349364,1222874,2038123,"BRA",1630499
1,119.0,"Northern Africa",1216893,0,1216893,916774,1527957,"EGY",1222366
1,119.0,"Southern Asia",769443,0,769443,578574,964290,"IRN",771432
1,119.0,"Eastern Europe",2757069,2584151,172918,2152317,3587195,"POL",2869756
1,119.0,"Middle Africa",73665,0,73665,55425,92375,"AGO",73900
1,119.0,"Central America",418160,0,418160,314858,524763,"MEX",419811
1,119.0,"Southern Africa",60128,0,60128,45510,75850,"ZAF",60680
1,119.0,"South-Eastern Asia",719702,0,719702,541859,903098,"IDN",722479
1,119.0,"China",8621876,8608588,13288,6498409,10830682,"CPR",8664546
1,119.0,"Pakistan",1624207,1421110,203097,1223475,2039126,"PAK",1631301
1,119.0,"Eastern Asia",759741,0,759741,573418,955697,"JPN",764558
1,119.0,"Russian Federation",3172778,2881930,290848,2113927,3523212,"RUS",2818570
1,119.0,"Western Asia",541911,0,541911,407172,678620,"IRQ",542896
1,119.0,"Southern Europe",581564,0,581564,437343,728905,"ITA",583124
1,119.0,"Eastern Africa",214186,0,214186,161103,268505,"ETH",214804
1,119.0,"Northern America",572014,572014,0,431940,719901,"CAN",575921
1,119.0,"Northern Europe",1839278,1834352,4926,1385542,2309237,"GBR",1847390
1,119.0,"United States of America",2725009,2725009,0,2054425,3424042,"USA",2739234
1,119.0,"Central Asia",1049876,1015787,34089,791434,1319057,"UZB",1055246
1,119.0,"India",5665868,5599595,66273,4267428,7112381,"IND",5689905
1,120.0,"Western Europe",3552640,3516913,35727,2911403,4852338,"NLD",3881871
1,120.0,"Western Africa",306399,0,306399,238461,397436,"NGA",317949
1,120.0,"Oceania",425519,425519,0,344616,574360,"NZL",459488
1,120.0,"South America",1667051,1303271,363780,1409269,2348782,"BRA",1879026
1,120.0,"Northern Africa",1260650,0,1260650,896427,1494046,"EGY",1195237
1,120.0,"Southern Asia",785373,0,785373,674532,1124220,"IRN",899376
1,120.0,"Eastern Europe",2845507,2646896,198611,2561281,4268802,"POL",3415042
1,120.0,"Middle Africa",75567,0,75567,58010,96683,"AGO",77347
1,120.0,"Central America",431621,0,431621,389967,649946,"MEX",519957
1,120.0,"Southern Africa",64545,0,64545,2436,4061,"ZAF",3249
1,120.0,"South-Eastern Asia",741915,0,741915,546042,910070,"IDN",728056
1,120.0,"China",8978058,8970176,7882,6970407,11617346,"CPR",9293877
1,120.0,"Pakistan",1681718,1476278,205440,1230260,2050433,"PAK",1640347
1,120.0,"Eastern Asia",798274,0,798274,622203,1037005,"JPN",829604
1,120.0,"Russian Federation",2980496,2716227,264269,2875160,4791933,"RUS",3833547
1,120.0,"Western Asia",549742,0,549742,289647,482746,"IRQ",386197
1,120.0,"Southern Europe",594187,0,594187,624480,1040801,"ITA",832641
1,120.0,"Eastern Africa",219155,0,219155,169678,282797,"ETH",226238
1,120.0,"Northern America",603231,603231,0,460564,767607,"CAN",614086
1,120.0,"Northern Europe",1904148,1904148,0,1476412,2460687,"GBR",1968550
1,120.0,"United States of America",2838801,2838801,0,1997673,3329456,"USA",2663565
1,120.0,"Central Asia",1094799,1062741,32058,873583,1455972,"UZB",1164778
1,120.0,"India",5860384,5810061,50323,4457332,7428887,"IND",5943110
1,121.0,"Western Europe",3442594,3415174,27420,2911403,4852338,"NLD",3881871
1,121.0,"Western Africa",298286,0,298286,238461,397436,"NGA",317949
1,121.0,"Oceania",410914,410914,0,344616,574360,"NZL",459488
1,121.0,"South America",1848273,1488341,359932,1409269,2348782,"BRA",1879026
1,121.0,"Northern Africa",1219635,0,1219635,896427,1494046,"EGY",1195237
1,121.0,"Southern Asia",770441,0,770441,674532,1124220,"IRN",899376
1,121.0,"Eastern Europe",2900756,2691377,209379,2561281,4268802,"POL",3415042
1,121.0,"Middle Africa",73786,0,73786,58010,96683,"AGO",77347
1,121.0,"Central America",419283,0,419283,389967,649946,"MEX",519957
1,121.0,"Southern Africa",60408,0,60408,2436,4061,"ZAF",3249
1,121.0,"South-Eastern Asia",721093,0,721093,546042,910070,"IDN",728056
1,121.0,"China",8651596,8651596,0,6970407,11617346,"CPR",9293877
1,121.0,"Pakistan",1628617,1434535,194082,1230260,2050433,"PAK",1640347
1,121.0,"Eastern Asia",762151,0,762151,622203,1037005,"JPN",829604
1,121.0,"Russian Federation",2812750,2575726,237024,2875160,4791933,"RUS",3833547
1,121.0,"Western Asia",542411,0,542411,289647,482746,"IRQ",386197
1,121.0,"Southern Europe",582500,0,582500,624480,1040801,"ITA",832641
1,121.0,"Eastern Africa",214495,0,214495,169678,282797,"ETH",226238
1,121.0,"Northern America",573972,573972,0,460564,767607,"CAN",614086
1,121.0,"Northern Europe",1843336,1843336,0,1476412,2460687,"GBR",1968550
1,121.0,"United States of America",2732122,2732122,0,1997673,3329456,"USA",2663565
1,121.0,"Central Asia",1053479,1026146,27333,873583,1455972,"UZB",1164778
1,121.0,"India",5679592,5647808,31784,4457332,7428887,"IND",5943110
1,122.0,"Western Europe",3691111,3660811,30300,2911403,4852338,"NLD",3881871
1,122.0,"Western Africa",313276,0,313276,238461,397436,"NGA",317949
1,122.0,"Oceania",456566,456566,0,344616,574360,"NZL",459488
1,122.0,"South America",1860944,1508749,352195,1409269,2348782,"BRA",1879026
1,122.0,"Northern Africa",1171668,0,1171668,896427,1494046,"EGY",1195237
1,122.0,"Southern Asia",890786,0,890786,674532,1124220,"IRN",899376
1,122.0,"Eastern Europe",2971233,2723085,248148,2561281,4268802,"POL",3415042
1,122.0,"Middle Africa",76310,0,76310,58010,96683,"AGO",77347
1,122.0,"Central America",511115,0,511115,389967,649946,"MEX",519957
1,122.0,"Southern Africa",4638,0,4638,2436,4061,"ZAF",3249
1,122.0,"South-Eastern Asia",716085,0,716085,546042,910070,"IDN",728056
1,122.0,"China",9143983,9143983,0,6970407,11617346,"CPR",9293877
1,122.0,"Pakistan",1624967,1440140,184827,1230260,2050433,"PAK",1640347
1,122.0,"Eastern Asia",808842,0,808842,622203,1037005,"JPN",829604
1,122.0,"Russian Federation",3206313,2887552,318761,2875160,4791933,"RUS",3833547
1,122.0,"Western Asia",381977,0,381977,289647,482746,"IRQ",386197
1,122.0,"Southern Europe",821539,0,821539,624480,1040801,"ITA",832641
1,122.0,"Eastern Africa",223553,0,223553,169678,282797,"ETH",226238
1,122.0,"Northern America",608229,608229,0,460564,767607,"CAN",614086
1,122.0,"Northern Europe",1956386,1956386,0,1476412,2460687,"GBR",1968550
1,122.0,"United States of America",2642229,2642229,0,1997673,3329456,"USA",2663565
1,122.0,"Central Asia",1151997,1126613,25384,873583,1455972,"UZB",1164778
1,122.0,"India",5903929,5889491,14438,4457332,7428887,"IND",5943110
1,123.0,"Western Europe",3727795,3690401,37394,2911403,4852338,"NLD",3881871
1,123.0,"Western Africa",317108,0,317108,238461,397436,"NGA",317949
1,123.0,"Oceania",464359,464359,0,344616,574360,"NZL",459488
1,123.0,"South America",1893350,1545162,348188,1409269,2348782,"BRA",1879026
1,123.0,"Northern Africa",1191006,0,1191006,896427,1494046,"EGY",1195237
1,123.0,"Southern Asia",897830,0,897830,674532,1124220,"IRN",899376
1,123.0,"Eastern Europe",3039707,2746140,293567,2561281,4268802,"POL",3415042
1,123.0,"Middle Africa",77170,0,77170,58010,96683,"AGO",77347
1,123.0,"Central America",518487,0,518487,389967,649946,"MEX",519957
1,123.0,"Southern Africa",4506,0,4506,2436,4061,"ZAF",3249
1,123.0,"South-Eastern Asia",725907,0,725907,546042,910070,"IDN",728056
1,123.0,"China",9138015,9136149,1866,6970407,11617346,"CPR",9293877
1,123.0,"Pakistan",1653077,1474178,178899,1230260,2050433,"PAK",1640347
1,123.0,"Eastern Asia",825875,0,825875,622203,1037005,"JPN",829604
1,123.0,"Russian Federation",3276707,2888151,388556,2875160,4791933,"RUS",3833547
1,123.0,"Western Asia",385436,0,385436,289647,482746,"IRQ",386197
1,123.0,"Southern Europe",830613,0,830613,624480,1040801,"ITA",832641
1,123.0,"Eastern Africa",225752,0,225752,169678,282797,"ETH",226238
1,123.0,"Northern America",623842,623842,0,460564,767607,"CAN",614086
1,123.0,"Northern Europe",1952332,1952332,0,1476412,2460687,"GBR",1968550
1,123.0,"United States of America",2699125,2699125,0,1997673,3329456,"USA",2663565
1,123.0,"Central Asia",1179923,1156059,23864,873583,1455972,"UZB",1164778
1,123.0,"India",6003561,6003329,232,4457332,7428887,"IND",5943110
1,124.0,"Western Europe",3771817,3721322,50495,2911403,4852338,"NLD",3881871
1,124.0,"Western Africa",315060,0,315060,238461,397436,"NGA",317949
1,124.0,"Oceania",457539,457539,0,344616,574360,"NZL",459488
1,124.0,"South America",1871455,1532780,338675,1409269,2348782,"BRA",1879026
1,124.0,"Northern Africa",1180661,0,1180661,896427,1494046,"EGY",1195237
1,124.0,"Southern Asia",894064,0,894064,674532,1124220,"IRN",899376
1,124.0,"Eastern Europe",3090834,2762662,328172,2561281,4268802,"POL",3415042
1,124.0,"Middle Africa",76705,0,76705,58010,96683,"AGO",77347
1,124.0,"Central America",514889,0,514889,389967,649946,"MEX",519957
1,124.0,"Southern Africa",4190,0,4190,2436,4061,"ZAF",3249
1,124.0,"South-Eastern Asia",720654,0,720654,546042,910070,"IDN",728056
1,124.0,"China",9136001,9136001,0,6970407,11617346,"CPR",9293877
1,124.0,"Pakistan",1630796,1461718,169078,1230260,2050433,"PAK",1640347
1,124.0,"Eastern Asia",816766,0,816766,622203,1037005,"JPN",829604
1,124.0,"Russian Federation",3339170,2884983,454187,2875160,4791933,"RUS",3833547
1,124.0,"Western Asia",383582,0,383582,289647,482746,"IRQ",386197
1,124.0,"Southern Europe",828066,0,828066,624480,1040801,"ITA",832641
1,124.0,"Eastern Africa",224575,0,224575,169678,282797,"ETH",226238
1,124.0,"Northern America",610184,610184,0,460564,767607,"CAN",614086
1,124.0,"Northern Europe",1932060,1932060,0,1476412,2460687,"GBR",1968550
1,124.0,"United States of America",2649341,2649341,0,1997673,3329456,"USA",2663565
1,124.0,"Central Asia",1158704,1139630,19074,873583,1455972,"UZB",1164778
1,124.0,"India",5919496,5919496,0,4457332,7428887,"IND",5943110
1,125.0,"Western Europe",3793827,3730408,63419,2911403,4852338,"NLD",3881871
1,125.0,"Western Africa",314638,0,314638,238461,397436,"NGA",317949
1,125.0,"Oceania",455592,455592,0,344616,574360,"NZL",459488
1,125.0,"South America",1863116,1531471,331645,1409269,2348782,"BRA",1879026
1,125.0,"Northern Africa",1178530,0,1178530,896427,1494046,"EGY",1195237
1,125.0,"Southern Asia",893289,0,893289,674532,1124220,"IRN",899376
1,125.0,"Eastern Europe",3138329,2780618,357711,2561281,4268802,"POL",3415042
1,125.0,"Middle Africa",76613,0,76613,58010,96683,"AGO",77347
1,125.0,"Central America",514152,0,514152,389967,649946,"MEX",519957
1,125.0,"Southern Africa",3878,0,3878,2436,4061,"ZAF",3249
1,125.0,"South-Eastern Asia",719572,0,719572,546042,910070,"IDN",728056
1,125.0,"China",9135942,9131832,4110,6970407,11617346,"CPR",9293877
1,125.0,"Pakistan",1624102,1462345,161757,1230260,2050433,"PAK",1640347
1,125.0,"Eastern Asia",814894,0,814894,622203,1037005,"JPN",829604
1,125.0,"Russian Federation",3398368,2886237,512131,2875160,4791933,"RUS",3833547
1,125.0,"Western Asia",383201,0,383201,289647,482746,"IRQ",386197
1,125.0,"Southern Europe",827528,0,827528,624480,1040801,"ITA",832641
1,125.0,"Eastern Africa",224335,0,224335,169678,282797,"ETH",226238
1,125.0,"Northern America",606280,606280,0,460564,767607,"CAN",614086
1,125.0,"Northern Europe",1923950,1923950,0,1476412,2460687,"GBR",1968550
1,125.0,"United States of America",2635117,2635117,0,1997673,3329456,"USA",2663565
1,125.0,"Central Asia",1152405,1137838,14567,873583,1455972,"UZB",1164778
1,125.0,"India",5894351,5894351,0,4457332,7428887,"IND",5943110
1,126.0,"Western Europe",3815837,3739562,76275,2911403,4852338,"NLD",3881871
1,126.0,"Western Africa",316315,0,316315,238461,397436,"NGA",317949
1,126.0,"Oceania",461436,461436,0,344616,574360,"NZL",459488
1,126.0,"South America",1884141,1556471,327670,1409269,2348782,"BRA",1879026
1,126.0,"Northern Africa",1187001,0,1187001,896427,1494046,"EGY",1195237
1,126.0,"Southern Asia",896371,0,896371,674532,1124220,"IRN",899376
1,126.0,"Eastern Europe",3191600,2803493,388107,2561281,4268802,"POL",3415042
1,126.0,"Middle Africa",76982,0,76982,58010,96683,"AGO",77347
1,126.0,"Central America",517093,0,517093,389967,649946,"MEX",519957
1,126.0,"Southern Africa",3812,0,3812,2436,4061,"ZAF",3249
1,126.0,"South-Eastern Asia",724155,0,724155,546042,910070,"IDN",728056
1,126.0,"China",9136324,9124828,11496,6970407,11617346,"CPR",9293877
1,126.0,"Pakistan",1644983,1487774,157209,1230260,2050433,"PAK",1640347
1,126.0,"Eastern Asia",822348,0,822348,622203,1037005,"JPN",829604
1,126.0,"Russian Federation",3455874,2886406,569468,2875160,4791933,"RUS",3833547
1,126.0,"Western Asia",384717,0,384717,289647,482746,"IRQ",386197
1,126.0,"Southern Europe",829692,0,829692,624480,1040801,"ITA",832641
1,126.0,"Eastern Africa",225297,0,225297,169678,282797,"ETH",226238
1,126.0,"Northern America",617988,617988,0,460564,767607,"CAN",614086
1,126.0,"Northern Europe",1923951,1923951,0,1476412,2460687,"GBR",1968550
1,126.0,"United States of America",2642229,2642229,0,1997673,3329456,"USA",2663565
1,126.0,"Central Asia",1164525,1153140,11385,873583,1455972,"UZB",1164778
1,126.0,"India",5966847,5966847,0,4457332,7428887,"IND",5943110
1,127.0,"Western Europe",3837848,3748882,88966,2911403,4852338,"NLD",3881871
1,127.0,"Western Africa",316269,0,316269,238461,397436,"NGA",317949
1,127.0,"Oceania",463385,463385,0,344616,574360,"NZL",459488
1,127.0,"South America",1890396,1571008,319388,1409269,2348782,"BRA",1879026
1,127.0,"Northern Africa",1186764,0,1186764,896427,1494046,"EGY",1195237
1,127.0,"Southern Asia",896287,0,896287,674532,1124220,"IRN",899376
1,127.0,"Eastern Europe",3232018,2818074,413944,2561281,4268802,"POL",3415042
1,127.0,"Middle Africa",76973,0,76973,58010,96683,"AGO",77347
1,127.0,"Central America",517012,0,517012,389967,649946,"MEX",519957
1,127.0,"Southern Africa",3821,0,3821,2436,4061,"ZAF",3249
1,127.0,"South-Eastern Asia",724033,0,724033,546042,910070,"IDN",728056
1,127.0,"China",9159482,9131517,27965,6970407,11617346,"CPR",9293877
1,127.0,"Pakistan",1651928,1501254,150674,1230260,2050433,"PAK",1640347
1,127.0,"Eastern Asia",822143,0,822143,622203,1037005,"JPN",829604
1,127.0,"Russian Federation",3507666,2887208,620458,2875160,4791933,"RUS",3833547
1,127.0,"Western Asia",384675,0,384675,289647,482746,"IRQ",386197
1,127.0,"Southern Europe",829656,0,829656,624480,1040801,"ITA",832641
1,127.0,"Eastern Africa",225271,0,225271,169678,282797,"ETH",226238
1,127.0,"Northern America",612135,612135,0,460564,767607,"CAN",614086
1,127.0,"Northern Europe",1928003,1924782,3221,1476412,2460687,"GBR",1968550
1,127.0,"United States of America",2635117,2635117,0,1997673,3329456,"USA",2663565
1,127.0,"Central Asia",1114974,1107067,7907,873583,1455972,"UZB",1164778
1,127.0,"India",5991871,5991871,0,4457332,7428887,"IND",5943110
1,128.0,"Western Europe",3852520,3751122,101398,2911403,4852338,"NLD",3881871
1,128.0,"Western Africa",315705,0,315705,238461,397436,"NGA",317949
1,128.0,"Oceania",457539,457539,0,344616,574360,"NZL",459488
1,128.0,"South America",1870766,1560897,309869,1409269,2348782,"BRA",1879026
1,128.0,"Northern Africa",1183926,0,1183926,896427,1494046,"EGY",1195237
1,128.0,"Southern Asia",895253,0,895253,674532,1124220,"IRN",899376
1,128.0,"Eastern Europe",3935981,3501154,434827,2561281,4268802,"POL",3415042
1,128.0,"Middle Africa",76849,0,76849,58010,96683,"AGO",77347
1,128.0,"Central America",516026,0,516026,389967,649946,"MEX",519957
1,128.0,"Southern Africa",3646,0,3646,2436,4061,"ZAF",3249
1,128.0,"South-Eastern Asia",723466,0,723466,546042,910070,"IDN",728056
1,128.0,"China",9180320,9130913,49407,6970407,11617346,"CPR",9293877
1,128.0,"Pakistan",1632010,1489692,142318,1230260,2050433,"PAK",1640347
1,128.0,"Eastern Asia",819679,0,819679,622203,1037005,"JPN",829604
1,128.0,"Russian Federation",3549084,2885209,663875,2875160,4791933,"RUS",3833547
1,128.0,"Western Asia",384167,0,384167,289647,482746,"IRQ",386197
1,128.0,"Southern Europe",828913,0,828913,624480,1040801,"ITA",832641
1,128.0,"Eastern Africa",224947,0,224947,169678,282797,"ETH",226238
1,128.0,"Northern America",606280,606280,0,460564,767607,"CAN",614086
1,128.0,"Northern Europe",1810422,1801162,9260,1476412,2460687,"GBR",1968550
1,128.0,"United States of America",2642229,2642229,0,1997673,3329456,"USA",2663565
1,128.0,"Central Asia",1107378,1099359,8019,873583,1455972,"UZB",1164778
1,128.0,"India",5919372,5919372,0,4457332,7428887,"IND",5943110
1,129.0,"Western Europe",3815837,3702208,113629,2911403,4852338,"NLD",3881871
1,129.0,"Western Africa",304639,0,304639,238461,397436,"NGA",317949
1,129.0,"Oceania",460462,460462,0,344616,574360,"NZL",459488
1,129.0,"South America",1860833,1576516,284317,1409269,2348782,"BRA",1879026
1,129.0,"Northern Africa",1128026,0,1128026,896427,1494046,"EGY",1195237
1,129.0,"Southern Asia",874893,0,874893,674532,1124220,"IRN",899376
1,129.0,"Eastern Europe",3873085,3513156,359929,2561281,4268802,"POL",3415042
1,129.0,"Middle Africa",74405,0,74405,58010,96683,"AGO",77347
1,129.0,"Central America",496797,0,496797,389967,649946,"MEX",519957
1,129.0,"Southern Africa",3597,0,3597,2436,4061,"ZAF",3249
1,129.0,"South-Eastern Asia",694962,0,694962,546042,910070,"IDN",728056
1,129.0,"China",9203602,9132773,70829,6970407,11617346,"CPR",9293877
1,129.0,"Pakistan",1624689,1492489,132200,1230260,2050433,"PAK",1640347
1,129.0,"Eastern Asia",772145,0,772145,622203,1037005,"JPN",829604
1,129.0,"Russian Federation",4585836,3919880,665956,2875160,4791933,"RUS",3833547
1,129.0,"Western Asia",374152,0,374152,289647,482746,"IRQ",386197
1,129.0,"Southern Europe",810842,0,810842,624480,1040801,"ITA",832641
1,129.0,"Eastern Africa",218596,0,218596,169678,282797,"ETH",226238
1,129.0,"Northern America",569207,569207,0,460564,767607,"CAN",614086
1,129.0,"Northern Europe",1826640,1810614,16026,1476412,2460687,"GBR",1968550
1,129.0,"United States of America",2371975,2371975,0,1997673,3329456,"USA",2663565
1,129.0,"Central Asia",1104168,1096151,8017,873583,1455972,"UZB",1164778
1,129.0,"India",5954985,5954985,0,4457332,7428887,"IND",5943110
1,130.0,"Western Europe",3823173,3708225,114948,2911403,4852338,"NLD",3881871
1,130.0,"Western Africa",309374,0,309374,238461,397436,"NGA",317949
1,130.0,"Oceania",468255,468255,0,344616,574360,"NZL",459488
1,130.0,"South America",1865587,1597000,268587,1409269,2348782,"BRA",1879026
1,130.0,"Northern Africa",1151940,0,1151940,896427,1494046,"EGY",1195237
1,130.0,"Southern Asia",883600,0,883600,674532,1124220,"IRN",899376
1,130.0,"Eastern Europe",3844731,3517974,326757,2561281,4268802,"POL",3415042
1,130.0,"Middle Africa",75470,0,75470,58010,96683,"AGO",77347
1,130.0,"Central America",505307,0,505307,389967,649946,"MEX",519957
1,130.0,"Southern Africa",3800,0,3800,2436,4061,"ZAF",3249
1,130.0,"South-Eastern Asia",706730,0,706730,546042,910070,"IDN",728056
1,130.0,"China",9228333,9126446,101887,6970407,11617346,"CPR",9293877
1,130.0,"Pakistan",1570851,1444977,125874,1230260,2050433,"PAK",1640347
1,130.0,"Eastern Asia",792369,0,792369,622203,1037005,"JPN",829604
1,130.0,"Russian Federation",4480360,3924255,556105,2875160,4791933,"RUS",3833547
1,130.0,"Western Asia",378436,0,378436,289647,482746,"IRQ",386197
1,130.0,"Southern Europe",818565,0,818565,624480,1040801,"ITA",832641
1,130.0,"Eastern Africa",221311,0,221311,169678,282797,"ETH",226238
1,130.0,"Northern America",588716,588716,0,460564,767607,"CAN",614086
1,130.0,"Northern Europe",1855021,1832032,22989,1476412,2460687,"GBR",1968550
1,130.0,"United States of America",2464428,2459748,4680,1997673,3329456,"USA",2663565
1,130.0,"Central Asia",1002543,990126,12417,873583,1455972,"UZB",1164778
1,130.0,"India",6052841,6052380,461,4457332,7428887,"IND",5943110
1,131.0,"Western Europe",3845185,3729064,116121,2911408,4852347,"NLD",3881878
1,131.0,"Western Africa",312019,0,312019,238462,397437,"NGA",317950
1,131.0,"Oceania",463385,463385,0,344624,574373,"NZL",459499
1,131.0,"South America",1846897,1590815,256082,1409273,2348788,"BRA",1879031
1,131.0,"Northern Africa",1165297,0,1165297,896428,1494047,"EGY",1195238
1,131.0,"Southern Asia",888471,0,888471,674532,1124221,"IRN",899377
1,131.0,"Eastern Europe",3828024,3524789,303235,2561286,4268810,"POL",3415048
1,131.0,"Middle Africa",76033,0,76033,58017,96695,"AGO",77356
1,131.0,"Central America",509890,0,509890,389973,649956,"MEX",519965
1,131.0,"Southern Africa",3812,0,3812,2438,4063,"ZAF",3251
1,131.0,"South-Eastern Asia",713399,0,713399,546046,910077,"IDN",728062
1,131.0,"China",9249489,9117824,131665,6970414,11617357,"CPR",9293886
1,131.0,"Pakistan",1574060,1443225,130835,1230268,2050447,"PAK",1640358
1,131.0,"Eastern Asia",804020,0,804020,622206,1037011,"JPN",829609
1,131.0,"Russian Federation",4401033,3918152,482881,2875163,4791938,"RUS",3833551
1,131.0,"Western Asia",380828,0,380828,289650,482751,"IRQ",386201
1,131.0,"Southern Europe",822908,0,822908,624485,1040808,"ITA",832647
1,131.0,"Eastern Africa",222828,0,222828,169683,282805,"ETH",226244
1,131.0,"Northern America",600425,600425,0,460569,767616,"CAN",614093
1,131.0,"Northern Europe",1879348,1849391,29957,1476415,2460692,"GBR",1968554
1,131.0,"United States of America",2521324,2508045,13279,1997677,3329462,"USA",2663570
1,131.0,"Central Asia",1020878,1002828,18050,873586,1455977,"UZB",1164782
1,131.0,"India",5992907,5992775,132,4457333,7428888,"IND",5943111
1,132.0,"Western Europe",3852521,3735668,116853,2777207,4628678,"NLD",3702943
1,132.0,"Western Africa",313839,0,313839,251361,418936,"NGA",335149
1,132.0,"Oceania",460462,460462,0,360921,601535,"NZL",481228
1,132.0,"South America",1829879,1580436,249443,1316415,2194025,"BRA",1755220
1,132.0,"Northern Africa",1174500,0,1174500,1023844,1706407,"EGY",1365126
1,132.0,"Southern Asia",891818,0,891818,462297,770496,"IRN",616397
1,132.0,"Eastern Europe",3797591,3524514,273077,2384755,3974592,"POL",3179674
1,132.0,"Middle Africa",76435,0,76435,63836,106393,"AGO",85115
1,132.0,"Central America",513001,0,513001,338025,563375,"MEX",450700
1,132.0,"Southern Africa",3729,0,3729,43911,73186,"ZAF",58549
1,132.0,"South-Eastern Asia",717928,0,717928,675164,1125273,"IDN",900219
1,132.0,"China",9271112,9128884,142228,6422388,10703980,"CPR",8563184
1,132.0,"Pakistan",1599968,1463880,136088,1141178,1901963,"PAK",1521571
1,132.0,"Eastern Asia",811924,0,811924,611110,1018517,"JPN",814814
1,132.0,"Russian Federation",4355521,3923704,431817,2100451,3500752,"RUS",2800602
1,132.0,"Western Asia",382476,0,382476,357588,595981,"IRQ",476785
1,132.0,"Southern Europe",825897,0,825897,722764,1204607,"ITA",963686
1,132.0,"Eastern Africa",223876,0,223876,151367,252278,"ETH",201823
1,132.0,"Northern America",608230,606363,1867,476081,793468,"CAN",634775
1,132.0,"Northern Europe",1903676,1868443,35233,1438818,2398030,"GBR",1918424
1,132.0,"United States of America",2563995,2542030,21965,1738656,2897760,"USA",2318208
1,132.0,"Central Asia",1079501,1055920,23581,936867,1561446,"UZB",1249157
1,132.0,"India",5943634,5943634,0,4238274,7063791,"IND",5651033
1,133.0,"Western Europe",3867204,3749764,117440,2777207,4628678,"NLD",3702943
1,133.0,"Western Africa",315094,0,315094,251361,418936,"NGA",335149
1,133.0,"Oceania",457551,457551,0,360921,601535,"NZL",481228
1,133.0,"South America",1977934,1730445,247489,1316415,2194025,"BRA",1755220
1,133.0,"Northern Africa",1180829,0,1180829,1023844,1706407,"EGY",1365126
1,133.0,"Southern Asia",894126,0,894126,462297,770496,"IRN",616397
1,133.0,"Eastern Europe",3764693,3519317,245376,2384755,3974592,"POL",3179674
1,133.0,"Middle Africa",76722,0,76722,63836,106393,"AGO",85115
1,133.0,"Central America",515151,0,515151,338025,563375,"MEX",450700
1,133.0,"Southern Africa",3572,0,3572,43911,73186,"ZAF",58549
1,133.0,"South-Eastern Asia",721053,0,721053,675164,1125273,"IDN",900219
1,133.0,"China",9292753,9125062,167691,6422388,10703980,"CPR",8563184
1,133.0,"Pakistan",1604119,1464830,139289,1141178,1901963,"PAK",1521571
1,133.0,"Eastern Asia",817376,0,817376,611110,1018517,"JPN",814814
1,133.0,"Russian Federation",4313934,3925799,388135,2100451,3500752,"RUS",2800602
1,133.0,"Western Asia",383618,0,383618,357588,595981,"IRQ",476785
1,133.0,"Southern Europe",827960,0,827960,722764,1204607,"ITA",963686
1,133.0,"Eastern Africa",224602,0,224602,151367,252278,"ETH",201823
1,133.0,"Northern America",612140,608348,3792,476081,793468,"CAN",634775
1,133.0,"Northern Europe",1919898,1878101,41797,1438818,2398030,"GBR",1918424
1,133.0,"United States of America",2592449,2562888,29561,1738656,2897760,"USA",2318208
1,133.0,"Central Asia",1139956,1110979,28977,936867,1561446,"UZB",1249157
1,133.0,"India",5846100,5846100,0,4238274,7063791,"IND",5651033
1,134.0,"Western Europe",3783650,3669495,114155,2777207,4628678,"NLD",3702943
1,134.0,"Western Africa",340982,0,340982,251361,418936,"NGA",335149
1,134.0,"Oceania",480254,480254,0,360921,601535,"NZL",481228
1,134.0,"South America",1764165,1548817,215348,1316415,2194025,"BRA",1755220
1,134.0,"Northern Africa",1394276,0,1394276,1023844,1706407,"EGY",1365126
1,134.0,"Southern Asia",627020,0,627020,462297,770496,"IRN",616397
1,134.0,"Eastern Europe",3533386,3324426,208960,2384755,3974592,"POL",3179674
1,134.0,"Middle Africa",86396,0,86396,63836,106393,"AGO",85115
1,134.0,"Central America",461235,0,461235,338025,563375,"MEX",450700
1,134.0,"Southern Africa",27564,0,27564,43911,73186,"ZAF",58549
1,134.0,"South-Eastern Asia",913862,0,913862,675164,1125273,"IDN",900219
1,134.0,"China",9304714,9123507,181207,6422388,10703980,"CPR",8563184
1,134.0,"Pakistan",1610588,1477145,133443,1141178,1901963,"PAK",1521571
1,134.0,"Eastern Asia",840255,0,840255,611110,1018517,"JPN",814814
1,134.0,"Russian Federation",3004062,2746413,257649,2100451,3500752,"RUS",2800602
1,134.0,"Western Asia",482004,0,482004,357588,595981,"IRQ",476785
1,134.0,"Southern Europe",973160,0,973160,722764,1204607,"ITA",963686
1,134.0,"Eastern Africa",205143,0,205143,151367,252278,"ETH",201823
1,134.0,"Northern America",636749,630901,5848,476081,793468,"CAN",634775
1,134.0,"Northern Europe",1938699,1891166,47533,1438818,2398030,"GBR",1918424
1,134.0,"United States of America",2453337,2419009,34328,1738656,2897760,"USA",2318208
1,134.0,"Central Asia",1213166,1177488,35678,936867,1561446,"UZB",1249157
1,134.0,"India",5725848,5725848,0,4238274,7063791,"IND",5651033
1,135.0,"Western Europe",3783651,3671109,112542,2777207,4628678,"NLD",3702943
1,135.0,"Western Africa",340194,0,340194,251361,418936,"NGA",335149
1,135.0,"Oceania",473435,473435,0,360921,601535,"NZL",481228
1,135.0,"South America",1736070,1520609,215461,1316415,2194025,"BRA",1755220
1,135.0,"Northern Africa",1390586,0,1390586,1023844,1706407,"EGY",1365126
1,135.0,"Southern Asia",625674,0,625674,462297,770496,"IRN",616397
1,135.0,"Eastern Europe",3130447,2948578,181869,2384755,3974592,"POL",3179674
1,135.0,"Middle Africa",86232,0,86232,63836,106393,"AGO",85115
1,135.0,"Central America",459386,0,459386,338025,563375,"MEX",450700
1,135.0,"Southern Africa",60555,0,60555,43911,73186,"ZAF",58549
1,135.0,"South-Eastern Asia",912862,0,912862,675164,1125273,"IDN",900219
1,135.0,"China",9153992,8969208,184784,6422388,10703980,"CPR",8563184
1,135.0,"Pakistan",1607977,1480594,127383,1141178,1901963,"PAK",1521571
1,135.0,"Eastern Asia",836863,0,836863,611110,1018517,"JPN",814814
1,135.0,"Russian Federation",2741214,2506865,234349,2100451,3500752,"RUS",2800602
1,135.0,"Western Asia",481348,0,481348,357588,595981,"IRQ",476785
1,135.0,"Southern Europe",971963,0,971963,722764,1204607,"ITA",963686
1,135.0,"Eastern Africa",204723,0,204723,151367,252278,"ETH",201823
1,135.0,"Northern America",648435,640697,7738,476081,793468,"CAN",634775
1,135.0,"Northern Europe",1967082,1914113,52969,1438818,2398030,"GBR",1918424
1,135.0,"United States of America",2417777,2377790,39987,1738656,2897760,"USA",2318208
1,135.0,"Central Asia",1248597,1207782,40815,936867,1561446,"UZB",1249157
1,135.0,"India",5554803,5554803,0,4238274,7063791,"IND",5651033
1,136.0,"Western Europe",3776313,3665384,110929,2777207,4628678,"NLD",3702943
1,136.0,"Western Africa",340090,0,340090,251361,418936,"NGA",335149
1,136.0,"Oceania",478305,478305,0,360921,601535,"NZL",481228
1,136.0,"South America",1751390,1531967,219423,1316415,2194025,"BRA",1755220
1,136.0,"Northern Africa",1390059,0,1390059,1023844,1706407,"EGY",1365126
1,136.0,"Southern Asia",625482,0,625482,462297,770496,"IRN",616397
1,136.0,"Eastern Europe",3158002,2978498,179504,2384755,3974592,"POL",3179674
1,136.0,"Middle Africa",86211,0,86211,63836,106393,"AGO",85115
1,136.0,"Central America",459061,0,459061,338025,563375,"MEX",450700
1,136.0,"Southern Africa",60999,0,60999,43911,73186,"ZAF",58549
1,136.0,"South-Eastern Asia",912405,0,912405,675164,1125273,"IDN",900219
1,136.0,"China",8514072,8362343,151729,6422388,10703980,"CPR",8563184
1,136.0,"Pakistan",1573285,1451643,121642,1141178,1901963,"PAK",1521571
1,136.0,"Eastern Asia",836047,0,836047,611110,1018517,"JPN",814814
1,136.0,"Russian Federation",2773837,2541569,232268,2100451,3500752,"RUS",2800602
1,136.0,"Western Asia",481257,0,481257,357588,595981,"IRQ",476785
1,136.0,"Southern Europe",971794,0,971794,722764,1204607,"ITA",963686
1,136.0,"Eastern Africa",204660,0,204660,151367,252278,"ETH",201823
1,136.0,"Northern America",646484,638847,7637,476081,793468,"CAN",634775
1,136.0,"Northern Europe",1991409,1933541,57868,1438818,2398030,"GBR",1918424
1,136.0,"United States of America",2410666,2364845,45821,1738656,2897760,"USA",2318208
1,136.0,"Central Asia",1280126,1235002,45124,936867,1561446,"UZB",1249157
1,136.0,"India",5613638,5613638,0,4238274,7063791,"IND",5651033
1,137.0,"Western Europe",3776315,3663628,112687,2777207,4628678,"NLD",3702943
1,137.0,"Western Africa",340020,0,340020,251361,418936,"NGA",335149
1,137.0,"Oceania",480254,480254,0,360921,601535,"NZL",481228
1,137.0,"South America",1757914,1537154,220760,1316415,2194025,"BRA",1755220
1,137.0,"Northern Africa",1389716,0,1389716,1023844,1706407,"EGY",1365126
1,137.0,"Southern Asia",625357,0,625357,462297,770496,"IRN",616397
1,137.0,"Eastern Europe",3175194,2999654,175540,2384755,3974592,"POL",3179674
1,137.0,"Middle Africa",86148,0,86148,63836,106393,"AGO",85115
1,137.0,"Central America",458878,0,458878,338025,563375,"MEX",450700
1,137.0,"Southern Africa",61088,0,61088,43911,73186,"ZAF",58549
1,137.0,"South-Eastern Asia",912138,0,912138,675164,1125273,"IDN",900219
1,137.0,"China",8539879,8413331,126548,6422388,10703980,"CPR",8563184
1,137.0,"Pakistan",1522267,1407293,114974,1141178,1901963,"PAK",1521571
1,137.0,"Eastern Asia",835581,0,835581,611110,1018517,"JPN",814814
1,137.0,"Russian Federation",2792938,2564923,228015,2100451,3500752,"RUS",2800602
1,137.0,"Western Asia",481195,0,481195,357588,595981,"IRQ",476785
1,137.0,"Southern Europe",971681,0,971681,722764,1204607,"ITA",963686
1,137.0,"Eastern Africa",204622,0,204622,151367,252278,"ETH",201823
1,137.0,"Northern America",646449,638935,7514,476081,793468,"CAN",634775
1,137.0,"Northern Europe",2003572,1941364,62208,1438818,2398030,"GBR",1918424
1,137.0,"United States of America",2403553,2351976,51577,1738656,2897760,"USA",2318208
1,137.0,"Central Asia",1309484,1260171,49313,936867,1561446,"UZB",1249157
1,137.0,"India",5638512,5638512,0,4238274,7063791,"IND",5651033
1,138.0,"Western Europe",3783651,3661514,122137,2777207,4628678,"NLD",3702943
1,138.0,"Western Africa",339855,0,339855,251361,418936,"NGA",335149
1,138.0,"Oceania",484151,484151,0,360921,601535,"NZL",481228
1,138.0,"South America",1770121,1549954,220167,1316415,2194025,"BRA",1755220
1,138.0,"Northern Africa",1388871,0,1388871,1023844,1706407,"EGY",1365126
1,138.0,"Southern Asia",625050,0,625050,462297,770496,"IRN",616397
1,138.0,"Eastern Europe",3208606,3037608,170998,2384755,3974592,"POL",3179674
1,138.0,"Middle Africa",86106,0,86106,63836,106393,"AGO",85115
1,138.0,"Central America",458541,0,458541,338025,563375,"MEX",450700
1,138.0,"Southern Africa",60956,0,60956,43911,73186,"ZAF",58549
1,138.0,"South-Eastern Asia",911646,0,911646,675164,1125273,"IDN",900219
1,138.0,"China",8628285,8527235,101050,6422388,10703980,"CPR",8563184
1,138.0,"Pakistan",1534212,1420706,113506,1141178,1901963,"PAK",1521571
1,138.0,"Eastern Asia",834727,0,834727,611110,1018517,"JPN",814814
1,138.0,"Russian Federation",2828777,2606070,222707,2100451,3500752,"RUS",2800602
1,138.0,"Western Asia",481043,0,481043,357588,595981,"IRQ",476785
1,138.0,"Southern Europe",971403,0,971403,722764,1204607,"ITA",963686
1,138.0,"Eastern Africa",204525,0,204525,151367,252278,"ETH",201823
1,138.0,"Northern America",644533,638987,5546,476081,793468,"CAN",634775
1,138.0,"Northern Europe",2011680,1945521,66159,1438818,2398030,"GBR",1918424
1,138.0,"United States of America",2389331,2338633,50698,1738656,2897760,"USA",2318208
1,138.0,"Central Asia",1335672,1282666,53006,936867,1561446,"UZB",1249157
1,138.0,"India",5687283,5687283,0,4238274,7063791,"IND",5651033
1,139.0,"Western Europe",3790988,3659734,131254,2777207,4628678,"NLD",3702943
1,139.0,"Western Africa",339641,0,339641,251361,418936,"NGA",335149
1,139.0,"Oceania",478305,478305,0,360921,601535,"NZL",481228
1,139.0,"South America",1750888,1532993,217895,1316415,2194025,"BRA",1755220
1,139.0,"Northern Africa",1387805,0,1387805,1023844,1706407,"EGY",1365126
1,139.0,"Southern Asia",624663,0,624663,462297,770496,"IRN",616397
1,139.0,"Eastern Europe",3161415,2996364,165051,2384755,3974592,"POL",3179674
1,139.0,"Middle Africa",86209,0,86209,63836,106393,"AGO",85115
1,139.0,"Central America",458202,0,458202,338025,563375,"MEX",450700
1,139.0,"Southern Africa",60850,0,60850,43911,73186,"ZAF",58549
1,139.0,"South-Eastern Asia",911077,0,911077,675164,1125273,"IDN",900219
1,139.0,"China",8499260,8424299,74961,6422388,10703980,"CPR",8563184
1,139.0,"Pakistan",1515358,1404565,110793,1141178,1901963,"PAK",1521571
1,139.0,"Eastern Asia",833732,0,833732,611110,1018517,"JPN",814814
1,139.0,"Russian Federation",2777201,2563539,213662,2100451,3500752,"RUS",2800602
1,139.0,"Western Asia",480852,0,480852,357588,595981,"IRQ",476785
1,139.0,"Southern Europe",971061,0,971061,722764,1204607,"ITA",963686
1,139.0,"Eastern Africa",204408,0,204408,151367,252278,"ETH",201823
1,139.0,"Northern America",644533,640926,3607,476081,793468,"CAN",634775
1,139.0,"Northern Europe",2015736,1945970,69766,1438818,2398030,"GBR",1918424
1,139.0,"United States of America",2389330,2332731,56599,1738656,2897760,"USA",2318208
1,139.0,"Central Asia",1357649,1302796,54853,936867,1561446,"UZB",1249157
1,139.0,"India",5615033,5615033,0,4238274,7063791,"IND",5651033
1,140.0,"Western Europe",3790987,3650981,140006,2777207,4628678,"NLD",3702943
1,140.0,"Western Africa",339514,0,339514,251361,418936,"NGA",335149
1,140.0,"Oceania",479280,479280,0,360921,601535,"NZL",481228
1,140.0,"South America",1753420,1535366,218054,1316415,2194025,"BRA",1755220
1,140.0,"Northern Africa",1387157,0,1387157,1023844,1706407,"EGY",1365126
1,140.0,"Southern Asia",624423,0,624423,462297,770496,"IRN",616397
1,140.0,"Eastern Europe",3167825,3006418,161407,2384755,3974592,"POL",3179674
1,140.0,"Middle Africa",86043,0,86043,63836,106393,"AGO",85115
1,140.0,"Central America",458652,0,458652,338025,563375,"MEX",450700
1,140.0,"Southern Africa",60704,0,60704,43911,73186,"ZAF",58549
1,140.0,"South-Eastern Asia",910922,0,910922,675164,1125273,"IDN",900219
1,140.0,"China",8517541,8468012,49529,6422388,10703980,"CPR",8563184
1,140.0,"Pakistan",1518201,1408356,109845,1141178,1901963,"PAK",1521571
1,140.0,"Eastern Asia",834013,0,834013,611110,1018517,"JPN",814814
1,140.0,"Russian Federation",2783449,2575402,208047,2100451,3500752,"RUS",2800602
1,140.0,"Western Asia",480734,0,480734,357588,595981,"IRQ",476785
1,140.0,"Southern Europe",970851,0,970851,722764,1204607,"ITA",963686
1,140.0,"Eastern Africa",204331,0,204331,151367,252278,"ETH",201823
1,140.0,"Northern America",642582,640895,1687,476081,793468,"CAN",634775
1,140.0,"Northern Europe",1991408,1918314,73094,1438818,2398030,"GBR",1918424
1,140.0,"United States of America",2389330,2329041,60289,1738656,2897760,"USA",2318208
1,140.0,"Central Asia",1374156,1319069,55087,936867,1561446,"UZB",1249157
1,140.0,"India",5626400,5626400,0,4238274,7063791,"IND",5651033
1,141.0,"Western Europe",3666261,3517690,148571,2777207,4628678,"NLD",3702943
1,141.0,"Western Africa",323575,0,323575,251361,418936,"NGA",335149
1,141.0,"Oceania",478306,478306,0,360921,601535,"NZL",481228
1,141.0,"South America",1725562,1532363,193199,1316415,2194025,"BRA",1755220
1,141.0,"Northern Africa",1306641,0,1306641,1023844,1706407,"EGY",1365126
1,141.0,"Southern Asia",595096,0,595096,462297,770496,"IRN",616397
1,141.0,"Eastern Europe",3153825,3002512,151313,2384755,3974592,"POL",3179674
1,141.0,"Middle Africa",82514,0,82514,63836,106393,"AGO",85115
1,141.0,"Central America",430885,0,430885,338025,563375,"MEX",450700
1,141.0,"Southern Africa",52713,0,52713,43911,73186,"ZAF",58549
1,141.0,"South-Eastern Asia",870121,0,870121,675164,1125273,"IDN",900219
1,141.0,"China",8496137,8472209,23928,6422388,10703980,"CPR",8563184
1,141.0,"Pakistan",1504753,1406465,98288,1141178,1901963,"PAK",1521571
1,141.0,"Eastern Asia",763308,0,763308,611110,1018517,"JPN",814814
1,141.0,"Russian Federation",2745641,2573094,172547,2100451,3500752,"RUS",2800602
1,141.0,"Western Asia",466310,0,466310,357588,595981,"IRQ",476785
1,141.0,"Southern Europe",944679,0,944679,722764,1204607,"ITA",963686
1,141.0,"Eastern Africa",195179,0,195179,151367,252278,"ETH",201823
1,141.0,"Northern America",496238,496238,0,476081,793468,"CAN",634775
1,141.0,"Northern Europe",2003571,1926685,76886,1438818,2398030,"GBR",1918424
1,141.0,"United States of America",2232866,2178901,53965,1738656,2897760,"USA",2318208
1,141.0,"Central Asia",1376857,1327358,49499,936867,1561446,"UZB",1249157
1,141.0,"India",5614392,5614392,0,4238274,7063791,"IND",5651033
1,142.0,"Western Europe",3658919,3498102,160817,2777207,4628678,"NLD",3702943
1,142.0,"Western Africa",327795,0,327795,251361,418936,"NGA",335149
1,142.0,"Oceania",482201,482201,0,360921,601535,"NZL",481228
1,142.0,"South America",1750745,1565853,184892,1316415,2194025,"BRA",1755220
1,142.0,"Northern Africa",1328003,0,1328003,1023844,1706407,"EGY",1365126
1,142.0,"Southern Asia",602871,0,602871,462297,770496,"IRN",616397
1,142.0,"Eastern Europe",3185388,3043955,141433,2384755,3974592,"POL",3179674
1,142.0,"Middle Africa",83575,0,83575,63836,106393,"AGO",85115
1,142.0,"Central America",437210,0,437210,338025,563375,"MEX",450700
1,142.0,"Southern Africa",54788,0,54788,43911,73186,"ZAF",58549
1,142.0,"South-Eastern Asia",881372,0,881372,675164,1125273,"IDN",900219
1,142.0,"China",8583215,8583215,0,6422388,10703980,"CPR",8563184
1,142.0,"Pakistan",1523410,1429245,94165,1141178,1901963,"PAK",1521571
1,142.0,"Eastern Asia",782121,0,782121,611110,1018517,"JPN",814814
1,142.0,"Russian Federation",2795901,2639159,156742,2100451,3500752,"RUS",2800602
1,142.0,"Western Asia",470130,0,470130,357588,595981,"IRQ",476785
1,142.0,"Southern Europe",951616,0,951616,722764,1204607,"ITA",963686
1,142.0,"Eastern Africa",197599,0,197599,151367,252278,"ETH",201823
1,142.0,"Northern America",576226,574051,2175,476081,793468,"CAN",634775
1,142.0,"Northern Europe",1995462,1919709,75753,1438818,2398030,"GBR",1918424
1,142.0,"United States of America",2211526,2163425,48101,1738656,2897760,"USA",2318208
1,142.0,"Central Asia",1326046,1277181,48865,936867,1561446,"UZB",1249157
1,142.0,"India",5662774,5662774,0,4238274,7063791,"IND",5651033
1,143.0,"Western Europe",3666257,3492872,173385,2777211,4628686,"NLD",3702949
1,143.0,"Western Africa",330872,0,330872,251370,418950,"NGA",335160
1,143.0,"Oceania",487073,487073,0,360922,601537,"NZL",481230
1,143.0,"South America",1769586,1594454,175132,1316418,2194030,"BRA",1755224
1,143.0,"Northern Africa",1343543,0,1343543,1023845,1706408,"EGY",1365127
1,143.0,"Southern Asia",608533,0,608533,462302,770503,"IRN",616403
1,143.0,"Eastern Europe",3227245,3096879,130366,2384760,3974601,"POL",3179681
1,143.0,"Middle Africa",84166,0,84166,63843,106405,"AGO",85124
1,143.0,"Central America",442836,0,442836,338028,563380,"MEX",450704
1,143.0,"Southern Africa",56361,0,56361,43914,73190,"ZAF",58552
1,143.0,"South-Eastern Asia",889260,0,889260,675164,1125273,"IDN",900219
1,143.0,"China",8695269,8695269,0,6422388,10703981,"CPR",8563185
1,143.0,"Pakistan",1540416,1451090,89326,1141184,1901973,"PAK",1521579
1,143.0,"Eastern Asia",795806,0,795806,611117,1018528,"JPN",814823
1,143.0,"Russian Federation",2849900,2703703,146197,2100458,3500763,"RUS",2800611
1,143.0,"Western Asia",472914,0,472914,357596,595993,"IRQ",476795
1,143.0,"Southern Europe",956670,0,956670,722769,1204616,"ITA",963693
1,143.0,"Eastern Africa",199364,0,199364,151369,252282,"ETH",201826
1,143.0,"Northern America",613306,609012,4294,476088,793480,"CAN",634784
1,143.0,"Northern Europe",1987353,1913705,73648,1438824,2398040,"GBR",1918432
1,143.0,"United States of America",2225750,2176287,49463,1738663,2897772,"USA",2318218
1,143.0,"Central Asia",1268672,1225450,43222,936873,1561455,"UZB",1249164
1,143.0,"India",5723920,5723920,0,4238280,7063801,"IND",5651041
1,144.0,"Western Europe",3680930,3495143,185787,2691367,4485612,"NLD",3588490
1,144.0,"Western Africa",332452,0,332452,249888,416480,"NGA",333184
1,144.0,"Oceania",475383,475383,0,405348,675581,"NZL",540465
1,144.0,"South America",1733033,1568005,165028,1475713,2459522,"BRA",1967618
1,144.0,"Northern Africa",1351516,0,1351516,822822,1371370,"EGY",1097096
1,144.0,"Southern Asia",611437,0,611437,326114,543523,"IRN",434819
1,144.0,"Eastern Europe",3131894,3013777,118117,2002410,3337350,"POL",2669880
1,144.0,"Middle Africa",84516,0,84516,69132,115220,"AGO",92176
1,144.0,"Central America",445970,0,445970,375885,626475,"MEX",501180
1,144.0,"Southern Africa",57165,0,57165,52056,86761,"ZAF",69409
1,144.0,"South-Eastern Asia",893311,0,893311,577857,963095,"IDN",770476
1,144.0,"China",8435386,8435386,0,6705209,11175348,"CPR",8940279
1,144.0,"Pakistan",1503379,1419766,83613,1234669,2057782,"PAK",1646226
1,144.0,"Eastern Asia",802829,0,802829,600287,1000478,"JPN",800383
1,144.0,"Russian Federation",2749665,2616018,133647,1978290,3297151,"RUS",2637721
1,144.0,"Western Asia",474342,0,474342,341202,568670,"IRQ",454936
1,144.0,"Southern Europe",959260,0,959260,596340,993900,"ITA",795120
1,144.0,"Eastern Africa",200270,0,200270,217480,362467,"ETH",289974
1,144.0,"Northern America",632821,626510,6311,462597,770996,"CAN",616797
1,144.0,"Northern Europe",1975189,1904402,70787,1518131,2530218,"GBR",2024175
1,144.0,"United States of America",2254199,2200574,53625,2015148,3358580,"USA",2686864
1,144.0,"Central Asia",1233478,1194258,39220,1060683,1767805,"UZB",1414244
1,144.0,"India",5579037,5579037,0,4337031,7228385,"IND",5782708
1,145.0,"Western Europe",3695609,3498236,197373,2691367,4485612,"NLD",3588490
1,145.0,"Western Africa",333672,0,333672,249888,416480,"NGA",333184
1,145.0,"Oceania",475385,475385,0,405348,675581,"NZL",540465
1,145.0,"South America",1732200,1573176,159024,1475713,2459522,"BRA",1967618
1,145.0,"Northern Africa",1357626,0,1357626,822822,1371370,"EGY",1097096
1,145.0,"Southern Asia",613669,0,613669,326114,543523,"IRN",434819
1,145.0,"Eastern Europe",3129073,3017398,111675,2002410,3337350,"POL",2669880
1,145.0,"Middle Africa",84791,0,84791,69132,115220,"AGO",92176
1,145.0,"Central America",448441,0,448441,375885,626475,"MEX",501180
1,145.0,"Southern Africa",57790,0,57790,52056,86761,"ZAF",69409
1,145.0,"South-Eastern Asia",896408,0,896408,577857,963095,"IDN",770476
1,145.0,"China",8428065,8428065,0,6705209,11175348,"CPR",8940279
1,145.0,"Pakistan",1501137,1422193,78944,1234669,2057782,"PAK",1646226
1,145.0,"Eastern Asia",808217,0,808217,600287,1000478,"JPN",800383
1,145.0,"Russian Federation",2746491,2617698,128793,1978290,3297151,"RUS",2637721
1,145.0,"Western Asia",475446,0,475446,341202,568670,"IRQ",454936
1,145.0,"Southern Europe",961255,0,961255,596340,993900,"ITA",795120
1,145.0,"Eastern Africa",200971,0,200971,217480,362467,"ETH",289974
1,145.0,"Northern America",640637,632463,8174,462597,770996,"CAN",616797
1,145.0,"Northern Europe",1910325,1847008,63317,1518131,2530218,"GBR",2024175
1,145.0,"United States of America",2275545,2212864,62681,2015148,3358580,"USA",2686864
1,145.0,"Central Asia",1231969,1196674,35295,1060683,1767805,"UZB",1414244
1,145.0,"India",5577520,5577520,0,4337031,7228385,"IND",5782708
1,146.0,"Western Europe",3786587,3582670,203917,2691367,4485612,"NLD",3588490
1,146.0,"Western Africa",336080,0,336080,249888,416480,"NGA",333184
1,146.0,"Oceania",536569,536569,0,405348,675581,"NZL",540465
1,146.0,"South America",1946434,1766350,180084,1475713,2459522,"BRA",1967618
1,146.0,"Northern Africa",1111706,0,1111706,822822,1371370,"EGY",1097096
1,146.0,"Southern Asia",440146,0,440146,326114,543523,"IRN",434819
1,146.0,"Eastern Europe",2661234,2566803,94431,2002410,3337350,"POL",2669880
1,146.0,"Middle Africa",92805,0,92805,69132,115220,"AGO",92176
1,146.0,"Central America",505907,0,505907,375885,626475,"MEX",501180
1,146.0,"Southern Africa",70882,0,70882,52056,86761,"ZAF",69409
1,146.0,"South-Eastern Asia",777896,0,777896,577857,963095,"IDN",770476
1,146.0,"China",8838170,8838170,0,6705209,11175348,"CPR",8940279
1,146.0,"Pakistan",1562733,1476329,86404,1234669,2057782,"PAK",1646226
1,146.0,"Eastern Asia",813251,0,813251,600287,1000478,"JPN",800383
1,146.0,"Russian Federation",2619239,2493200,126039,1978290,3297151,"RUS",2637721
1,146.0,"Western Asia",457557,0,457557,341202,568670,"IRQ",454936
1,146.0,"Southern Europe",800998,0,800998,596340,993900,"ITA",795120
1,146.0,"Eastern Africa",291629,0,291629,217480,362467,"ETH",289974
1,146.0,"Northern America",683142,673318,9824,462597,770996,"CAN",616797
1,146.0,"Northern Europe",1943083,1883301,59782,1518131,2530218,"GBR",2024175
1,146.0,"United States of America",2551735,2473767,77968,2015148,3358580,"USA",2686864
1,146.0,"Central Asia",1397021,1362006,35015,1060683,1767805,"UZB",1414244
1,146.0,"India",5732042,5732042,0,4337031,7228385,"IND",5782708
1,147.0,"Western Europe",3727894,3532945,194949,2691367,4485612,"NLD",3588490
1,147.0,"Western Africa",336222,0,336222,249888,416480,"NGA",333184
1,147.0,"Oceania",545334,545334,0,405348,675581,"NZL",540465
1,147.0,"South America",1988673,1806622,182051,1475713,2459522,"BRA",1967618
1,147.0,"Northern Africa",1112423,0,1112423,822822,1371370,"EGY",1097096
1,147.0,"Southern Asia",440404,0,440404,326114,543523,"IRN",434819
1,147.0,"Eastern Europe",2716792,2623399,93393,2002410,3337350,"POL",2669880
1,147.0,"Middle Africa",92851,0,92851,69132,115220,"AGO",92176
1,147.0,"Central America",506508,0,506508,375885,626475,"MEX",501180
1,147.0,"Southern Africa",70965,0,70965,52056,86761,"ZAF",69409
1,147.0,"South-Eastern Asia",778195,0,778195,577857,963095,"IDN",770476
1,147.0,"China",8937402,8937402,0,6705209,11175348,"CPR",8940279
1,147.0,"Pakistan",1600484,1504519,95965,1234669,2057782,"PAK",1646226
1,147.0,"Eastern Asia",813882,0,813882,600287,1000478,"JPN",800383
1,147.0,"Russian Federation",2687157,2561047,126110,1978290,3297151,"RUS",2637721
1,147.0,"Western Asia",457688,0,457688,341202,568670,"IRQ",454936
1,147.0,"Southern Europe",799708,0,799708,596340,993900,"ITA",795120
1,147.0,"Eastern Africa",291722,0,291722,217480,362467,"ETH",289974
1,147.0,"Northern America",649974,638963,11011,462597,770996,"CAN",616797
1,147.0,"Northern Europe",1947138,1890464,56674,1518131,2530218,"GBR",2024175
1,147.0,"United States of America",2637077,2548431,88646,2015148,3358580,"USA",2686864
1,147.0,"Central Asia",1429468,1396388,33080,1060683,1767805,"UZB",1414244
1,147.0,"India",5842810,5842810,0,4337031,7228385,"IND",5782708
1,148.0,"Western Europe",3676536,3496246,180290,2691367,4485612,"NLD",3588490
1,148.0,"Western Africa",336631,0,336631,249888,416480,"NGA",333184
1,148.0,"Oceania",549232,549232,0,405348,675581,"NZL",540465
1,148.0,"South America",2003581,1823857,179724,1475713,2459522,"BRA",1967618
1,148.0,"Northern Africa",1114489,0,1114489,822822,1371370,"EGY",1097096
1,148.0,"Southern Asia",441159,0,441159,326114,543523,"IRN",434819
1,148.0,"Eastern Europe",2748796,2660675,88121,2002410,3337350,"POL",2669880
1,148.0,"Middle Africa",92941,0,92941,69132,115220,"AGO",92176
1,148.0,"Central America",507225,0,507225,375885,626475,"MEX",501180
1,148.0,"Southern Africa",71172,0,71172,52056,86761,"ZAF",69409
1,148.0,"South-Eastern Asia",779833,0,779833,577857,963095,"IDN",770476
1,148.0,"China",8940197,8940197,0,6705209,11175348,"CPR",8940279
1,148.0,"Pakistan",1634403,1530116,104287,1234669,2057782,"PAK",1646226
1,148.0,"Eastern Asia",815703,0,815703,600287,1000478,"JPN",800383
1,148.0,"Russian Federation",2728011,2602253,125758,1978290,3297151,"RUS",2637721
1,148.0,"Western Asia",458057,0,458057,341202,568670,"IRQ",454936
1,148.0,"Southern Europe",799974,0,799974,596340,993900,"ITA",795120
1,148.0,"Eastern Africa",291955,0,291955,217480,362467,"ETH",289974
1,148.0,"Northern America",640116,627640,12476,462597,770996,"CAN",616797
1,148.0,"Northern Europe",1959301,1894806,64495,1518131,2530218,"GBR",2024175
1,148.0,"United States of America",2693973,2596216,97757,2015148,3358580,"USA",2686864
1,148.0,"Central Asia",1440886,1411089,29797,1060683,1767805,"UZB",1414244
1,148.0,"India",5892485,5892485,0,4337031,7228385,"IND",5782708
1,149.0,"Western Europe",3625176,3458736,166440,2691367,4485612,"NLD",3588490
1,149.0,"Western Africa",335812,0,335812,249888,416480,"NGA",333184
1,149.0,"Oceania",539491,539491,0,405348,675581,"NZL",540465
1,149.0,"South America",1969405,1795665,173740,1475713,2459522,"BRA",1967618
1,149.0,"Northern Africa",1110351,0,1110351,822822,1371370,"EGY",1097096
1,149.0,"Southern Asia",439649,0,439649,326114,543523,"IRN",434819
1,149.0,"Eastern Europe",2666218,2586884,79334,2002410,3337350,"POL",2669880
1,149.0,"Middle Africa",92760,0,92760,69132,115220,"AGO",92176
1,149.0,"Central America",505785,0,505785,375885,626475,"MEX",501180
1,149.0,"Southern Africa",70755,0,70755,52056,86761,"ZAF",69409
1,149.0,"South-Eastern Asia",777619,0,777619,577857,963095,"IDN",770476
1,149.0,"China",8941207,8940276,931,6705209,11175348,"CPR",8940279
1,149.0,"Pakistan",1654660,1544751,109909,1234669,2057782,"PAK",1646226
1,149.0,"Eastern Asia",812055,0,812055,600287,1000478,"JPN",800383
1,149.0,"Russian Federation",2636907,2519849,117058,1978290,3297151,"RUS",2637721
1,149.0,"Western Asia",457312,0,457312,341202,568670,"IRQ",454936
1,149.0,"Southern Europe",799597,0,799597,596340,993900,"ITA",795120
1,149.0,"Eastern Africa",291486,0,291486,217480,362467,"ETH",289974
1,149.0,"Northern America",634361,622156,12205,462597,770996,"CAN",616797
1,149.0,"Northern Europe",1975519,1903341,72178,1518131,2530218,"GBR",2024175
1,149.0,"United States of America",2722426,2616770,105656,2015148,3358580,"USA",2686864
1,149.0,"Central Asia",1412577,1387226,25351,1060683,1767805,"UZB",1414244
1,149.0,"India",5771736,5771736,0,4337031,7228385,"IND",5782708
1,150.0,"Western Europe",3566482,3412007,154475,2691367,4485612,"NLD",3588490
1,150.0,"Western Africa",335042,0,335042,249888,416480,"NGA",333184
1,150.0,"Oceania",537543,537543,0,405348,675581,"NZL",540465
1,150.0,"South America",1961295,1790251,171044,1475713,2459522,"BRA",1967618
1,150.0,"Northern Africa",1106465,0,1106465,822822,1371370,"EGY",1097096
1,150.0,"Southern Asia",438234,0,438234,326114,543523,"IRN",434819
1,150.0,"Eastern Europe",2644335,2573991,70344,2002410,3337350,"POL",2669880
1,150.0,"Middle Africa",92503,0,92503,69132,115220,"AGO",92176
1,150.0,"Central America",504437,0,504437,375885,626475,"MEX",501180
1,150.0,"Southern Africa",70361,0,70361,52056,86761,"ZAF",69409
1,150.0,"South-Eastern Asia",775424,0,775424,577857,963095,"IDN",770476
1,150.0,"China",8940306,8940306,0,6705209,11175348,"CPR",8940279
1,150.0,"Pakistan",1732100,1619073,113027,1234669,2057782,"PAK",1646226
1,150.0,"Eastern Asia",808633,0,808633,600287,1000478,"JPN",800383
1,150.0,"Russian Federation",2612935,2502527,110408,1978290,3297151,"RUS",2637721
1,150.0,"Western Asia",456620,0,456620,341202,568670,"IRQ",454936
1,150.0,"Southern Europe",798525,0,798525,596340,993900,"ITA",795120
1,150.0,"Eastern Africa",291043,0,291043,217480,362467,"ETH",289974
1,150.0,"Northern America",632410,620005,12405,462597,770996,"CAN",616797
1,150.0,"Northern Europe",2003899,1924340,79559,1518131,2530218,"GBR",2024175
1,150.0,"United States of America",2736650,2631807,104843,2015148,3358580,"USA",2686864
1,150.0,"Central Asia",1405600,1384755,20845,1060683,1767805,"UZB",1414244
1,150.0,"India",5746211,5746211,0,4337031,7228385,"IND",5782708
1,151.0,"Western Europe",3573814,3429435,144379,2691367,4485612,"NLD",3588490
1,151.0,"Western Africa",335068,0,335068,249888,416480,"NGA",333184
1,151.0,"Oceania",538517,538517,0,405348,675581,"NZL",540465
1,151.0,"South America",1964437,1795083,169354,1475713,2459522,"BRA",1967618
1,151.0,"Northern Africa",1106599,0,1106599,822822,1371370,"EGY",1097096
1,151.0,"Southern Asia",438283,0,438283,326114,543523,"IRN",434819
1,151.0,"Eastern Europe",2652082,2589735,62347,2002410,3337350,"POL",2669880
1,151.0,"Middle Africa",92594,0,92594,69132,115220,"AGO",92176
1,151.0,"Central America",504488,0,504488,375885,626475,"MEX",501180
1,151.0,"Southern Africa",70377,0,70377,52056,86761,"ZAF",69409
1,151.0,"South-Eastern Asia",775299,0,775299,577857,963095,"IDN",770476
1,151.0,"China",8940280,8940280,0,6705209,11175348,"CPR",8940279
1,151.0,"Pakistan",1714828,1607857,106971,1234669,2057782,"PAK",1646226
1,151.0,"Eastern Asia",808754,0,808754,600287,1000478,"JPN",800383
1,151.0,"Russian Federation",2620830,2515635,105195,1978290,3297151,"RUS",2637721
1,151.0,"Western Asia",456641,0,456641,341202,568670,"IRQ",454936
1,151.0,"Southern Europe",798457,0,798457,596340,993900,"ITA",795120
1,151.0,"Eastern Africa",291059,0,291059,217480,362467,"ETH",289974
1,151.0,"Northern America",628507,614467,14040,462597,770996,"CAN",616797
1,151.0,"Northern Europe",2028228,1942010,86218,1518131,2530218,"GBR",2024175
1,151.0,"United States of America",2736651,2632946,103705,2015148,3358580,"USA",2686864
1,151.0,"Central Asia",1408271,1391722,16549,1060683,1767805,"UZB",1414244
1,151.0,"India",5758070,5758070,0,4337031,7228385,"IND",5782708
1,152.0,"Western Europe",3573814,3439787,134027,2691367,4485612,"NLD",3588490
1,152.0,"Western Africa",335728,0,335728,249888,416480,"NGA",333184
1,152.0,"Oceania",538516,538516,0,405348,675581,"NZL",540465
1,152.0,"South America",1965161,1797213,167948,1475713,2459522,"BRA",1967618
1,152.0,"Northern Africa",1109924,0,1109924,822822,1371370,"EGY",1097096
1,152.0,"Southern Asia",439493,0,439493,326114,543523,"IRN",434819
1,152.0,"Eastern Europe",2652694,2598248,54446,2002410,3337350,"POL",2669880
1,152.0,"Middle Africa",92832,0,92832,69132,115220,"AGO",92176
1,152.0,"Central America",505636,0,505636,375885,626475,"MEX",501180
1,152.0,"Southern Africa",70711,0,70711,52056,86761,"ZAF",69409
1,152.0,"South-Eastern Asia",775926,0,775926,577857,963095,"IDN",770476
1,152.0,"China",8940280,8940280,0,6705209,11175348,"CPR",8940279
1,152.0,"Pakistan",1641811,1544451,97360,1234669,2057782,"PAK",1646226
1,152.0,"Eastern Asia",811680,0,811680,600287,1000478,"JPN",800383
1,152.0,"Russian Federation",2621786,2521604,100182,1978290,3297151,"RUS",2637721
1,152.0,"Western Asia",457237,0,457237,341202,568670,"IRQ",454936
1,152.0,"Southern Europe",799533,0,799533,596340,993900,"ITA",795120
1,152.0,"Eastern Africa",291437,0,291437,217480,362467,"ETH",289974
1,152.0,"Northern America",628507,612800,15707,462597,770996,"CAN",616797
1,152.0,"Northern Europe",2255284,2163118,92166,1518131,2530218,"GBR",2024175
1,152.0,"United States of America",2736649,2628485,108164,2015148,3358580,"USA",2686864
1,152.0,"Central Asia",1408495,1396150,12345,1060683,1767805,"UZB",1414244
1,152.0,"India",5758194,5758194,0,4337031,7228385,"IND",5782708
1,153.0,"Western Europe",3493108,3369467,123641,2691367,4485612,"NLD",3588490
1,153.0,"Western Africa",340827,0,340827,249888,416480,"NGA",333184
1,153.0,"Oceania",546309,546309,0,405348,675581,"NZL",540465
1,153.0,"South America",2000791,1824802,175989,1475713,2459522,"BRA",1967618
1,153.0,"Northern Africa",1135686,0,1135686,822822,1371370,"EGY",1097096
1,153.0,"Southern Asia",448878,0,448878,326114,543523,"IRN",434819
1,153.0,"Eastern Europe",2713966,2671094,42872,2002410,3337350,"POL",2669880
1,153.0,"Middle Africa",93866,0,93866,69132,115220,"AGO",92176
1,153.0,"Central America",514588,0,514588,375885,626475,"MEX",501180
1,153.0,"Southern Africa",73316,0,73316,52056,86761,"ZAF",69409
1,153.0,"South-Eastern Asia",790065,0,790065,577857,963095,"IDN",770476
1,153.0,"China",8940280,8940280,0,6705209,11175348,"CPR",8940279
1,153.0,"Pakistan",1663435,1572320,91115,1234669,2057782,"PAK",1646226
1,153.0,"Eastern Asia",834368,0,834368,600287,1000478,"JPN",800383
1,153.0,"Russian Federation",2683151,2595989,87162,1978290,3297151,"RUS",2637721
1,153.0,"Western Asia",461854,0,461854,341202,568670,"IRQ",454936
1,153.0,"Southern Europe",807149,0,807149,596340,993900,"ITA",795120
1,153.0,"Eastern Africa",294364,0,294364,217480,362467,"ETH",289974
1,153.0,"Northern America",589482,575786,13696,462597,770996,"CAN",616797
1,153.0,"Northern Europe",2113375,2026773,86602,1518131,2530218,"GBR",2024175
1,153.0,"United States of America",3021128,2906194,114934,2015148,3358580,"USA",2686864
1,153.0,"Central Asia",1430843,1422512,8331,1060683,1767805,"UZB",1414244
1,153.0,"India",5855212,5855212,0,4337031,7228385,"IND",5782708
1,154.0,"Western Europe",3573813,3447698,126115,2691367,4485612,"NLD",3588490
1,154.0,"Western Africa",339949,0,339949,249888,416480,"NGA",333184
1,154.0,"Oceania",536569,536569,0,405348,675581,"NZL",540465
1,154.0,"South America",1966933,1788858,178075,1475713,2459522,"BRA",1967618
1,154.0,"Northern Africa",1131247,0,1131247,822822,1371370,"EGY",1097096
1,154.0,"Southern Asia",447264,0,447264,326114,543523,"IRN",434819
1,154.0,"Eastern Europe",2637988,2605072,32916,2002410,3337350,"POL",2669880
1,154.0,"Middle Africa",93673,0,93673,69132,115220,"AGO",92176
1,154.0,"Central America",513773,0,513773,375885,626475,"MEX",501180
1,154.0,"Southern Africa",72869,0,72869,52056,86761,"ZAF",69409
1,154.0,"South-Eastern Asia",787817,0,787817,577857,963095,"IDN",770476
1,154.0,"China",8940280,8940280,0,6705209,11175348,"CPR",8940279
1,154.0,"Pakistan",1634009,1549002,85007,1234669,2057782,"PAK",1646226
1,154.0,"Eastern Asia",830461,0,830461,600287,1000478,"JPN",800383
1,154.0,"Russian Federation",2606015,2527766,78249,1978290,3297151,"RUS",2637721
1,154.0,"Western Asia",461060,0,461060,341202,568670,"IRQ",454936
1,154.0,"Southern Europe",806791,0,806791,596340,993900,"ITA",795120
1,154.0,"Eastern Africa",293861,0,293861,217480,362467,"ETH",289974
1,154.0,"Northern America",620696,606623,14073,462597,770996,"CAN",616797
1,154.0,"Northern Europe",2007959,1930051,77908,1518131,2530218,"GBR",2024175
1,154.0,"United States of America",2914449,2814191,100258,2015148,3358580,"USA",2686864
1,154.0,"Central Asia",1405307,1399716,5591,1060683,1767805,"UZB",1414244
1,154.0,"India",5734963,5734963,0,4337031,7228385,"IND",5782708
1,155.0,"Western Europe",3617835,3491488,126347,2691369,4485616,"NLD",3588493
1,155.0,"Western Africa",336487,0,336487,249896,416493,"NGA",333195
1,155.0,"Oceania",539490,539490,0,405357,675595,"NZL",540476
1,155.0,"South America",1970409,1792096,178313,1475718,2459530,"BRA",1967624
1,155.0,"Northern Africa",1113753,0,1113753,822829,1371382,"EGY",1097106
1,155.0,"Southern Asia",440887,0,440887,326114,543523,"IRN",434819
1,155.0,"Eastern Europe",2662179,2635122,27057,2002416,3337361,"POL",2669889
1,155.0,"Middle Africa",92909,0,92909,69140,115233,"AGO",92187
1,155.0,"Central America",507362,0,507362,375893,626488,"MEX",501191
1,155.0,"Southern Africa",71100,0,71100,52061,86768,"ZAF",69415
1,155.0,"South-Eastern Asia",778934,0,778934,577865,963108,"IDN",770487
1,155.0,"China",8940280,8940280,0,6705210,11175351,"CPR",8940281
1,155.0,"Pakistan",1642703,1561912,80791,1234677,2057796,"PAK",1646237
1,155.0,"Eastern Asia",815054,0,815054,600294,1000491,"JPN",800393
1,155.0,"Russian Federation",2631634,2556050,75584,1978293,3297156,"RUS",2637725
1,155.0,"Western Asia",457924,0,457924,341208,568680,"IRQ",454944
1,155.0,"Southern Europe",800804,0,800804,596342,993903,"ITA",795123
1,155.0,"Eastern Africa",291871,0,291871,217482,362471,"ETH",289977
1,155.0,"Northern America",638309,624242,14067,462600,771001,"CAN",616801
1,155.0,"Northern Europe",2020119,1947844,72275,1518135,2530225,"GBR",2024180
1,155.0,"United States of America",2736650,2649574,87076,2015151,3358586,"USA",2686869
1,155.0,"Central Asia",1412442,1409809,2633,1060684,1767807,"UZB",1414246
1,155.0,"India",5770078,5770078,0,4337033,7228388,"IND",5782711
1,156.0,"Western Europe",3639850,3509466,130384,2923180,4871967,"NLD",3897574
1,156.0,"Western Africa",335115,0,335115,280808,468013,"NGA",374411
1,156.0,"Oceania",539491,539491,0,429351,715585,"NZL",572468
1,156.0,"South America",1967959,1792302,175657,1490019,2483365,"BRA",1986692
1,156.0,"Northern Africa",1106827,0,1106827,907674,1512791,"EGY",1210233
1,156.0,"Southern Asia",438367,0,438367,246203,410338,"IRN",328271
1,156.0,"Eastern Europe",2664041,2642317,21724,2620725,4367876,"POL",3494301
1,156.0,"Middle Africa",92608,0,92608,75163,125272,"AGO",100218
1,156.0,"Central America",504807,0,504807,405351,675585,"MEX",540468
1,156.0,"Southern Africa",70398,0,70398,85858,143097,"ZAF",114478
1,156.0,"South-Eastern Asia",775417,0,775417,785642,1309403,"IDN",1047523
1,156.0,"China",8940280,8940280,0,6743456,11239093,"CPR",8991275
1,156.0,"Pakistan",1645722,1566911,78811,1309280,2182133,"PAK",1745707
1,156.0,"Eastern Asia",808952,0,808952,627604,1046007,"JPN",836806
1,156.0,"Russian Federation",2633951,2560890,73061,2726607,4544345,"RUS",3635476
1,156.0,"Western Asia",456682,0,456682,448245,747076,"IRQ",597661
1,156.0,"Southern Europe",798469,0,798469,664310,1107183,"ITA",885747
1,156.0,"Eastern Africa",291086,0,291086,181521,302535,"ETH",242028
1,156.0,"Northern America",638263,624494,13769,582852,971420,"CAN",777136
1,156.0,"Northern Europe",2020119,1953817,66302,1579578,2632631,"GBR",2106105
1,156.0,"United States of America",2679755,2601754,78001,2023456,3372427,"USA",2697942
1,156.0,"Central Asia",1411516,1411415,101,1105047,1841745,"UZB",1473396
1,156.0,"India",5770448,5770448,0,4548952,7581587,"IND",6065270
1,157.0,"Western Europe",3595831,3477290,118541,2923180,4871967,"NLD",3897574
1,157.0,"Western Africa",333630,0,333630,280808,468013,"NGA",374411
1,157.0,"Oceania",537554,537554,0,429351,715585,"NZL",572468
1,157.0,"South America",1437372,1266615,170757,1490019,2483365,"BRA",1986692
1,157.0,"Northern Africa",1099282,0,1099282,907674,1512791,"EGY",1210233
1,157.0,"Southern Asia",435616,0,435616,246203,410338,"IRN",328271
1,157.0,"Eastern Europe",2645640,2634025,11615,2620725,4367876,"POL",3494301
1,157.0,"Middle Africa",92285,0,92285,75163,125272,"AGO",100218
1,157.0,"Central America",502343,0,502343,405351,675585,"MEX",540468
1,157.0,"Southern Africa",69640,0,69640,85858,143097,"ZAF",114478
1,157.0,"South-Eastern Asia",771594,0,771594,785642,1309403,"IDN",1047523
1,157.0,"China",8940280,8940280,0,6743456,11239093,"CPR",8991275
1,157.0,"Pakistan",1638314,1563154,75160,1309280,2182133,"PAK",1745707
1,157.0,"Eastern Asia",802313,0,802313,627604,1046007,"JPN",836806
1,157.0,"Russian Federation",2615962,2549295,66667,2726607,4544345,"RUS",3635476
1,157.0,"Western Asia",455337,0,455337,448245,747076,"IRQ",597661
1,157.0,"Southern Europe",796174,0,796174,664310,1107183,"ITA",885747
1,157.0,"Eastern Africa",290227,0,290227,181521,302535,"ETH",242028
1,157.0,"Northern America",636315,622843,13472,582852,971420,"CAN",777136
1,157.0,"Northern Europe",2012014,1951940,60074,1579578,2632631,"GBR",2106105
1,157.0,"United States of America",2665531,2595494,70037,2023456,3372427,"USA",2697942
1,157.0,"Central Asia",1406744,1405850,894,1105047,1841745,"UZB",1473396
1,157.0,"India",5746200,5746200,0,4548952,7581587,"IND",6065270
1,158.0,"Western Europe",3618773,3504958,113815,2923180,4871967,"NLD",3897574
1,158.0,"Western Africa",361124,0,361124,280808,468013,"NGA",374411
1,158.0,"Oceania",550063,550063,0,429351,715585,"NZL",572468
1,158.0,"South America",1497452,1273971,223481,1490019,2483365,"BRA",1986692
1,158.0,"Northern Africa",1143136,0,1143136,907674,1512791,"EGY",1210233
1,158.0,"Southern Asia",303836,0,303836,246203,410338,"IRN",328271
1,158.0,"Eastern Europe",2659139,2658066,1073,2620725,4367876,"POL",3494301
1,158.0,"Middle Africa",97278,0,97278,75163,125272,"AGO",100218
1,158.0,"Central America",518655,0,518655,405351,675585,"MEX",540468
1,158.0,"Southern Africa",107684,0,107684,85858,143097,"ZAF",114478
1,158.0,"South-Eastern Asia",1013455,0,1013455,785642,1309403,"IDN",1047523
1,158.0,"China",8946002,8946002,0,6743456,11239093,"CPR",8991275
1,158.0,"Pakistan",1701232,1629076,72156,1309280,2182133,"PAK",1745707
1,158.0,"Eastern Asia",777713,0,777713,627604,1046007,"JPN",836806
1,158.0,"Russian Federation",3258738,3180342,78396,2726607,4544345,"RUS",3635476
1,158.0,"Western Asia",585634,0,585634,448245,747076,"IRQ",597661
1,158.0,"Southern Europe",864830,0,864830,664310,1107183,"ITA",885747
1,158.0,"Eastern Africa",234404,0,234404,181521,302535,"ETH",242028
1,158.0,"Northern America",669811,657053,12758,582852,971420,"CAN",777136
1,158.0,"Northern Europe",2106103,2050456,55647,1579578,2632631,"GBR",2106105
1,158.0,"United States of America",2683716,2621249,62467,2023456,3372427,"USA",2697942
1,158.0,"Central Asia",1471148,1471148,0,1105047,1841745,"UZB",1473396
1,158.0,"India",6061915,6061915,0,4548952,7581587,"IND",6065270
1,159.0,"Western Europe",3648118,3528075,120043,2923180,4871967,"NLD",3897574
1,159.0,"Western Africa",361374,0,361374,280808,468013,"NGA",374411
1,159.0,"Oceania",544219,544219,0,429351,715585,"NZL",572468
1,159.0,"South America",1542196,1273614,268582,1490019,2483365,"BRA",1986692
1,159.0,"Northern Africa",1146096,0,1146096,907674,1512791,"EGY",1210233
1,159.0,"Southern Asia",303912,0,303912,246203,410338,"IRN",328271
1,159.0,"Eastern Europe",2676955,2662758,14197,2620725,4367876,"POL",3494301
1,159.0,"Middle Africa",97288,0,97288,75163,125272,"AGO",100218
1,159.0,"Central America",519737,0,519737,405351,675585,"MEX",540468
1,159.0,"Southern Africa",107708,0,107708,85858,143097,"ZAF",114478
1,159.0,"South-Eastern Asia",1013575,0,1013575,785642,1309403,"IDN",1047523
1,159.0,"China",8924242,8924242,0,6743456,11239093,"CPR",8991275
1,159.0,"Pakistan",1696067,1624538,71529,1309280,2182133,"PAK",1745707
1,159.0,"Eastern Asia",777918,0,777918,627604,1046007,"JPN",836806
1,159.0,"Russian Federation",3283092,3195955,87137,2726607,4544345,"RUS",3635476
1,159.0,"Western Asia",585677,0,585677,448245,747076,"IRQ",597661
1,159.0,"Southern Europe",866510,0,866510,664310,1107183,"ITA",885747
1,159.0,"Eastern Africa",234422,0,234422,181521,302535,"ETH",242028
1,159.0,"Northern America",712738,698749,13989,582852,971420,"CAN",777136
1,159.0,"Northern Europe",2085832,2036503,49329,1579578,2632631,"GBR",2106105
1,159.0,"United States of America",2598374,2543800,54574,2023456,3372427,"USA",2697942
1,159.0,"Central Asia",1459485,1459485,0,1105047,1841745,"UZB",1473396
1,159.0,"India",6004599,6004599,0,4548952,7581587,"IND",6065270
1,160.0,"Western Europe",3677466,3551851,125615,2923180,4871967,"NLD",3897574
1,160.0,"Western Africa",362859,0,362859,280808,468013,"NGA",374411
1,160.0,"Oceania",539347,537566,1781,429351,715585,"NZL",572468
1,160.0,"South America",1583885,1275944,307941,1490019,2483365,"BRA",1986692
1,160.0,"Northern Africa",1151343,0,1151343,907674,1512791,"EGY",1210233
1,160.0,"Southern Asia",303953,0,303953,246203,410338,"IRN",328271
1,160.0,"Eastern Europe",2702590,2673383,29207,2620725,4367876,"POL",3494301
1,160.0,"Middle Africa",97296,0,97296,75163,125272,"AGO",100218
1,160.0,"Central America",520318,0,520318,405351,675585,"MEX",540468
1,160.0,"Southern Africa",107718,0,107718,85858,143097,"ZAF",114478
1,160.0,"South-Eastern Asia",1013635,0,1013635,785642,1309403,"IDN",1047523
1,160.0,"China",8923632,8923632,0,6743456,11239093,"CPR",8991275
1,160.0,"Pakistan",1695796,1617458,78338,1309280,2182133,"PAK",1745707
1,160.0,"Eastern Asia",778019,0,778019,627604,1046007,"JPN",836806
1,160.0,"Russian Federation",3302099,3197594,104505,2726607,4544345,"RUS",3635476
1,160.0,"Western Asia",585697,0,585697,448245,747076,"IRQ",597661
1,160.0,"Southern Europe",867058,0,867058,664310,1107183,"ITA",885747
1,160.0,"Eastern Africa",234435,0,234435,181521,302535,"ETH",242028
1,160.0,"Northern America",730303,715011,15292,582852,971420,"CAN",777136
1,160.0,"Northern Europe",2106104,2062778,43326,1579578,2632631,"GBR",2106105
1,160.0,"United States of America",2555700,2508025,47675,2023456,3372427,"USA",2697942
1,160.0,"Central Asia",1472926,1472926,0,1105047,1841745,"UZB",1473396
1,160.0,"India",5943361,5943361,0,4548952,7581587,"IND",6065270
1,161.0,"Western Europe",3699476,3568944,130532,2923180,4871967,"NLD",3897574
1,161.0,"Western Africa",362960,0,362960,280808,468013,"NGA",374411
1,161.0,"Oceania",537397,533752,3645,429351,715585,"NZL",572468
1,161.0,"South America",1621596,1277309,344287,1490019,2483365,"BRA",1986692
1,161.0,"Northern Africa",1151846,0,1151846,907674,1512791,"EGY",1210233
1,161.0,"Southern Asia",303852,0,303852,246203,410338,"IRN",328271
1,161.0,"Eastern Europe",2737174,2690885,46289,2620725,4367876,"POL",3494301
1,161.0,"Middle Africa",97283,0,97283,75163,125272,"AGO",100218
1,161.0,"Central America",520443,0,520443,405351,675585,"MEX",540468
1,161.0,"Southern Africa",107690,0,107690,85858,143097,"ZAF",114478
1,161.0,"South-Eastern Asia",1013491,0,1013491,785642,1309403,"IDN",1047523
1,161.0,"China",8901694,8901694,0,6743456,11239093,"CPR",8991275
1,161.0,"Pakistan",1698938,1613677,85261,1309280,2182133,"PAK",1745707
1,161.0,"Eastern Asia",777773,0,777773,627604,1046007,"JPN",836806
1,161.0,"Russian Federation",3328774,3207118,121656,2726607,4544345,"RUS",3635476
1,161.0,"Western Asia",585644,0,585644,448245,747076,"IRQ",597661
1,161.0,"Southern Europe",867169,0,867169,664310,1107183,"ITA",885747
1,161.0,"Eastern Africa",234405,0,234405,181521,302535,"ETH",242028
1,161.0,"Northern America",738107,719842,18265,582852,971420,"CAN",777136
1,161.0,"Northern Europe",2057450,2020442,37008,1579578,2632631,"GBR",2106105
1,161.0,"United States of America",2534365,2493367,40998,2023456,3372427,"USA",2697942
1,161.0,"Central Asia",1451243,1451243,0,1105047,1841745,"UZB",1473396
1,161.0,"India",5942717,5942717,0,4548952,7581587,"IND",6065270
1,162.0,"Western Europe",3706813,3571857,134956,2923180,4871967,"NLD",3897574
1,162.0,"Western Africa",362967,0,362967,280808,468013,"NGA",374411
1,162.0,"Oceania",535450,529859,5591,429351,715585,"NZL",572468
1,162.0,"South America",1654603,1278062,376541,1490019,2483365,"BRA",1986692
1,162.0,"Northern Africa",1151888,0,1151888,907674,1512791,"EGY",1210233
1,162.0,"Southern Asia",303646,0,303646,246203,410338,"IRN",328271
1,162.0,"Eastern Europe",2770687,2707011,63676,2620725,4367876,"POL",3494301
1,162.0,"Middle Africa",97257,0,97257,75163,125272,"AGO",100218
1,162.0,"Central America",520454,0,520454,405351,675585,"MEX",540468
1,162.0,"Southern Africa",107633,0,107633,85858,143097,"ZAF",114478
1,162.0,"South-Eastern Asia",1013201,0,1013201,785642,1309403,"IDN",1047523
1,162.0,"China",8901078,8901078,0,6743456,11239093,"CPR",8991275
1,162.0,"Pakistan",1645467,1553291,92176,1309280,2182133,"PAK",1745707
1,162.0,"Eastern Asia",777268,0,777268,627604,1046007,"JPN",836806
1,162.0,"Russian Federation",3347265,3208939,138326,2726607,4544345,"RUS",3635476
1,162.0,"Western Asia",585544,0,585544,448245,747076,"IRQ",597661
1,162.0,"Southern Europe",867178,0,867178,664310,1107183,"ITA",885747
1,162.0,"Eastern Africa",234341,0,234341,181521,302535,"ETH",242028
1,162.0,"Northern America",742010,720810,21200,582852,971420,"CAN",777136
1,162.0,"Northern Europe",2008794,1977570,31224,1579578,2632631,"GBR",2106105
1,162.0,"United States of America",2527252,2491877,35375,2023456,3372427,"USA",2697942
1,162.0,"Central Asia",1483717,1483717,0,1105047,1841745,"UZB",1473396
1,162.0,"India",5942710,5942710,0,4548952,7581587,"IND",6065270
1,163.0,"Western Europe",3721487,3582270,139217,2923180,4871967,"NLD",3897574
1,163.0,"Western Africa",363197,0,363197,280808,468013,"NGA",374411
1,163.0,"Oceania",533501,525876,7625,429351,715585,"NZL",572468
1,163.0,"South America",1684562,1279146,405416,1490019,2483365,"BRA",1986692
1,163.0,"Northern Africa",1153049,0,1153049,907674,1512791,"EGY",1210233
1,163.0,"Southern Asia",303847,0,303847,246203,410338,"IRN",328271
1,163.0,"Eastern Europe",2804821,2722963,81858,2620725,4367876,"POL",3494301
1,163.0,"Middle Africa",97283,0,97283,75163,125272,"AGO",100218
1,163.0,"Central America",520855,0,520855,405351,675585,"MEX",540468
1,163.0,"Southern Africa",107689,0,107689,85858,143097,"ZAF",114478
1,163.0,"South-Eastern Asia",1013485,0,1013485,785642,1309403,"IDN",1047523
1,163.0,"China",8879141,8879141,0,6743456,11239093,"CPR",8991275
1,163.0,"Pakistan",1648994,1547780,101214,1309280,2182133,"PAK",1745707
1,163.0,"Eastern Asia",777763,0,777763,627604,1046007,"JPN",836806
1,163.0,"Russian Federation",3374258,3219314,154944,2726607,4544345,"RUS",3635476
1,163.0,"Western Asia",585646,0,585646,448245,747076,"IRQ",597661
1,163.0,"Southern Europe",867557,0,867557,664310,1107183,"ITA",885747
1,163.0,"Eastern Africa",234401,0,234401,181521,302535,"ETH",242028
1,163.0,"Northern America",742011,717877,24134,582852,971420,"CAN",777136
1,163.0,"Northern Europe",1996631,1969532,27099,1579578,2632631,"GBR",2106105
1,163.0,"United States of America",2527253,2490468,36785,2023456,3372427,"USA",2697942
1,163.0,"Central Asia",1462676,1462676,0,1105047,1841745,"UZB",1473396
1,163.0,"India",5942709,5939915,2794,4548952,7581587,"IND",6065270
1,164.0,"Western Europe",3728825,3585675,143150,2923180,4871967,"NLD",3897574
1,164.0,"Western Africa",363393,0,363393,280808,468013,"NGA",374411
1,164.0,"Oceania",534475,524724,9751,429351,715585,"NZL",572468
1,164.0,"South America",1711171,1280039,431132,1490019,2483365,"BRA",1986692
1,164.0,"Northern Africa",1154042,0,1154042,907674,1512791,"EGY",1210233
1,164.0,"Southern Asia",304304,0,304304,246203,410338,"IRN",328271
1,164.0,"Eastern Europe",3210960,3111340,99620,2620725,4367876,"POL",3494301
1,164.0,"Middle Africa",97336,0,97336,75163,125272,"AGO",100218
1,164.0,"Central America",521195,0,521195,405351,675585,"MEX",540468
1,164.0,"Southern Africa",107816,0,107816,85858,143097,"ZAF",114478
1,164.0,"South-Eastern Asia",1014305,0,1014305,785642,1309403,"IDN",1047523
1,164.0,"China",8856605,8856605,0,6743456,11239093,"CPR",8991275
1,164.0,"Pakistan",1652333,1542024,110309,1309280,2182133,"PAK",1745707
1,164.0,"Eastern Asia",778867,0,778867,627604,1046007,"JPN",836806
1,164.0,"Russian Federation",3392926,3221900,171026,2726607,4544345,"RUS",3635476
1,164.0,"Western Asia",585871,0,585871,448245,747076,"IRQ",597661
1,164.0,"Southern Europe",867870,0,867870,664310,1107183,"ITA",885747
1,164.0,"Eastern Africa",234545,0,234545,181521,302535,"ETH",242028
1,164.0,"Northern America",743963,716836,27127,582852,971420,"CAN",777136
1,164.0,"Northern Europe",1899323,1871214,28109,1579578,2632631,"GBR",2106105
1,164.0,"United States of America",2534364,2496170,38194,2023456,3372427,"USA",2697942
1,164.0,"Central Asia",1448129,1448129,0,1105047,1841745,"UZB",1473396
1,164.0,"India",5942710,5931377,11333,4548952,7581587,"IND",6065270
1,165.0,"Western Europe",3816866,3669947,146919,2923180,4871967,"NLD",3897574
1,165.0,"Western Africa",382843,0,382843,280808,468013,"NGA",374411
1,165.0,"Oceania",536425,524487,11938,429351,715585,"NZL",572468
1,165.0,"South America",1769257,1280456,488801,1490019,2483365,"BRA",1986692
1,165.0,"Northern Africa",1252308,0,1252308,907674,1512791,"EGY",1210233
1,165.0,"Southern Asia",340302,0,340302,246203,410338,"IRN",328271
1,165.0,"Eastern Europe",3244497,3124489,120008,2620725,4367876,"POL",3494301
1,165.0,"Middle Africa",101656,0,101656,75163,125272,"AGO",100218
1,165.0,"Central America",555337,0,555337,405351,675585,"MEX",540468
1,165.0,"Southern Africa",117817,0,117817,85858,143097,"ZAF",114478
1,165.0,"South-Eastern Asia",1065645,0,1065645,785642,1309403,"IDN",1047523
1,165.0,"China",7913417,7913417,0,6743456,11239093,"CPR",8991275
1,165.0,"Pakistan",1655662,1536215,119447,1309280,2182133,"PAK",1745707
1,165.0,"Eastern Asia",867774,0,867774,627604,1046007,"JPN",836806
1,165.0,"Russian Federation",3954729,3761126,193603,2726607,4544345,"RUS",3635476
1,165.0,"Western Asia",603576,0,603576,448245,747076,"IRQ",597661
1,165.0,"Southern Europe",899803,0,899803,664310,1107183,"ITA",885747
1,165.0,"Eastern Africa",245778,0,245778,181521,302535,"ETH",242028
1,165.0,"Northern America",919574,889438,30136,582852,971420,"CAN",777136
1,165.0,"Northern Europe",1899322,1869305,30017,1579578,2632631,"GBR",2106105
1,165.0,"United States of America",2769060,2729515,39545,2023456,3372427,"USA",2697942
1,165.0,"Central Asia",1458709,1458709,0,1105047,1841745,"UZB",1473396
1,165.0,"India",5954836,5931009,23827,4548952,7581587,"IND",6065270
1,166.0,"Western Europe",3868224,3719504,148720,2923180,4871967,"NLD",3897574
1,166.0,"Western Africa",379069,0,379069,280808,468013,"NGA",374411
1,166.0,"Oceania",564673,550509,14164,429351,715585,"NZL",572468
1,166.0,"South America",1814030,1282669,531361,1490019,2483365,"BRA",1986692
1,166.0,"Northern Africa",1234118,0,1234118,907674,1512791,"EGY",1210233
1,166.0,"Southern Asia",335562,0,335562,246203,410338,"IRN",328271
1,166.0,"Eastern Europe",3318893,3162546,156347,2620725,4367876,"POL",3494301
1,166.0,"Middle Africa",101100,0,101100,75163,125272,"AGO",100218
1,166.0,"Central America",549054,0,549054,405351,675585,"MEX",540468
1,166.0,"Southern Africa",116508,0,116508,85858,143097,"ZAF",114478
1,166.0,"South-Eastern Asia",1059227,0,1059227,785642,1309403,"IDN",1047523
1,166.0,"China",7930755,7924197,6558,6743456,11239093,"CPR",8991275
1,166.0,"Pakistan",1677920,1549309,128611,1309280,2182133,"PAK",1745707
1,166.0,"Eastern Asia",857223,0,857223,627604,1046007,"JPN",836806
1,166.0,"Russian Federation",3948825,3755710,193115,2726607,4544345,"RUS",3635476
1,166.0,"Western Asia",601248,0,601248,448245,747076,"IRQ",597661
1,166.0,"Southern Europe",893236,0,893236,664310,1107183,"ITA",885747
1,166.0,"Eastern Africa",244310,0,244310,181521,302535,"ETH",242028
1,166.0,"Northern America",839582,812361,27221,582852,971420,"CAN",777136
1,166.0,"Northern Europe",1911485,1879560,31925,1579578,2632631,"GBR",2106105
1,166.0,"United States of America",2754840,2717223,37617,2023456,3372427,"USA",2697942
1,166.0,"Central Asia",1182351,1182351,0,1105047,1841745,"UZB",1473396
1,166.0,"India",5930710,5918595,12115,4548952,7581587,"IND",6065270
1,167.0,"Western Europe",3897572,3748198,149374,2923184,4871973,"NLD",3897579
1,167.0,"Western Africa",376651,0,376651,280811,468018,"NGA",374415
1,167.0,"Oceania",578311,562308,16003,429355,715592,"NZL",572474
1,167.0,"South America",1849246,1285228,564018,1490027,2483378,"BRA",1986703
1,167.0,"Northern Africa",1221766,0,1221766,907678,1512797,"EGY",1210238
1,167.0,"Southern Asia",332816,0,332816,246204,410341,"IRN",328273
1,167.0,"Eastern Europe",3369600,3187184,182416,2620732,4367887,"POL",3494310
1,167.0,"Middle Africa",100768,0,100768,75166,125277,"AGO",100222
1,167.0,"Central America",545364,0,545364,405357,675595,"MEX",540476
1,167.0,"Southern Africa",115654,0,115654,85861,143102,"ZAF",114482
1,167.0,"South-Eastern Asia",1055249,0,1055249,785646,1309411,"IDN",1047529
1,167.0,"China",7953162,7930615,22547,6743463,11239106,"CPR",8991285
1,167.0,"Pakistan",1698008,1561084,136924,1309286,2182143,"PAK",1745715
1,167.0,"Eastern Asia",850283,0,850283,627611,1046018,"JPN",836815
1,167.0,"Russian Federation",3949797,3763447,186350,2726609,4544348,"RUS",3635479
1,167.0,"Western Asia",599899,0,599899,448248,747080,"IRQ",597664
1,167.0,"Southern Europe",889333,0,889333,664311,1107186,"ITA",885749
1,167.0,"Eastern Africa",243449,0,243449,181527,302546,"ETH",242037
1,167.0,"Northern America",802506,778784,23722,582852,971421,"CAN",777137
1,167.0,"Northern Europe",1927704,1893984,33720,1579584,2632641,"GBR",2106113
1,167.0,"United States of America",2733503,2701728,31775,2023464,3372441,"USA",2697953
1,167.0,"Central Asia",1211774,1206733,5041,1105053,1841755,"UZB",1473404
1,167.0,"India",5833440,5833440,0,4548957,7581596,"IND",6065277
1,168.0,"Western Europe",3897573,3748199,149374,3104968,5174947,"NLD",4139958
1,168.0,"Western Africa",374197,0,374197,358696,597827,"NGA",478262
1,168.0,"Oceania",584082,568247,15835,452909,754848,"NZL",603879
1,168.0,"South America",1877751,1289925,587826,1423938,2373231,"BRA",1898585
1,168.0,"Northern Africa",1209250,0,1209250,1004696,1674493,"EGY",1339595
1,168.0,"Southern Asia",329070,0,329070,255829,426382,"IRN",341106
1,168.0,"Eastern Europe",3411898,3212691,199207,2373705,3956176,"POL",3164941
1,168.0,"Middle Africa",100318,0,100318,73038,121731,"AGO",97385
1,168.0,"Central America",540967,0,540967,391149,651916,"MEX",521533
1,168.0,"Southern Africa",114960,0,114960,88632,147721,"ZAF",118177
1,168.0,"South-Eastern Asia",1049884,0,1049884,702500,1170833,"IDN",936667
1,168.0,"China",7997632,7944846,52786,6345839,10576398,"CPR",8461119
1,168.0,"Pakistan",1702209,1563121,139088,1262535,2104225,"PAK",1683380
1,168.0,"Eastern Asia",840950,0,840950,590778,984630,"JPN",787704
1,168.0,"Russian Federation",3925904,3758896,167008,2288659,3814432,"RUS",3051546
1,168.0,"Western Asia",598059,0,598059,324147,540246,"IRQ",432197
1,168.0,"Southern Europe",885350,0,885350,847699,1412832,"ITA",1130266
1,168.0,"Eastern Africa",242281,0,242281,207168,345281,"ETH",276225
1,168.0,"Northern America",769334,748370,20964,490386,817310,"CAN",653848
1,168.0,"Northern Europe",1943921,1901929,41992,1532297,2553828,"GBR",2043063
1,168.0,"United States of America",2719280,2691586,27694,1890547,3150912,"USA",2520730
1,168.0,"Central Asia",1245973,1235463,10510,1152527,1920878,"UZB",1536703
1,168.0,"India",5771782,5771782,0,4151478,6919130,"IND",5535304
1,169.0,"Western Europe",3897578,3748204,149374,3104968,5174947,"NLD",4139958
1,169.0,"Western Africa",376061,0,376061,358696,597827,"NGA",478262
1,169.0,"Oceania",809188,791745,17443,452909,754848,"NZL",603879
1,169.0,"South America",2548823,1922247,626576,1423938,2373231,"BRA",1898585
1,169.0,"Northern Africa",1219475,0,1219475,1004696,1674493,"EGY",1339595
1,169.0,"Southern Asia",353150,0,353150,255829,426382,"IRN",341106
1,169.0,"Eastern Europe",3449531,3223734,225797,2373705,3956176,"POL",3164941
1,169.0,"Middle Africa",103111,0,103111,73038,121731,"AGO",97385
1,169.0,"Central America",539026,0,539026,391149,651916,"MEX",521533
1,169.0,"Southern Africa",121372,0,121372,88632,147721,"ZAF",118177
1,169.0,"South-Eastern Asia",1082194,0,1082194,702500,1170833,"IDN",936667
1,169.0,"China",8020810,7938012,82798,6345839,10576398,"CPR",8461119
1,169.0,"Pakistan",1705548,1561373,144175,1262535,2104225,"PAK",1683380
1,169.0,"Eastern Asia",896919,0,896919,590778,984630,"JPN",787704
1,169.0,"Russian Federation",3859886,3710415,149471,2288659,3814432,"RUS",3051546
1,169.0,"Western Asia",609496,0,609496,324147,540246,"IRQ",432197
1,169.0,"Southern Europe",883634,0,883634,847699,1412832,"ITA",1130266
1,169.0,"Eastern Africa",249505,0,249505,207168,345281,"ETH",276225
1,169.0,"Northern America",759574,740453,19121,490386,817310,"CAN",653848
1,169.0,"Northern Europe",1952039,1908271,43768,1532297,2553828,"GBR",2043063
1,169.0,"United States of America",2705068,2682201,22867,1890547,3150912,"USA",2520730
1,169.0,"Central Asia",1301775,1283277,18498,1152527,1920878,"UZB",1536703
1,169.0,"India",5771140,5770751,389,4151478,6919130,"IND",5535304
1,170.0,"Western Europe",3919850,3765062,154788,3104968,5174947,"NLD",4139958
1,170.0,"Western Africa",480006,0,480006,358696,597827,"NGA",478262
1,170.0,"Oceania",600001,587608,12393,452909,754848,"NZL",603879
1,170.0,"South America",2470491,1925579,544912,1423938,2373231,"BRA",1898585
1,170.0,"Northern Africa",1348422,0,1348422,1004696,1674493,"EGY",1339595
1,170.0,"Southern Asia",345015,0,345015,255829,426382,"IRN",341106
1,170.0,"Eastern Europe",3445771,3223267,222504,2373705,3956176,"POL",3164941
1,170.0,"Middle Africa",97777,0,97777,73038,121731,"AGO",97385
1,170.0,"Central America",524524,0,524524,391149,651916,"MEX",521533
1,170.0,"Southern Africa",119256,0,119256,88632,147721,"ZAF",118177
1,170.0,"South-Eastern Asia",942665,0,942665,702500,1170833,"IDN",936667
1,170.0,"China",8075785,7965247,110538,6345839,10576398,"CPR",8461119
1,170.0,"Pakistan",1706551,1563450,143101,1262535,2104225,"PAK",1683380
1,170.0,"Eastern Asia",823419,0,823419,590778,984630,"JPN",787704
1,170.0,"Russian Federation",3450149,3334623,115526,2288659,3814432,"RUS",3051546
1,170.0,"Western Asia",433782,0,433782,324147,540246,"IRQ",432197
1,170.0,"Southern Europe",1132052,0,1132052,847699,1412832,"ITA",1130266
1,170.0,"Eastern Africa",277264,0,277264,207168,345281,"ETH",276225
1,170.0,"Northern America",694831,679121,15710,490386,817310,"CAN",653848
1,170.0,"Northern Europe",1949805,1905042,44763,1532297,2553828,"GBR",2043063
1,170.0,"United States of America",2641635,2626159,15476,1890547,3150912,"USA",2520730
1,170.0,"Central Asia",1373668,1343447,30221,1152527,1920878,"UZB",1536703
1,170.0,"India",5790898,5775877,15021,4151478,6919130,"IND",5535304
1,171.0,"Western Europe",3985881,3826178,159703,3104968,5174947,"NLD",4139958
1,171.0,"Western Africa",479478,0,479478,358696,597827,"NGA",478262
1,171.0,"Oceania",592187,581554,10633,452909,754848,"NZL",603879
1,171.0,"South America",2410793,1925000,485793,1423938,2373231,"BRA",1898585
1,171.0,"Northern Africa",1346362,0,1346362,1004696,1674493,"EGY",1339595
1,171.0,"Southern Asia",343856,0,343856,255829,426382,"IRN",341106
1,171.0,"Eastern Europe",3463834,3234693,229141,2373705,3956176,"POL",3164941
1,171.0,"Middle Africa",97739,0,97739,73038,121731,"AGO",97385
1,171.0,"Central America",525441,0,525441,391149,651916,"MEX",521533
1,171.0,"Southern Africa",118943,0,118943,88632,147721,"ZAF",118177
1,171.0,"South-Eastern Asia",940447,0,940447,702500,1170833,"IDN",936667
1,171.0,"China",8119268,7982690,136578,6345839,10576398,"CPR",8461119
1,171.0,"Pakistan",1707240,1564622,142618,1262535,2104225,"PAK",1683380
1,171.0,"Eastern Asia",812138,0,812138,590778,984630,"JPN",787704
1,171.0,"Russian Federation",2972952,2874372,98580,2288659,3814432,"RUS",3051546
1,171.0,"Western Asia",433300,0,433300,324147,540246,"IRQ",432197
1,171.0,"Southern Europe",1132262,0,1132262,847699,1412832,"ITA",1130266
1,171.0,"Eastern Africa",276923,0,276923,207168,345281,"ETH",276225
1,171.0,"Northern America",677267,662549,14718,490386,817310,"CAN",653848
1,171.0,"Northern Europe",1957916,1912133,45783,1532297,2553828,"GBR",2043063
1,171.0,"United States of America",2634524,2618838,15686,1890547,3150912,"USA",2520730
1,171.0,"Central Asia",1433265,1389777,43488,1152527,1920878,"UZB",1536703
1,171.0,"India",5803710,5774070,29640,4151478,6919130,"IND",5535304
1,172.0,"Western Europe",4029902,3866759,163143,3104968,5174947,"NLD",4139958
1,172.0,"Western Africa",479977,0,479977,358696,597827,"NGA",478262
1,172.0,"Oceania",603877,594925,8952,452909,754848,"NZL",603879
1,172.0,"South America",2360364,1927269,433095,1423938,2373231,"BRA",1898585
1,172.0,"Northern Africa",1349461,0,1349461,1004696,1674493,"EGY",1339595
1,172.0,"Southern Asia",344708,0,344708,255829,426382,"IRN",341106
1,172.0,"Eastern Europe",3479499,3245713,233786,2373705,3956176,"POL",3164941
1,172.0,"Middle Africa",97769,0,97769,73038,121731,"AGO",97385
1,172.0,"Central America",525061,0,525061,391149,651916,"MEX",521533
1,172.0,"Southern Africa",119179,0,119179,88632,147721,"ZAF",118177
1,172.0,"South-Eastern Asia",941646,0,941646,702500,1170833,"IDN",936667
1,172.0,"China",8145619,7979650,165969,6345839,10576398,"CPR",8461119
1,172.0,"Pakistan",1707435,1565172,142263,1262535,2104225,"PAK",1683380
1,172.0,"Eastern Asia",808948,0,808948,590778,984630,"JPN",787704
1,172.0,"Russian Federation",3046558,2955739,90819,2288659,3814432,"RUS",3051546
1,172.0,"Western Asia",433750,0,433750,324147,540246,"IRQ",432197
1,172.0,"Southern Europe",1133077,0,1133077,847699,1412832,"ITA",1130266
1,172.0,"Eastern Africa",277346,0,277346,207168,345281,"ETH",276225
1,172.0,"Northern America",667509,655022,12487,490386,817310,"CAN",653848
1,172.0,"Northern Europe",1966024,1919310,46714,1532297,2553828,"GBR",2043063
1,172.0,"United States of America",2620298,2608516,11782,1890547,3150912,"USA",2520730
1,172.0,"Central Asia",1483356,1428709,54647,1152527,1920878,"UZB",1536703
1,172.0,"India",5525689,5481748,43941,4151478,6919130,"IND",5535304
1,173.0,"Western Europe",4059250,3893650,165600,3104968,5174947,"NLD",4139958
1,173.0,"Western Africa",480349,0,480349,358696,597827,"NGA",478262
1,173.0,"Oceania",609723,602582,7141,452909,754848,"NZL",603879
1,173.0,"South America",2310343,1929522,380821,1423938,2373231,"BRA",1898585
1,173.0,"Northern Africa",1351144,0,1351144,1004696,1674493,"EGY",1339595
1,173.0,"Southern Asia",345318,0,345318,255829,426382,"IRN",341106
1,173.0,"Eastern Europe",3495509,3258609,236900,2373705,3956176,"POL",3164941
1,173.0,"Middle Africa",97851,0,97851,73038,121731,"AGO",97385
1,173.0,"Central America",524995,0,524995,391149,651916,"MEX",521533
1,173.0,"Southern Africa",119349,0,119349,88632,147721,"ZAF",118177
1,173.0,"South-Eastern Asia",942485,0,942485,702500,1170833,"IDN",936667
1,173.0,"China",8195239,7994650,200589,6345839,10576398,"CPR",8461119
1,173.0,"Pakistan",1707777,1565546,142231,1262535,2104225,"PAK",1683380
1,173.0,"Eastern Asia",807536,0,807536,590778,984630,"JPN",787704
1,173.0,"Russian Federation",3104582,3021427,83155,2288659,3814432,"RUS",3051546
1,173.0,"Western Asia",434084,0,434084,324147,540246,"IRQ",432197
1,173.0,"Southern Europe",1133686,0,1133686,847699,1412832,"ITA",1130266
1,173.0,"Eastern Africa",277536,0,277536,207168,345281,"ETH",276225
1,173.0,"Northern America",665556,655163,10393,490386,817310,"CAN",653848
1,173.0,"Northern Europe",1982241,1929122,53119,1532297,2553828,"GBR",2043063
1,173.0,"United States of America",2606075,2601955,4120,1890547,3150912,"USA",2520730
1,173.0,"Central Asia",1527919,1463956,63963,1152527,1920878,"UZB",1536703
1,173.0,"India",5547730,5486743,60987,4151478,6919130,"IND",5535304
1,174.0,"Western Europe",4088598,3921196,167402,3104968,5174947,"NLD",4139958
1,174.0,"Western Africa",475954,0,475954,358696,597827,"NGA",478262
1,174.0,"Oceania",592192,586900,5292,452909,754848,"NZL",603879
1,174.0,"South America",2254990,1928972,326018,1423938,2373231,"BRA",1898585
1,174.0,"Northern Africa",1328622,0,1328622,1004696,1674493,"EGY",1339595
1,174.0,"Southern Asia",337116,0,337116,255829,426382,"IRN",341106
1,174.0,"Eastern Europe",3498407,3273101,225306,2373705,3956176,"POL",3164941
1,174.0,"Middle Africa",96878,0,96878,73038,121731,"AGO",97385
1,174.0,"Central America",519024,0,519024,391149,651916,"MEX",521533
1,174.0,"Southern Africa",117068,0,117068,88632,147721,"ZAF",118177
1,174.0,"South-Eastern Asia",931042,0,931042,702500,1170833,"IDN",936667
1,174.0,"China",8211845,7983498,228347,6345839,10576398,"CPR",8461119
1,174.0,"Pakistan",1670072,1530906,139166,1262535,2104225,"PAK",1683380
1,174.0,"Eastern Asia",785106,0,785106,590778,984630,"JPN",787704
1,174.0,"Russian Federation",2949616,2877776,71840,2288659,3814432,"RUS",3051546
1,174.0,"Western Asia",430110,0,430110,324147,540246,"IRQ",432197
1,174.0,"Southern Europe",1126474,0,1126474,847699,1412832,"ITA",1130266
1,174.0,"Eastern Africa",274975,0,274975,207168,345281,"ETH",276225
1,174.0,"Northern America",647997,639657,8340,490386,817310,"CAN",653848
1,174.0,"Northern Europe",2006571,1946494,60077,1532297,2553828,"GBR",2043063
1,174.0,"United States of America",2513618,2513618,0,1890547,3150912,"USA",2520730
1,174.0,"Central Asia",1557808,1489856,67952,1152527,1920878,"UZB",1536703
1,174.0,"India",5558896,5482211,76685,4151478,6919130,"IND",5535304
1,175.0,"Western Europe",4095935,3927387,168548,3104968,5174947,"NLD",4139958
1,175.0,"Western Africa",475442,0,475442,358696,597827,"NGA",478262
1,175.0,"Oceania",599006,595474,3532,452909,754848,"NZL",603879
1,175.0,"South America",2204026,1926927,277099,1423938,2373231,"BRA",1898585
1,175.0,"Northern Africa",1325376,0,1325376,1004696,1674493,"EGY",1339595
1,175.0,"Southern Asia",335923,0,335923,255829,426382,"IRN",341106
1,175.0,"Eastern Europe",3472375,3270056,202319,2373705,3956176,"POL",3164941
1,175.0,"Middle Africa",96760,0,96760,73038,121731,"AGO",97385
1,175.0,"Central America",517082,0,517082,391149,651916,"MEX",521533
1,175.0,"Southern Africa",116736,0,116736,88632,147721,"ZAF",118177
1,175.0,"South-Eastern Asia",929499,0,929499,702500,1170833,"IDN",936667
1,175.0,"China",8252429,7999915,252514,6345839,10576398,"CPR",8461119
1,175.0,"Pakistan",1669057,1530297,138760,1262535,2104225,"PAK",1683380
1,175.0,"Eastern Asia",778455,0,778455,590778,984630,"JPN",787704
1,175.0,"Russian Federation",3001792,2937848,63944,2288659,3814432,"RUS",3051546
1,175.0,"Western Asia",429644,0,429644,324147,540246,"IRQ",432197
1,175.0,"Southern Europe",1125750,0,1125750,847699,1412832,"ITA",1130266
1,175.0,"Eastern Africa",274611,0,274611,207168,345281,"ETH",276225
1,175.0,"Northern America",644090,637676,6414,490386,817310,"CAN",653848
1,175.0,"Northern Europe",2030896,1964143,66753,1532297,2553828,"GBR",2043063
1,175.0,"United States of America",2485170,2485170,0,1890547,3150912,"USA",2520730
1,175.0,"Central Asia",1599059,1528800,70259,1152527,1920878,"UZB",1536703
1,175.0,"India",5571581,5483850,87731,4151478,6919130,"IND",5535304
1,176.0,"Western Europe",4103272,3933742,169530,3104968,5174947,"NLD",4139958
1,176.0,"Western Africa",473519,0,473519,358696,597827,"NGA",478262
1,176.0,"Oceania",593163,591432,1731,452909,754848,"NZL",603879
1,176.0,"South America",2161423,1929408,232015,1423938,2373231,"BRA",1898585
1,176.0,"Northern Africa",1313950,0,1313950,1004696,1674493,"EGY",1339595
1,176.0,"Southern Asia",331759,0,331759,255829,426382,"IRN",341106
1,176.0,"Eastern Europe",4009660,3834629,175031,2373705,3956176,"POL",3164941
1,176.0,"Middle Africa",96332,0,96332,73038,121731,"AGO",97385
1,176.0,"Central America",513671,0,513671,391149,651916,"MEX",521533
1,176.0,"Southern Africa",115580,0,115580,88632,147721,"ZAF",118177
1,176.0,"South-Eastern Asia",923717,0,923717,702500,1170833,"IDN",936667
1,176.0,"China",8275839,7999059,276780,6345839,10576398,"CPR",8461119
1,176.0,"Pakistan",1664362,1527449,136913,1262535,2104225,"PAK",1683380
1,176.0,"Eastern Asia",766805,0,766805,590778,984630,"JPN",787704
1,176.0,"Russian Federation",2953159,2897843,55316,2288659,3814432,"RUS",3051546
1,176.0,"Western Asia",427902,0,427902,324147,540246,"IRQ",432197
1,176.0,"Southern Europe",1123480,0,1123480,847699,1412832,"ITA",1130266
1,176.0,"Eastern Africa",273317,0,273317,207168,345281,"ETH",276225
1,176.0,"Northern America",632384,627890,4494,490386,817310,"CAN",653848
1,176.0,"Northern Europe",2144424,2071344,73080,1532297,2553828,"GBR",2043063
1,176.0,"United States of America",2442498,2442498,0,1890547,3150912,"USA",2520730
1,176.0,"Central Asia",1633622,1564534,69088,1152527,1920878,"UZB",1536703
1,176.0,"India",5571309,5484713,86596,4151478,6919130,"IND",5535304
1,177.0,"Western Europe",4550820,4380472,170348,3104968,5174947,"NLD",4139958
1,177.0,"Western Africa",482590,0,482590,358696,597827,"NGA",478262
1,177.0,"Oceania",603878,603878,0,452909,754848,"NZL",603879
1,177.0,"South America",1961568,1771486,190082,1423938,2373231,"BRA",1898585
1,177.0,"Northern Africa",1359544,0,1359544,1004696,1674493,"EGY",1339595
1,177.0,"Southern Asia",348255,0,348255,255829,426382,"IRN",341106
1,177.0,"Eastern Europe",3956797,3824808,131989,2373705,3956176,"POL",3164941
1,177.0,"Middle Africa",98338,0,98338,73038,121731,"AGO",97385
1,177.0,"Central America",528227,0,528227,391149,651916,"MEX",521533
1,177.0,"Southern Africa",120168,0,120168,88632,147721,"ZAF",118177
1,177.0,"South-Eastern Asia",946766,0,946766,702500,1170833,"IDN",936667
1,177.0,"China",8566044,8260503,305541,6345839,10576398,"CPR",8461119
1,177.0,"Pakistan",1663023,1525684,137339,1262535,2104225,"PAK",1683380
1,177.0,"Eastern Asia",769135,0,769135,590778,984630,"JPN",787704
1,177.0,"Russian Federation",3045302,2998272,47030,2288659,3814432,"RUS",3051546
1,177.0,"Western Asia",436113,0,436113,324147,540246,"IRQ",432197
1,177.0,"Southern Europe",1137273,0,1137273,847699,1412832,"ITA",1130266
1,177.0,"Eastern Africa",278469,0,278469,207168,345281,"ETH",276225
1,177.0,"Northern America",618723,616140,2583,490386,817310,"CAN",653848
1,177.0,"Northern Europe",2168756,2091350,77406,1532297,2553828,"GBR",2043063
1,177.0,"United States of America",2478059,2478059,0,1890547,3150912,"USA",2520730
1,177.0,"Central Asia",1662290,1595220,67070,1152527,1920878,"UZB",1536703
1,177.0,"India",5559955,5483002,76953,4151478,6919130,"IND",5535304
1,178.0,"Western Europe",4462782,4301611,161171,3104968,5174947,"NLD",4139958
1,178.0,"Western Africa",484468,0,484468,358696,597827,"NGA",478262
1,178.0,"Oceania",610696,610696,0,452909,754848,"NZL",603879
1,178.0,"South America",1923432,1745829,177603,1423938,2373231,"BRA",1898585
1,178.0,"Northern Africa",1370919,0,1370919,1004696,1674493,"EGY",1339595
1,178.0,"Southern Asia",351854,0,351854,255829,426382,"IRN",341106
1,178.0,"Eastern Europe",3940851,3831885,108966,2373705,3956176,"POL",3164941
1,178.0,"Middle Africa",98759,0,98759,73038,121731,"AGO",97385
1,178.0,"Central America",531178,0,531178,391149,651916,"MEX",521533
1,178.0,"Southern Africa",121190,0,121190,88632,147721,"ZAF",118177
1,178.0,"South-Eastern Asia",951544,0,951544,702500,1170833,"IDN",936667
1,178.0,"China",8597230,8266406,330824,6345839,10576398,"CPR",8461119
1,178.0,"Pakistan",1670409,1528433,141976,1262535,2104225,"PAK",1683380
1,178.0,"Eastern Asia",784609,0,784609,590778,984630,"JPN",787704
1,178.0,"Russian Federation",3111748,3073829,37919,2288659,3814432,"RUS",3051546
1,178.0,"Western Asia",437816,0,437816,324147,540246,"IRQ",432197
1,178.0,"Southern Europe",1139875,0,1139875,847699,1412832,"ITA",1130266
1,178.0,"Eastern Africa",279889,0,279889,207168,345281,"ETH",276225
1,178.0,"Northern America",649944,646767,3177,490386,817310,"CAN",653848
1,178.0,"Northern Europe",2189027,2109458,79569,1532297,2553828,"GBR",2043063
1,178.0,"United States of America",2513618,2513618,0,1890547,3150912,"USA",2520730
1,178.0,"Central Asia",1725946,1659752,66194,1152527,1920878,"UZB",1536703
1,178.0,"India",5560187,5482305,77882,4151478,6919130,"IND",5535304
1,179.0,"Western Europe",4404087,4249611,154476,3104970,5174950,"NLD",4139960
1,179.0,"Western Africa",484810,0,484810,358704,597841,"NGA",478273
1,179.0,"Oceania",609725,609725,0,452916,754860,"NZL",603888
1,179.0,"South America",1920911,1749663,171248,1423942,2373237,"BRA",1898590
1,179.0,"Northern Africa",1372661,0,1372661,1004696,1674493,"EGY",1339595
1,179.0,"Southern Asia",352370,0,352370,255832,426387,"IRN",341110
1,179.0,"Eastern Europe",3933642,3837625,96017,2373708,3956180,"POL",3164944
1,179.0,"Middle Africa",98834,0,98834,73039,121732,"AGO",97386
1,179.0,"Central America",531821,0,531821,391153,651922,"MEX",521538
1,179.0,"Southern Africa",121303,0,121303,88632,147721,"ZAF",118177
1,179.0,"South-Eastern Asia",952210,0,952210,702507,1170846,"IDN",936677
1,179.0,"China",8641579,8286530,355049,6345846,10576410,"CPR",8461128
1,179.0,"Pakistan",1680131,1531901,148230,1262537,2104228,"PAK",1683383
1,179.0,"Eastern Asia",802052,0,802052,590779,984632,"JPN",787706
1,179.0,"Russian Federation",3107310,3078869,28441,2288663,3814438,"RUS",3051551
1,179.0,"Western Asia",438125,0,438125,324152,540253,"IRQ",432203
1,179.0,"Southern Europe",1140576,0,1140576,847700,1412833,"ITA",1130267
1,179.0,"Eastern Africa",279987,0,279987,207176,345293,"ETH",276235
1,179.0,"Northern America",661652,657472,4180,490392,817321,"CAN",653857
1,179.0,"Northern Europe",2221464,2138727,82737,1532301,2553836,"GBR",2043069
1,179.0,"United States of America",2534954,2534954,0,1890554,3150923,"USA",2520739
1,179.0,"Central Asia",1727479,1664236,63243,1152531,1920885,"UZB",1536708
1,179.0,"India",5572309,5491496,80813,4151484,6919141,"IND",5535313
1,180.0,"Western Europe",4352730,4192229,160501,3347390,5578983,"NLD",4463187
1,180.0,"Western Africa",484488,0,484488,359793,599655,"NGA",479724
1,180.0,"Oceania",601932,601932,0,523109,871848,"NZL",697479
1,180.0,"South America",1896594,1729547,167047,1553353,2588922,"BRA",2071138
1,180.0,"Northern Africa",1371020,0,1371020,1123390,1872317,"EGY",1497854
1,180.0,"Southern Asia",352310,0,352310,331722,552871,"IRN",442297
1,180.0,"Eastern Europe",3219834,3144746,75088,2270412,3784021,"POL",3027217
1,180.0,"Middle Africa",98764,0,98764,89043,148406,"AGO",118725
1,180.0,"Central America",532000,0,532000,381900,636501,"MEX",509201
1,180.0,"Southern Africa",121108,0,121108,76379,127298,"ZAF",101839
1,180.0,"South-Eastern Asia",951232,0,951232,810939,1351565,"IDN",1081252
1,180.0,"China",8684315,8308414,375901,6851757,11419595,"CPR",9135676
1,180.0,"Pakistan",1686215,1532924,153291,1431990,2386651,"PAK",1909321
1,180.0,"Eastern Asia",812955,0,812955,609777,1016296,"JPN",813037
1,180.0,"Russian Federation",3037773,3018688,19085,2363439,3939066,"RUS",3151253
1,180.0,"Western Asia",437831,0,437831,343455,572425,"IRQ",457940
1,180.0,"Southern Europe",1140830,0,1140830,758971,1264952,"ITA",1011962
1,180.0,"Eastern Africa",279800,0,279800,223113,371855,"ETH",297484
1,180.0,"Northern America",667509,663357,4152,517487,862478,"CAN",689983
1,180.0,"Northern Europe",2241738,2156760,84978,1612846,2688077,"GBR",2150462
1,180.0,"United States of America",2556289,2556289,0,1983710,3306183,"USA",2644947
1,180.0,"Central Asia",1727898,1667571,60327,1286442,2144071,"UZB",1715257
1,180.0,"India",5584219,5498117,86102,4796362,7993937,"IND",6395150
1,181.0,"Western Europe",4323383,4155074,168309,3347390,5578983,"NLD",4463187
1,181.0,"Western Africa",482195,0,482195,359793,599655,"NGA",479724
1,181.0,"Oceania",592198,592198,0,523109,871848,"NZL",697479
1,181.0,"South America",1861804,1698371,163433,1553353,2588922,"BRA",2071138
1,181.0,"Northern Africa",1359381,0,1359381,1123390,1872317,"EGY",1497854
1,181.0,"Southern Asia",348318,0,348318,331722,552871,"IRN",442297
1,181.0,"Eastern Europe",3071934,3005109,66825,2270412,3784021,"POL",3027217
1,181.0,"Middle Africa",98256,0,98256,89043,148406,"AGO",118725
1,181.0,"Central America",528962,0,528962,381900,636501,"MEX",509201
1,181.0,"Southern Africa",120223,0,120223,76379,127298,"ZAF",101839
1,181.0,"South-Eastern Asia",945268,0,945268,810939,1351565,"IDN",1081252
1,181.0,"China",8704541,8309795,394746,6851757,11419595,"CPR",9135676
1,181.0,"Pakistan",1702484,1543589,158895,1431990,2386651,"PAK",1909321
1,181.0,"Eastern Asia",802700,0,802700,609777,1016296,"JPN",813037
1,181.0,"Russian Federation",2946790,2937133,9657,2363439,3939066,"RUS",3151253
1,181.0,"Western Asia",435753,0,435753,343455,572425,"IRQ",457940
1,181.0,"Southern Europe",1138021,0,1138021,758971,1264952,"ITA",1011962
1,181.0,"Eastern Africa",278487,0,278487,223113,371855,"ETH",297484
1,181.0,"Northern America",669468,667410,2058,517487,862478,"CAN",689983
1,181.0,"Northern Europe",2249852,2163083,86769,1612846,2688077,"GBR",2150462
1,181.0,"United States of America",2513628,2513628,0,1983710,3306183,"USA",2644947
1,181.0,"Central Asia",1728985,1670341,58644,1286442,2144071,"UZB",1715257
1,181.0,"India",5596485,5508075,88410,4796362,7993937,"IND",6395150
1,182.0,"Western Europe",4338459,4152802,185657,3347390,5578983,"NLD",4463187
1,182.0,"Western Africa",474108,0,474108,359793,599655,"NGA",479724
1,182.0,"Oceania",702340,702340,0,523109,871848,"NZL",697479
1,182.0,"South America",2075836,1902697,173139,1553353,2588922,"BRA",2071138
1,182.0,"Northern Africa",1469466,0,1469466,1123390,1872317,"EGY",1497854
1,182.0,"Southern Asia",431952,0,431952,331722,552871,"IRN",442297
1,182.0,"Eastern Europe",3070764,3012778,57986,2270412,3784021,"POL",3027217
1,182.0,"Middle Africa",117478,0,117478,89043,148406,"AGO",118725
1,182.0,"Central America",498958,0,498958,381900,636501,"MEX",509201
1,182.0,"Southern Africa",98972,0,98972,76379,127298,"ZAF",101839
1,182.0,"South-Eastern Asia",1065291,0,1065291,810939,1351565,"IDN",1081252
1,182.0,"China",8753554,8319307,434247,6851757,11419595,"CPR",9135676
1,182.0,"Pakistan",1723640,1546210,177430,1431990,2386651,"PAK",1909321
1,182.0,"Eastern Asia",786581,0,786581,609777,1016296,"JPN",813037
1,182.0,"Russian Federation",3051708,3051497,211,2363439,3939066,"RUS",3151253
1,182.0,"Western Asia",452850,0,452850,343455,572425,"IRQ",457940
1,182.0,"Southern Europe",1004136,0,1004136,758971,1264952,"ITA",1011962
1,182.0,"Eastern Africa",294254,0,294254,223113,371855,"ETH",297484
1,182.0,"Northern America",660713,660713,0,517487,862478,"CAN",689983
1,182.0,"Northern Europe",2255882,2165166,90716,1612846,2688077,"GBR",2150462
1,182.0,"United States of America",2573827,2573827,0,1983710,3306183,"USA",2644947
1,182.0,"Central Asia",1729729,1669258,60471,1286442,2144071,"UZB",1715257
1,182.0,"India",5574440,5498224,76216,4796362,7993937,"IND",6395150
1,183.0,"Western Europe",4360469,4169367,191102,3347390,5578983,"NLD",4463187
1,183.0,"Western Africa",474633,0,474633,359793,599655,"NGA",479724
1,183.0,"Oceania",695532,695532,0,523109,871848,"NZL",697479
1,183.0,"South America",2061729,1898300,163429,1553353,2588922,"BRA",2071138
1,183.0,"Northern Africa",1472158,0,1472158,1123390,1872317,"EGY",1497854
1,183.0,"Southern Asia",432935,0,432935,331722,552871,"IRN",442297
1,183.0,"Eastern Europe",3013877,2964703,49174,2270412,3784021,"POL",3027217
1,183.0,"Middle Africa",117596,0,117596,89043,148406,"AGO",118725
1,183.0,"Central America",500010,0,500010,381900,636501,"MEX",509201
1,183.0,"Southern Africa",99236,0,99236,76379,127298,"ZAF",101839
1,183.0,"South-Eastern Asia",1067393,0,1067393,810939,1351565,"IDN",1081252
1,183.0,"China",8774766,8303655,471111,6851757,11419595,"CPR",9135676
1,183.0,"Pakistan",1749501,1554822,194679,1431990,2386651,"PAK",1909321
1,183.0,"Eastern Asia",788905,0,788905,609777,1016296,"JPN",813037
1,183.0,"Russian Federation",3015080,3015080,0,2363439,3939066,"RUS",3151253
1,183.0,"Western Asia",453330,0,453330,343455,572425,"IRQ",457940
1,183.0,"Southern Europe",1003686,0,1003686,758971,1264952,"ITA",1011962
1,183.0,"Eastern Africa",294558,0,294558,223113,371855,"ETH",297484
1,183.0,"Northern America",666566,666566,0,517487,862478,"CAN",689983
1,183.0,"Northern Europe",2247772,2159712,88060,1612846,2688077,"GBR",2150462
1,183.0,"United States of America",2580939,2580939,0,1983710,3306183,"USA",2644947
1,183.0,"Central Asia",1729422,1669462,59960,1286442,2144071,"UZB",1715257
1,183.0,"India",5623333,5518459,104874,4796362,7993937,"IND",6395150
1,184.0,"Western Europe",4389816,4182182,207634,3347390,5578983,"NLD",4463187
1,184.0,"Western Africa",474910,0,474910,359793,599655,"NGA",479724
1,184.0,"Oceania",683840,683840,0,523109,871848,"NZL",697479
1,184.0,"South America",2022434,1867085,155349,1553353,2588922,"BRA",2071138
1,184.0,"Northern Africa",1473555,0,1473555,1123390,1872317,"EGY",1497854
1,184.0,"Southern Asia",433442,0,433442,331722,552871,"IRN",442297
1,184.0,"Eastern Europe",2913817,2872817,41000,2270412,3784021,"POL",3027217
1,184.0,"Middle Africa",117658,0,117658,89043,148406,"AGO",118725
1,184.0,"Central America",501978,0,501978,381900,636501,"MEX",509201
1,184.0,"Southern Africa",99375,0,99375,76379,127298,"ZAF",101839
1,184.0,"South-Eastern Asia",1068116,0,1068116,810939,1351565,"IDN",1081252
1,184.0,"China",8815804,8311234,504570,6851757,11419595,"CPR",9135676
1,184.0,"Pakistan",1774932,1565320,209612,1431990,2386651,"PAK",1909321
1,184.0,"Eastern Asia",790154,0,790154,609777,1016296,"JPN",813037
1,184.0,"Russian Federation",3004098,3002399,1699,2363439,3939066,"RUS",3151253
1,184.0,"Western Asia",453583,0,453583,343455,572425,"IRQ",457940
1,184.0,"Southern Europe",1005295,0,1005295,758971,1264952,"ITA",1011962
1,184.0,"Eastern Africa",294719,0,294719,223113,371855,"ETH",297484
1,184.0,"Northern America",670470,670470,0,517487,862478,"CAN",689983
1,184.0,"Northern Europe",2247772,2158653,89119,1612846,2688077,"GBR",2150462
1,184.0,"United States of America",2588052,2588052,0,1983710,3306183,"USA",2644947
1,184.0,"Central Asia",1726811,1667188,59623,1286442,2144071,"UZB",1715257
1,184.0,"India",5538119,5404488,133631,4796362,7993937,"IND",6395150
1,185.0,"Western Europe",4404490,4181077,223413,3347390,5578983,"NLD",4463187
1,185.0,"Western Africa",475966,0,475966,359793,599655,"NGA",479724
1,185.0,"Oceania",695529,695529,0,523109,871848,"NZL",697479
1,185.0,"South America",2059891,1909381,150510,1553353,2588922,"BRA",2071138
1,185.0,"Northern Africa",1478886,0,1478886,1123390,1872317,"EGY",1497854
1,185.0,"Southern Asia",435383,0,435383,331722,552871,"IRN",442297
1,185.0,"Eastern Europe",3006206,2972691,33515,2270412,3784021,"POL",3027217
1,185.0,"Middle Africa",117892,0,117892,89043,148406,"AGO",118725
1,185.0,"Central America",502637,0,502637,381900,636501,"MEX",509201
1,185.0,"Southern Africa",99914,0,99914,76379,127298,"ZAF",101839
1,185.0,"South-Eastern Asia",1071206,0,1071206,810939,1351565,"IDN",1081252
1,185.0,"China",8864013,8323356,540657,6851757,11419595,"CPR",9135676
1,185.0,"Pakistan",1799040,1575027,224013,1431990,2386651,"PAK",1909321
1,185.0,"Eastern Asia",795149,0,795149,609777,1016296,"JPN",813037
1,185.0,"Russian Federation",3012058,3006718,5340,2363439,3939066,"RUS",3151253
1,185.0,"Western Asia",454535,0,454535,343455,572425,"IRQ",457940
1,185.0,"Southern Europe",1005892,0,1005892,758971,1264952,"ITA",1011962
1,185.0,"Eastern Africa",295324,0,295324,223113,371855,"ETH",297484
1,185.0,"Northern America",672420,672420,0,517487,862478,"CAN",689983
1,185.0,"Northern Europe",2235609,2149043,86566,1612846,2688077,"GBR",2150462
1,185.0,"United States of America",2588051,2588051,0,1983710,3306183,"USA",2644947
1,185.0,"Central Asia",1679680,1625453,54227,1286442,2144071,"UZB",1715257
1,185.0,"India",5562357,5396532,165825,4796362,7993937,"IND",6395150
1,186.0,"Western Europe",4419164,4180336,238828,3347390,5578983,"NLD",4463187
1,186.0,"Western Africa",477056,0,477056,359793,599655,"NGA",479724
1,186.0,"Oceania",698452,698452,0,523109,871848,"NZL",697479
1,186.0,"South America",2071947,1928713,143234,1553353,2588922,"BRA",2071138
1,186.0,"Northern Africa",1484416,0,1484416,1123390,1872317,"EGY",1497854
1,186.0,"Southern Asia",437400,0,437400,331722,552871,"IRN",442297
1,186.0,"Eastern Europe",3034925,3009745,25180,2270412,3784021,"POL",3027217
1,186.0,"Middle Africa",118133,0,118133,89043,148406,"AGO",118725
1,186.0,"Central America",504263,0,504263,381900,636501,"MEX",509201
1,186.0,"Southern Africa",100475,0,100475,76379,127298,"ZAF",101839
1,186.0,"South-Eastern Asia",1074428,0,1074428,810939,1351565,"IDN",1081252
1,186.0,"China",8887983,8311444,576539,6851757,11419595,"CPR",9135676
1,186.0,"Pakistan",1949074,1711407,237667,1431990,2386651,"PAK",1909321
1,186.0,"Eastern Asia",801202,0,801202,609777,1016296,"JPN",813037
1,186.0,"Russian Federation",3021221,3006384,14837,2363439,3939066,"RUS",3151253
1,186.0,"Western Asia",455528,0,455528,343455,572425,"IRQ",457940
1,186.0,"Southern Europe",1007405,0,1007405,758971,1264952,"ITA",1011962
1,186.0,"Eastern Africa",295953,0,295953,223113,371855,"ETH",297484
1,186.0,"Northern America",676324,676324,0,517487,862478,"CAN",689983
1,186.0,"Northern Europe",2227500,2145423,82077,1612846,2688077,"GBR",2150462
1,186.0,"United States of America",2602275,2602275,0,1983710,3306183,"USA",2644947
1,186.0,"Central Asia",1675303,1621323,53980,1286442,2144071,"UZB",1715257
1,186.0,"India",5599160,5399966,199194,4796362,7993937,"IND",6395150
1,187.0,"Western Europe",4433838,4180017,253821,3347390,5578983,"NLD",4463187
1,187.0,"Western Africa",477004,0,477004,359793,599655,"NGA",479724
1,187.0,"Oceania",689687,689687,0,523109,871848,"NZL",697479
1,187.0,"South America",2043058,1908138,134920,1553353,2588922,"BRA",2071138
1,187.0,"Northern Africa",1484124,0,1484124,1123390,1872317,"EGY",1497854
1,187.0,"Southern Asia",437293,0,437293,331722,552871,"IRN",442297
1,187.0,"Eastern Europe",2962652,2946652,16000,2270412,3784021,"POL",3027217
1,187.0,"Middle Africa",118118,0,118118,89043,148406,"AGO",118725
1,187.0,"Central America",505135,0,505135,381900,636501,"MEX",509201
1,187.0,"Southern Africa",100442,0,100442,76379,127298,"ZAF",101839
1,187.0,"South-Eastern Asia",1074280,0,1074280,810939,1351565,"IDN",1081252
1,187.0,"China",8908006,8326216,581790,6851757,11419595,"CPR",9135676
1,187.0,"Pakistan",1943772,1710809,232963,1431990,2386651,"PAK",1909321
1,187.0,"Eastern Asia",800945,0,800945,609777,1016296,"JPN",813037
1,187.0,"Russian Federation",3039116,3014297,24819,2363439,3939066,"RUS",3151253
1,187.0,"Western Asia",455477,0,455477,343455,572425,"IRQ",457940
1,187.0,"Southern Europe",1008204,0,1008204,758971,1264952,"ITA",1011962
1,187.0,"Eastern Africa",295918,0,295918,223113,371855,"ETH",297484
1,187.0,"Northern America",680225,679550,675,517487,862478,"CAN",689983
1,187.0,"Northern Europe",2142355,2068541,73814,1612846,2688077,"GBR",2150462
1,187.0,"United States of America",2609387,2609387,0,1983710,3306183,"USA",2644947
1,187.0,"Central Asia",1675154,1620318,54836,1286442,2144071,"UZB",1715257
1,187.0,"India",5684008,5451250,232758,4796362,7993937,"IND",6395150
1,188.0,"Western Europe",4448510,4180175,268335,3347390,5578983,"NLD",4463187
1,188.0,"Western Africa",477986,0,477986,359793,599655,"NGA",479724
1,188.0,"Oceania",698452,698452,0,523109,871848,"NZL",697479
1,188.0,"South America",2071342,1942343,128999,1553353,2588922,"BRA",2071138
1,188.0,"Northern Africa",1489082,0,1489082,1123390,1872317,"EGY",1497854
1,188.0,"Southern Asia",439100,0,439100,331722,552871,"IRN",442297
1,188.0,"Eastern Europe",2820882,2814265,6617,2270412,3784021,"POL",3027217
1,188.0,"Middle Africa",118333,0,118333,89043,148406,"AGO",118725
1,188.0,"Central America",505947,0,505947,381900,636501,"MEX",509201
1,188.0,"Southern Africa",100949,0,100949,76379,127298,"ZAF",101839
1,188.0,"South-Eastern Asia",1076800,0,1076800,810939,1351565,"IDN",1081252
1,188.0,"China",8911012,8322075,588937,6851757,11419595,"CPR",9135676
1,188.0,"Pakistan",1938228,1708610,229618,1431990,2386651,"PAK",1909321
1,188.0,"Eastern Asia",805311,0,805311,609777,1016296,"JPN",813037
1,188.0,"Russian Federation",3057565,3022662,34903,2363439,3939066,"RUS",3151253
1,188.0,"Western Asia",456364,0,456364,343455,572425,"IRQ",457940
1,188.0,"Southern Europe",1008957,0,1008957,758971,1264952,"ITA",1011962
1,188.0,"Eastern Africa",296485,0,296485,223113,371855,"ETH",297484
1,188.0,"Northern America",682176,680151,2025,517487,862478,"CAN",689983
1,188.0,"Northern Europe",2089642,2022106,67536,1612846,2688077,"GBR",2150462
1,188.0,"United States of America",2616500,2616500,0,1983710,3306183,"USA",2644947
1,188.0,"Central Asia",1675149,1619453,55696,1286442,2144071,"UZB",1715257
1,188.0,"India",5770062,5503922,266140,4796362,7993937,"IND",6395150
1,189.0,"Western Europe",4558563,4276250,282313,3347390,5578983,"NLD",4463187
1,189.0,"Western Africa",481222,0,481222,359793,599655,"NGA",479724
1,189.0,"Oceania",713066,713066,0,523109,871848,"NZL",697479
1,189.0,"South America",2122935,2010313,112622,1553353,2588922,"BRA",2071138
1,189.0,"Northern Africa",1505454,0,1505454,1123390,1872317,"EGY",1497854
1,189.0,"Southern Asia",445061,0,445061,331722,552871,"IRN",442297
1,189.0,"Eastern Europe",2781378,2778219,3159,2270412,3784021,"POL",3027217
1,189.0,"Middle Africa",119054,0,119054,89043,148406,"AGO",118725
1,189.0,"Central America",510101,0,510101,381900,636501,"MEX",509201
1,189.0,"Southern Africa",102603,0,102603,76379,127298,"ZAF",101839
1,189.0,"South-Eastern Asia",1085264,0,1085264,810939,1351565,"IDN",1081252
1,189.0,"China",9340066,8716751,623315,6851757,11419595,"CPR",9135676
1,189.0,"Pakistan",1947011,1708179,238832,1431990,2386651,"PAK",1909321
1,189.0,"Eastern Asia",820181,0,820181,609777,1016296,"JPN",813037
1,189.0,"Russian Federation",2861039,2805940,55099,2363439,3939066,"RUS",3151253
1,189.0,"Western Asia",459296,0,459296,343455,572425,"IRQ",457940
1,189.0,"Southern Europe",1012836,0,1012836,758971,1264952,"ITA",1011962
1,189.0,"Eastern Africa",298343,0,298343,223113,371855,"ETH",297484
1,189.0,"Northern America",810959,810959,0,517487,862478,"CAN",689983
1,189.0,"Northern Europe",2061261,1998996,62265,1612846,2688077,"GBR",2150462
1,189.0,"United States of America",2381804,2381804,0,1983710,3306183,"USA",2644947
1,189.0,"Central Asia",1676239,1618594,57645,1286442,2144071,"UZB",1715257
1,189.0,"India",5834100,5532846,301254,4796362,7993937,"IND",6395150
1,190.0,"Western Europe",4536558,4258089,278469,3347390,5578983,"NLD",4463187
1,190.0,"Western Africa",476802,0,476802,359793,599655,"NGA",479724
1,190.0,"Oceania",686766,686766,0,523109,871848,"NZL",697479
1,190.0,"South America",2095731,2000036,95695,1553353,2588922,"BRA",2071138
1,190.0,"Northern Africa",1483077,0,1483077,1123390,1872317,"EGY",1497854
1,190.0,"Southern Asia",436918,0,436918,331722,552871,"IRN",442297
1,190.0,"Eastern Europe",2776277,2766987,9290,2270412,3784021,"POL",3027217
1,190.0,"Middle Africa",118084,0,118084,89043,148406,"AGO",118725
1,190.0,"Central America",505211,0,505211,381900,636501,"MEX",509201
1,190.0,"Southern Africa",100348,0,100348,76379,127298,"ZAF",101839
1,190.0,"South-Eastern Asia",1074376,0,1074376,810939,1351565,"IDN",1081252
1,190.0,"China",9360713,8715869,644844,6851757,11419595,"CPR",9135676
1,190.0,"Pakistan",1945867,1709413,236454,1431990,2386651,"PAK",1909321
1,190.0,"Eastern Asia",801138,0,801138,609777,1016296,"JPN",813037
1,190.0,"Russian Federation",2915497,2840689,74808,2363439,3939066,"RUS",3151253
1,190.0,"Western Asia",455295,0,455295,343455,572425,"IRQ",457940
1,190.0,"Southern Europe",1008241,0,1008241,758971,1264952,"ITA",1011962
1,190.0,"Eastern Africa",295808,0,295808,223113,371855,"ETH",297484
1,190.0,"Northern America",707549,707549,0,517487,862478,"CAN",689983
1,190.0,"Northern Europe",2069369,2006399,62970,1612846,2688077,"GBR",2150462
1,190.0,"United States of America",2502707,2494320,8387,1983710,3306183,"USA",2644947
1,190.0,"Central Asia",1936118,1876815,59303,1286442,2144071,"UZB",1715257
1,190.0,"India",5882182,5547473,334709,4796362,7993937,"IND",6395150
1,191.0,"Western Europe",4507211,4231698,275513,3347397,5578995,"NLD",4463196
1,191.0,"Western Africa",476990,0,476990,359796,599661,"NGA",479729
1,191.0,"Oceania",688711,688711,0,523117,871862,"NZL",697490
1,191.0,"South America",2063510,1981180,82330,1553359,2588932,"BRA",2071146
1,191.0,"Northern Africa",1484056,0,1484056,1123397,1872328,"EGY",1497863
1,191.0,"Southern Asia",437266,0,437266,331728,552881,"IRN",442305
1,191.0,"Eastern Europe",2790026,2768301,21725,2270421,3784035,"POL",3027228
1,191.0,"Middle Africa",118118,0,118118,89048,148413,"AGO",118731
1,191.0,"Central America",505238,0,505238,381902,636503,"MEX",509203
1,191.0,"Southern Africa",100440,0,100440,76385,127308,"ZAF",101847
1,191.0,"South-Eastern Asia",1074781,0,1074781,810943,1351572,"IDN",1081258
1,191.0,"China",9378060,8717726,660334,6851760,11419601,"CPR",9135681
1,191.0,"Pakistan",1944329,1711664,232665,1431996,2386661,"PAK",1909329
1,191.0,"Eastern Asia",801766,0,801766,609784,1016307,"JPN",813046
1,191.0,"Russian Federation",2957442,2867855,89587,2363441,3939068,"RUS",3151255
1,191.0,"Western Asia",455462,0,455462,343459,572432,"IRQ",457946
1,191.0,"Southern Europe",1008292,0,1008292,758976,1264960,"ITA",1011968
1,191.0,"Eastern Africa",295912,0,295912,223120,371867,"ETH",297494
1,191.0,"Northern America",688032,688032,0,517488,862480,"CAN",689984
1,191.0,"Northern Europe",2073425,2008906,64519,1612849,2688082,"GBR",2150466
1,191.0,"United States of America",2559602,2542804,16798,1983714,3306191,"USA",2644953
1,191.0,"Central Asia",1770794,1722748,48046,1286448,2144081,"UZB",1715265
1,191.0,"India",5942002,5575546,366456,4796367,7993945,"IND",6395156
1,192.0,"Western Europe",4485201,4211460,273741,3249662,5416103,"NLD",4332883
1,192.0,"Western Africa",477238,0,477238,359637,599395,"NGA",479516
1,192.0,"Oceania",690659,690659,0,499062,831770,"NZL",665416
1,192.0,"South America",2050578,1977874,72704,1673476,2789127,"BRA",2231302
1,192.0,"Northern Africa",1485323,0,1485323,1325352,2208921,"EGY",1767137
1,192.0,"Southern Asia",437730,0,437730,286347,477245,"IRN",381796
1,192.0,"Eastern Europe",2813274,2780572,32702,2555124,4258541,"POL",3406833
1,192.0,"Middle Africa",118170,0,118170,76498,127497,"AGO",101998
1,192.0,"Central America",505812,0,505812,386002,643337,"MEX",514670
1,192.0,"Southern Africa",100567,0,100567,92132,153553,"ZAF",122843
1,192.0,"South-Eastern Asia",1075397,0,1075397,806738,1344563,"IDN",1075651
1,192.0,"China",9398107,8725481,672626,7272231,12120386,"CPR",9696309
1,192.0,"Pakistan",1937299,1708970,228329,1461924,2436541,"PAK",1949233
1,192.0,"Eastern Asia",802883,0,802883,618789,1031316,"JPN",825053
1,192.0,"Russian Federation",2992097,2890520,101577,2365446,3942411,"RUS",3153929
1,192.0,"Western Asia",455692,0,455692,587505,979175,"IRQ",783340
1,192.0,"Southern Europe",1008513,0,1008513,615924,1026540,"ITA",821232
1,192.0,"Eastern Africa",296056,0,296056,223472,372453,"ETH",297963
1,192.0,"Northern America",678275,678275,0,437985,729976,"CAN",583981
1,192.0,"Northern Europe",2077480,2011489,65991,1703042,2838403,"GBR",2270723
1,192.0,"United States of America",2595163,2570010,25153,1958160,3263601,"USA",2610881
1,192.0,"Central Asia",1702362,1661383,40979,1395879,2326466,"UZB",1861173
1,192.0,"India",5990429,5593744,396685,5295224,8825373,"IND",7060299
1,193.0,"Western Europe",4470535,4197680,272855,3249662,5416103,"NLD",4332883
1,193.0,"Western Africa",480608,0,480608,359637,599395,"NGA",479516
1,193.0,"Oceania",743272,743035,237,499062,831770,"NZL",665416
1,193.0,"South America",1712004,1647571,64433,1673476,2789127,"BRA",2231302
1,193.0,"Northern Africa",1502327,0,1502327,1325352,2208921,"EGY",1767137
1,193.0,"Southern Asia",443928,0,443928,286347,477245,"IRN",381796
1,193.0,"Eastern Europe",2829739,2785618,44121,2555124,4258541,"POL",3406833
1,193.0,"Middle Africa",118854,0,118854,76498,127497,"AGO",101998
1,193.0,"Central America",506118,0,506118,386002,643337,"MEX",514670
1,193.0,"Southern Africa",102292,0,102292,92132,153553,"ZAF",122843
1,193.0,"South-Eastern Asia",1084001,0,1084001,806738,1344563,"IDN",1075651
1,193.0,"China",9412395,8713070,699325,7272231,12120386,"CPR",9696309
1,193.0,"Pakistan",1944429,1715681,228748,1461924,2436541,"PAK",1949233
1,193.0,"Eastern Asia",817768,0,817768,618789,1031316,"JPN",825053
1,193.0,"Russian Federation",3027223,2906876,120347,2365446,3942411,"RUS",3153929
1,193.0,"Western Asia",458743,0,458743,587505,979175,"IRQ",783340
1,193.0,"Southern Europe",1008808,0,1008808,615924,1026540,"ITA",821232
1,193.0,"Eastern Africa",297996,0,297996,223472,372453,"ETH",297963
1,193.0,"Northern America",674373,674373,0,437985,729976,"CAN",583981
1,193.0,"Northern Europe",2081537,2014152,67385,1703042,2838403,"GBR",2270723
1,193.0,"United States of America",2616504,2583197,33307,1958160,3263601,"USA",2610881
1,193.0,"Central Asia",1637012,1601754,35258,1395879,2326466,"UZB",1861173
1,193.0,"India",6030837,5599045,431792,5295224,8825373,"IND",7060299
1,194.0,"Western Europe",4369571,4102264,267307,3249662,5416103,"NLD",4332883
1,194.0,"Western Africa",476162,0,476162,359637,599395,"NGA",479516
1,194.0,"Oceania",657629,657629,0,499062,831770,"NZL",665416
1,194.0,"South America",1755551,1650659,104892,1673476,2789127,"BRA",2231302
1,194.0,"Northern Africa",1750159,0,1750159,1325352,2208921,"EGY",1767137
1,194.0,"Southern Asia",375618,0,375618,286347,477245,"IRN",381796
1,194.0,"Eastern Europe",2790029,2726760,63269,2555124,4258541,"POL",3406833
1,194.0,"Middle Africa",101175,0,101175,76498,127497,"AGO",101998
1,194.0,"Central America",510221,0,510221,386002,643337,"MEX",514670
1,194.0,"Southern Africa",121122,0,121122,92132,153553,"ZAF",122843
1,194.0,"South-Eastern Asia",1068409,0,1068409,806738,1344563,"IDN",1075651
1,194.0,"China",9443652,8709006,734646,7272231,12120386,"CPR",9696309
1,194.0,"Pakistan",1950383,1723102,227281,1461924,2436541,"PAK",1949233
1,194.0,"Eastern Asia",812333,0,812333,618789,1031316,"JPN",825053
1,194.0,"Russian Federation",3030392,2901746,128646,2365446,3942411,"RUS",3153929
1,194.0,"Western Asia",780295,0,780295,587505,979175,"IRQ",783340
1,194.0,"Southern Europe",819289,0,819289,615924,1026540,"ITA",821232
1,194.0,"Eastern Africa",296039,0,296039,223472,372453,"ETH",297963
1,194.0,"Northern America",570326,570326,0,437985,729976,"CAN",583981
1,194.0,"Northern Europe",2092323,2021323,71000,1703042,2838403,"GBR",2270723
1,194.0,"United States of America",2539762,2498667,41095,1958160,3263601,"USA",2610881
1,194.0,"Central Asia",1584003,1549811,34192,1395879,2326466,"UZB",1861173
1,194.0,"India",6096917,5611272,485645,5295224,8825373,"IND",7060299
1,195.0,"Western Europe",4347560,4083808,263752,3249662,5416103,"NLD",4332883
1,195.0,"Western Africa",473233,0,473233,359637,599395,"NGA",479516
1,195.0,"Oceania",633269,633269,0,499062,831770,"NZL",665416
1,195.0,"South America",1797611,1652998,144613,1673476,2789127,"BRA",2231302
1,195.0,"Northern Africa",1735413,0,1735413,1325352,2208921,"EGY",1767137
1,195.0,"Southern Asia",370235,0,370235,286347,477245,"IRN",381796
1,195.0,"Eastern Europe",2833741,2753045,80696,2555124,4258541,"POL",3406833
1,195.0,"Middle Africa",100707,0,100707,76498,127497,"AGO",101998
1,195.0,"Central America",507784,0,507784,386002,643337,"MEX",514670
1,195.0,"Southern Africa",119563,0,119563,92132,153553,"ZAF",122843
1,195.0,"South-Eastern Asia",1060769,0,1060769,806738,1344563,"IDN",1075651
1,195.0,"China",9475065,8719136,755929,7272231,12120386,"CPR",9696309
1,195.0,"Pakistan",1949806,1728391,221415,1461924,2436541,"PAK",1949233
1,195.0,"Eastern Asia",799189,0,799189,618789,1031316,"JPN",825053
1,195.0,"Russian Federation",3004224,2885839,118385,2365446,3942411,"RUS",3153929
1,195.0,"Western Asia",777652,0,777652,587505,979175,"IRQ",783340
1,195.0,"Southern Europe",814088,0,814088,615924,1026540,"ITA",821232
1,195.0,"Eastern Africa",294308,0,294308,223472,372453,"ETH",297963
1,195.0,"Northern America",548858,548858,0,437985,729976,"CAN",583981
1,195.0,"Northern Europe",2100430,2026022,74408,1703042,2838403,"GBR",2270723
1,195.0,"United States of America",2546872,2497268,49604,1958160,3263601,"USA",2610881
1,195.0,"Central Asia",1577989,1540043,37946,1395879,2326466,"UZB",1861173
1,195.0,"India",6154359,5619345,535014,5295224,8825373,"IND",7060299
1,196.0,"Western Europe",4310877,4056295,254582,3249662,5416103,"NLD",4332883
1,196.0,"Western Africa",470623,0,470623,359637,599395,"NGA",479516
1,196.0,"Oceania",625474,625474,0,499062,831770,"NZL",665416
1,196.0,"South America",1834773,1656341,178432,1673476,2789127,"BRA",2231302
1,196.0,"Northern Africa",1722234,0,1722234,1325352,2208921,"EGY",1767137
1,196.0,"Southern Asia",365592,0,365592,286347,477245,"IRN",381796
1,196.0,"Eastern Europe",2911984,2810454,101530,2555124,4258541,"POL",3406833
1,196.0,"Middle Africa",100126,0,100126,76498,127497,"AGO",101998
1,196.0,"Central America",503910,0,503910,386002,643337,"MEX",514670
1,196.0,"Southern Africa",118491,0,118491,92132,153553,"ZAF",122843
1,196.0,"South-Eastern Asia",1053978,0,1053978,806738,1344563,"IDN",1075651
1,196.0,"China",9446551,8707030,739521,7272231,12120386,"CPR",9696309
1,196.0,"Pakistan",1942900,1727883,215017,1461924,2436541,"PAK",1949233
1,196.0,"Eastern Asia",787356,0,787356,618789,1031316,"JPN",825053
1,196.0,"Russian Federation",2981971,2876756,105215,2365446,3942411,"RUS",3153929
1,196.0,"Western Asia",775291,0,775291,587505,979175,"IRQ",783340
1,196.0,"Southern Europe",810504,0,810504,615924,1026540,"ITA",821232
1,196.0,"Eastern Africa",293095,0,293095,223472,372453,"ETH",297963
1,196.0,"Northern America",531296,531296,0,437985,729976,"CAN",583981
1,196.0,"Northern Europe",2108541,2030879,77662,1703042,2838403,"GBR",2270723
1,196.0,"United States of America",2532649,2474507,58142,1958160,3263601,"USA",2610881
1,196.0,"Central Asia",1573950,1533240,40710,1395879,2326466,"UZB",1861173
1,196.0,"India",6758560,6177496,581064,5295224,8825373,"IND",7060299
1,197.0,"Western Europe",4252174,4009784,242390,3249662,5416103,"NLD",4332883
1,197.0,"Western Africa",469238,0,469238,359637,599395,"NGA",479516
1,197.0,"Oceania",623526,623526,0,499062,831770,"NZL",665416
1,197.0,"South America",1871029,1658708,212321,1673476,2789127,"BRA",2231302
1,197.0,"Northern Africa",1715239,0,1715239,1325352,2208921,"EGY",1767137
1,197.0,"Southern Asia",363495,0,363495,286347,477245,"IRN",381796
1,197.0,"Eastern Europe",2992655,2874891,117764,2555124,4258541,"POL",3406833
1,197.0,"Middle Africa",99810,0,99810,76498,127497,"AGO",101998
1,197.0,"Central America",501535,0,501535,386002,643337,"MEX",514670
1,197.0,"Southern Africa",117764,0,117764,92132,153553,"ZAF",122843
1,197.0,"South-Eastern Asia",1050271,0,1050271,806738,1344563,"IDN",1075651
1,197.0,"China",9445449,8721615,723834,7272231,12120386,"CPR",9696309
1,197.0,"Pakistan",1930005,1724042,205963,1461924,2436541,"PAK",1949233
1,197.0,"Eastern Asia",781027,0,781027,618789,1031316,"JPN",825053
1,197.0,"Russian Federation",2956932,2862227,94705,2365446,3942411,"RUS",3153929
1,197.0,"Western Asia",774036,0,774036,587505,979175,"IRQ",783340
1,197.0,"Southern Europe",808369,0,808369,615924,1026540,"ITA",821232
1,197.0,"Eastern Africa",292284,0,292284,223472,372453,"ETH",297963
1,197.0,"Northern America",531295,531295,0,437985,729976,"CAN",583981
1,197.0,"Northern Europe",2112594,2031834,80760,1703042,2838403,"GBR",2270723
1,197.0,"United States of America",2525536,2458583,66953,1958160,3263601,"USA",2610881
1,197.0,"Central Asia",1576541,1533055,43486,1395879,2326466,"UZB",1861173
1,197.0,"India",6784240,6179090,605150,5295224,8825373,"IND",7060299
1,198.0,"Western Europe",4193478,3961285,232193,3249662,5416103,"NLD",4332883
1,198.0,"Western Africa",468940,0,468940,359637,599395,"NGA",479516
1,198.0,"Oceania",633266,633266,0,499062,831770,"NZL",665416
1,198.0,"South America",1902324,1661055,241269,1673476,2789127,"BRA",2231302
1,198.0,"Northern Africa",1710949,0,1710949,1325352,2208921,"EGY",1767137
1,198.0,"Southern Asia",361572,0,361572,286347,477245,"IRN",381796
1,198.0,"Eastern Europe",3023702,2906359,117343,2555124,4258541,"POL",3406833
1,198.0,"Middle Africa",99582,0,99582,76498,127497,"AGO",101998
1,198.0,"Central America",498618,0,498618,386002,643337,"MEX",514670
1,198.0,"Southern Africa",117229,0,117229,92132,153553,"ZAF",122843
1,198.0,"South-Eastern Asia",1047698,0,1047698,806738,1344563,"IDN",1075651
1,198.0,"China",9417679,8715311,702368,7272231,12120386,"CPR",9696309
1,198.0,"Pakistan",1961749,1763202,198547,1461924,2436541,"PAK",1949233
1,198.0,"Eastern Asia",776398,0,776398,618789,1031316,"JPN",825053
1,198.0,"Russian Federation",2942760,2853481,89279,2365446,3942411,"RUS",3153929
1,198.0,"Western Asia",773128,0,773128,587505,979175,"IRQ",783340
1,198.0,"Southern Europe",805722,0,805722,615924,1026540,"ITA",821232
1,198.0,"Eastern Africa",291690,0,291690,223472,372453,"ETH",297963
1,198.0,"Northern America",529344,529344,0,437985,729976,"CAN",583981
1,198.0,"Northern Europe",2120705,2036923,83782,1703042,2838403,"GBR",2270723
1,198.0,"United States of America",2511313,2435335,75978,1958160,3263601,"USA",2610881
1,198.0,"Central Asia",1610163,1566372,43791,1395879,2326466,"UZB",1861173
1,198.0,"India",6820095,6192127,627968,5295224,8825373,"IND",7060299
1,199.0,"Western Europe",4142122,3918356,223766,3249662,5416103,"NLD",4332883
1,199.0,"Western Africa",469187,0,469187,359637,599395,"NGA",479516
1,199.0,"Oceania",634241,634241,0,499062,831770,"NZL",665416
1,199.0,"South America",1930721,1664636,266085,1673476,2789127,"BRA",2231302
1,199.0,"Northern Africa",1714423,0,1714423,1325352,2208921,"EGY",1767137
1,199.0,"Southern Asia",360408,0,360408,286347,477245,"IRN",381796
1,199.0,"Eastern Europe",3006948,2892504,114444,2555124,4258541,"POL",3406833
1,199.0,"Middle Africa",99367,0,99367,76498,127497,"AGO",101998
1,199.0,"Central America",497328,0,497328,386002,643337,"MEX",514670
1,199.0,"Southern Africa",116906,0,116906,92132,153553,"ZAF",122843
1,199.0,"South-Eastern Asia",1046098,0,1046098,806738,1344563,"IDN",1075651
1,199.0,"China",9376219,8713082,663137,7272231,12120386,"CPR",9696309
1,199.0,"Pakistan",1950802,1761553,189249,1461924,2436541,"PAK",1949233
1,199.0,"Eastern Asia",773603,0,773603,618789,1031316,"JPN",825053
1,199.0,"Russian Federation",2916585,2840493,76092,2365446,3942411,"RUS",3153929
1,199.0,"Western Asia",772583,0,772583,587505,979175,"IRQ",783340
1,199.0,"Southern Europe",804586,0,804586,615924,1026540,"ITA",821232
1,199.0,"Eastern Africa",291328,0,291328,223472,372453,"ETH",297963
1,199.0,"Northern America",537150,537150,0,437985,729976,"CAN",583981
1,199.0,"Northern Europe",2124759,2038111,86648,1703042,2838403,"GBR",2270723
1,199.0,"United States of America",2504201,2418856,85345,1958160,3263601,"USA",2610881
1,199.0,"Central Asia",1696562,1644703,51859,1395879,2326466,"UZB",1861173
1,199.0,"India",6844068,6194795,649273,5295224,8825373,"IND",7060299
1,200.0,"Western Europe",4112774,3896113,216661,3249662,5416103,"NLD",4332883
1,200.0,"Western Africa",468588,0,468588,359637,599395,"NGA",479516
1,200.0,"Oceania",634241,634241,0,499062,831770,"NZL",665416
1,200.0,"South America",1952653,1665588,287065,1673476,2789127,"BRA",2231302
1,200.0,"Northern Africa",1711483,0,1711483,1325352,2208921,"EGY",1767137
1,200.0,"Southern Asia",359226,0,359226,286347,477245,"IRN",381796
1,200.0,"Eastern Europe",2535168,2421915,113253,2555124,4258541,"POL",3406833
1,200.0,"Middle Africa",99301,0,99301,76498,127497,"AGO",101998
1,200.0,"Central America",496177,0,496177,386002,643337,"MEX",514670
1,200.0,"Southern Africa",116578,0,116578,92132,153553,"ZAF",122843
1,200.0,"South-Eastern Asia",1044467,0,1044467,806738,1344563,"IDN",1075651
1,200.0,"China",9331655,8705821,625834,7272231,12120386,"CPR",9696309
1,200.0,"Pakistan",1937630,1757005,180625,1461924,2436541,"PAK",1949233
1,200.0,"Eastern Asia",770766,0,770766,618789,1031316,"JPN",825053
1,200.0,"Russian Federation",2889397,2825678,63719,2365446,3942411,"RUS",3153929
1,200.0,"Western Asia",772027,0,772027,587505,979175,"IRQ",783340
1,200.0,"Southern Europe",803571,0,803571,615924,1026540,"ITA",821232
1,200.0,"Eastern Africa",290965,0,290965,223472,372453,"ETH",297963
1,200.0,"Northern America",539100,539100,0,437985,729976,"CAN",583981
1,200.0,"Northern Europe",2132868,2038191,94677,1703042,2838403,"GBR",2270723
1,200.0,"United States of America",2497088,2402115,94973,1958160,3263601,"USA",2610881
1,200.0,"Central Asia",1758371,1701461,56910,1395879,2326466,"UZB",1861173
1,200.0,"India",6867979,6198538,669441,5295224,8825373,"IND",7060299
1,201.0,"Western Europe",3525825,3315770,210055,3249662,5416103,"NLD",4332883
1,201.0,"Western Africa",463339,0,463339,359637,599395,"NGA",479516
1,201.0,"Oceania",633267,633267,0,499062,831770,"NZL",665416
1,201.0,"South America",1973376,1666434,306942,1673476,2789127,"BRA",2231302
1,201.0,"Northern Africa",1684943,0,1684943,1325352,2208921,"EGY",1767137
1,201.0,"Southern Asia",349433,0,349433,286347,477245,"IRN",381796
1,201.0,"Eastern Europe",2578444,2481710,96734,2555124,4258541,"POL",3406833
1,201.0,"Middle Africa",98129,0,98129,76498,127497,"AGO",101998
1,201.0,"Central America",503076,0,503076,386002,643337,"MEX",514670
1,201.0,"Southern Africa",113855,0,113855,92132,153553,"ZAF",122843
1,201.0,"South-Eastern Asia",1030830,0,1030830,806738,1344563,"IDN",1075651
1,201.0,"China",9478669,8893713,584956,7272231,12120386,"CPR",9696309
1,201.0,"Pakistan",1927364,1754689,172675,1461924,2436541,"PAK",1949233
1,201.0,"Eastern Asia",776552,0,776552,618789,1031316,"JPN",825053
1,201.0,"Russian Federation",3174249,3130283,43966,2365446,3942411,"RUS",3153929
1,201.0,"Western Asia",767241,0,767241,587505,979175,"IRQ",783340
1,201.0,"Southern Europe",794969,0,794969,615924,1026540,"ITA",821232
1,201.0,"Eastern Africa",287910,0,287910,223472,372453,"ETH",297963
1,201.0,"Northern America",451295,451295,0,437985,729976,"CAN",583981
1,201.0,"Northern Europe",2140977,2036499,104478,1703042,2838403,"GBR",2270723
1,201.0,"United States of America",2838463,2733585,104878,1958160,3263601,"USA",2610881
1,201.0,"Central Asia",1741882,1699532,42350,1395879,2326466,"UZB",1861173
1,201.0,"India",6878137,6203466,674671,5295224,8825373,"IND",7060299
1,202.0,"Western Europe",3687236,3453740,233496,3249662,5416103,"NLD",4332883
1,202.0,"Western Africa",463428,0,463428,359637,599395,"NGA",479516
1,202.0,"Oceania",629371,629371,0,499062,831770,"NZL",665416
1,202.0,"South America",1999503,1668300,331203,1673476,2789127,"BRA",2231302
1,202.0,"Northern Africa",1685144,0,1685144,1325352,2208921,"EGY",1767137
1,202.0,"Southern Asia",349300,0,349300,286347,477245,"IRN",381796
1,202.0,"Eastern Europe",2602351,2516421,85930,2555124,4258541,"POL",3406833
1,202.0,"Middle Africa",98117,0,98117,76498,127497,"AGO",101998
1,202.0,"Central America",506682,0,506682,386002,643337,"MEX",514670
1,202.0,"Southern Africa",113826,0,113826,92132,153553,"ZAF",122843
1,202.0,"South-Eastern Asia",1031092,0,1031092,806738,1344563,"IDN",1075651
1,202.0,"China",9447328,8900154,547174,7272231,12120386,"CPR",9696309
1,202.0,"Pakistan",1897616,1732666,164950,1461924,2436541,"PAK",1949233
1,202.0,"Eastern Asia",791840,0,791840,618789,1031316,"JPN",825053
1,202.0,"Russian Federation",3130745,3111540,19205,2365446,3942411,"RUS",3153929
1,202.0,"Western Asia",767256,0,767256,587505,979175,"IRQ",783340
1,202.0,"Southern Europe",795256,0,795256,615924,1026540,"ITA",821232
1,202.0,"Eastern Africa",287890,0,287890,223472,372453,"ETH",297963
1,202.0,"Northern America",509828,507904,1924,437985,729976,"CAN",583981
1,202.0,"Northern Europe",2145031,2030745,114286,1703042,2838403,"GBR",2270723
1,202.0,"United States of America",2639330,2546122,93208,1958160,3263601,"USA",2610881
1,202.0,"Central Asia",1776489,1749245,27244,1395879,2326466,"UZB",1861173
1,202.0,"India",6895605,6210631,684974,5295224,8825373,"IND",7060299
1,203.0,"Western Europe",3789953,3537703,252250,3249668,5416113,"NLD",4332891
1,203.0,"Western Africa",462595,0,462595,359642,599403,"NGA",479523
1,203.0,"Oceania",632291,630231,2060,499070,831783,"NZL",665427
1,203.0,"South America",2018149,1669751,348398,1673484,2789141,"BRA",2231313
1,203.0,"Northern Africa",1681610,0,1681610,1325358,2208931,"EGY",1767145
1,203.0,"Southern Asia",348062,0,348062,286354,477257,"IRN",381806
1,203.0,"Eastern Europe",2618339,2536173,82166,2555124,4258541,"POL",3406833
1,203.0,"Middle Africa",97967,0,97967,76498,127497,"AGO",101998
1,203.0,"Central America",502471,0,502471,386009,643348,"MEX",514679
1,203.0,"Southern Africa",113480,0,113480,92135,153558,"ZAF",122847
1,203.0,"South-Eastern Asia",1048872,0,1048872,806738,1344563,"IDN",1075651
1,203.0,"China",9407693,8888537,519156,7272233,12120388,"CPR",9696311
1,203.0,"Pakistan",1887917,1728847,159070,1461925,2436542,"PAK",1949234
1,203.0,"Eastern Asia",783002,0,783002,618789,1031316,"JPN",825053
1,203.0,"Russian Federation",3107475,3098296,9179,2365451,3942418,"RUS",3153935
1,203.0,"Western Asia",766659,0,766659,587507,979178,"IRQ",783343
1,203.0,"Southern Europe",793885,0,793885,615925,1026542,"ITA",821234
1,203.0,"Eastern Africa",287502,0,287502,223479,372465,"ETH",297972
1,203.0,"Northern America",527391,523531,3860,437985,729976,"CAN",583981
1,203.0,"Northern Europe",2149085,2024912,124173,1703042,2838403,"GBR",2270723
1,203.0,"United States of America",2518426,2433489,84937,1958166,3263611,"USA",2610889
1,203.0,"Central Asia",1805501,1783420,22081,1395881,2326468,"UZB",1861175
1,203.0,"India",6915567,6225211,690356,5295231,8825385,"IND",7060308
1,204.0,"Western Europe",3855985,3587965,268020,2939467,4899112,"NLD",3919290
1,204.0,"Western Africa",461830,0,461830,284388,473981,"NGA",379185
1,204.0,"Oceania",635216,631044,4172,457577,762628,"NZL",610103
1,204.0,"South America",2031409,1670899,360510,1385751,2309586,"BRA",1847669
1,204.0,"Northern Africa",1677525,0,1677525,1205562,2009271,"EGY",1607417
1,204.0,"Southern Asia",346952,0,346952,459985,766642,"IRN",613314
1,204.0,"Eastern Europe",2623314,2540335,82979,2328807,3881345,"POL",3105076
1,204.0,"Middle Africa",97838,0,97838,75159,125266,"AGO",100213
1,204.0,"Central America",498407,0,498407,268749,447915,"MEX",358332
1,204.0,"Southern Africa",113174,0,113174,88366,147277,"ZAF",117822
1,204.0,"South-Eastern Asia",1046501,0,1046501,529293,882156,"IDN",705725
1,204.0,"China",9406746,8888089,518657,5876297,9793828,"CPR",7835063
1,204.0,"Pakistan",1880495,1726619,153876,1222523,2037538,"PAK",1630031
1,204.0,"Eastern Asia",773683,0,773683,502415,837358,"JPN",669887
1,204.0,"Russian Federation",3080261,3080261,0,2870600,4784333,"RUS",3827467
1,204.0,"Western Asia",766152,0,766152,706593,1177656,"IRQ",942125
1,204.0,"Southern Europe",792659,0,792659,541157,901928,"ITA",721543
1,204.0,"Eastern Africa",287159,0,287159,200997,334996,"ETH",267997
1,204.0,"Northern America",535197,529381,5816,363744,606240,"CAN",484992
1,204.0,"Northern Europe",2161248,2027124,134124,1404288,2340480,"GBR",1872384
1,204.0,"United States of America",2440193,2361792,78401,1873728,3122880,"USA",2498304
1,204.0,"Central Asia",1811365,1789138,22227,1086594,1810991,"UZB",1448793
1,204.0,"India",6921256,6220613,700643,4473415,7455692,"IND",5964554
1,205.0,"Western Europe",3907350,3625479,281871,2939467,4899112,"NLD",3919290
1,205.0,"Western Africa",461459,0,461459,284388,473981,"NGA",379185
1,205.0,"Oceania",227069,220915,6154,457577,762628,"NZL",610103
1,205.0,"South America",2026122,1658144,367978,1385751,2309586,"BRA",1847669
1,205.0,"Northern Africa",1675290,0,1675290,1205562,2009271,"EGY",1607417
1,205.0,"Southern Asia",317816,0,317816,459985,766642,"IRN",613314
1,205.0,"Eastern Europe",2662166,2564533,97633,2328807,3881345,"POL",3105076
1,205.0,"Middle Africa",92289,0,92289,75159,125266,"AGO",100213
1,205.0,"Central America",495488,0,495488,268749,447915,"MEX",358332
1,205.0,"Southern Africa",100323,0,100323,88366,147277,"ZAF",117822
1,205.0,"South-Eastern Asia",979364,0,979364,529293,882156,"IDN",705725
1,205.0,"China",9357160,8893829,463331,5876297,9793828,"CPR",7835063
1,205.0,"Pakistan",1869358,1723379,145979,1222523,2037538,"PAK",1630031
1,205.0,"Eastern Asia",656270,0,656270,502415,837358,"JPN",669887
1,205.0,"Russian Federation",3067379,3067379,0,2870600,4784333,"RUS",3827467
1,205.0,"Western Asia",743446,0,743446,706593,1177656,"IRQ",942125
1,205.0,"Southern Europe",792060,0,792060,541157,901928,"ITA",721543
1,205.0,"Eastern Africa",272730,0,272730,200997,334996,"ETH",267997
1,205.0,"Northern America",535197,527706,7491,363744,606240,"CAN",484992
1,205.0,"Northern Europe",2177467,2034782,142685,1404288,2340480,"GBR",1872384
1,205.0,"United States of America",2397529,2324458,73071,1873728,3122880,"USA",2498304
1,205.0,"Central Asia",1803459,1784951,18508,1086594,1810991,"UZB",1448793
1,205.0,"India",6881433,6219658,661775,4473415,7455692,"IND",5964554
1,206.0,"Western Europe",3867930,3577529,290401,2939467,4899112,"NLD",3919290
1,206.0,"Western Africa",382225,0,382225,284388,473981,"NGA",379185
1,206.0,"Oceania",452380,441768,10612,457577,762628,"NZL",610103
1,206.0,"South America",2013221,1655949,357272,1385751,2309586,"BRA",1847669
1,206.0,"Northern Africa",1611323,0,1611323,1205562,2009271,"EGY",1607417
1,206.0,"Southern Asia",581662,0,581662,459985,766642,"IRN",613314
1,206.0,"Eastern Europe",2733641,2603176,130465,2328807,3881345,"POL",3105076
1,206.0,"Middle Africa",97948,0,97948,75159,125266,"AGO",100213
1,206.0,"Central America",379555,0,379555,268749,447915,"MEX",358332
1,206.0,"Southern Africa",112515,0,112515,88366,147277,"ZAF",117822
1,206.0,"South-Eastern Asia",716618,0,716618,529293,882156,"IDN",705725
1,206.0,"China",9331669,8897341,434328,5876297,9793828,"CPR",7835063
1,206.0,"Pakistan",1814434,1682099,132335,1222523,2037538,"PAK",1630031
1,206.0,"Eastern Asia",627722,0,627722,502415,837358,"JPN",669887
1,206.0,"Russian Federation",3097042,3097042,0,2870600,4784333,"RUS",3827467
1,206.0,"Western Asia",933893,0,933893,706593,1177656,"IRQ",942125
1,206.0,"Southern Europe",723377,0,723377,541157,901928,"ITA",721543
1,206.0,"Eastern Africa",262337,0,262337,200997,334996,"ETH",267997
1,206.0,"Northern America",520117,511444,8673,363744,606240,"CAN",484992
1,206.0,"Northern Europe",2160257,2025778,134479,1404288,2340480,"GBR",1872384
1,206.0,"United States of America",2448520,2381796,66724,1873728,3122880,"USA",2498304
1,206.0,"Central Asia",1791352,1779676,11676,1086594,1810991,"UZB",1448793
1,206.0,"India",6827096,6219504,607592,4473415,7455692,"IND",5964554
1,207.0,"Western Europe",3889939,3586187,303752,2939467,4899112,"NLD",3919290
1,207.0,"Western Africa",379011,0,379011,284388,473981,"NGA",379185
1,207.0,"Oceania",518535,504866,13669,457577,762628,"NZL",610103
1,207.0,"South America",2004397,1658674,345723,1385751,2309586,"BRA",1847669
1,207.0,"Northern Africa",1606200,0,1606200,1205562,2009271,"EGY",1607417
1,207.0,"Southern Asia",609648,0,609648,459985,766642,"IRN",613314
1,207.0,"Eastern Europe",2802654,2639824,162830,2328807,3881345,"POL",3105076
1,207.0,"Middle Africa",98803,0,98803,75159,125266,"AGO",100213
1,207.0,"Central America",360554,0,360554,268749,447915,"MEX",358332
1,207.0,"Southern Africa",114376,0,114376,88366,147277,"ZAF",117822
1,207.0,"South-Eastern Asia",691517,0,691517,529293,882156,"IDN",705725
1,207.0,"China",9280111,8887441,392670,5876297,9793828,"CPR",7835063
1,207.0,"Pakistan",1718994,1598045,120949,1222523,2037538,"PAK",1630031
1,207.0,"Eastern Asia",636298,0,636298,502415,837358,"JPN",669887
1,207.0,"Russian Federation",3186606,3159143,27463,2870600,4784333,"RUS",3827467
1,207.0,"Western Asia",936862,0,936862,706593,1177656,"IRQ",942125
1,207.0,"Southern Europe",721126,0,721126,541157,901928,"ITA",721543
1,207.0,"Eastern Africa",264164,0,264164,200997,334996,"ETH",267997
1,207.0,"Northern America",494750,484845,9905,363744,606240,"CAN",484992
1,207.0,"Northern Europe",2139983,2013248,126735,1404288,2340480,"GBR",1872384
1,207.0,"United States of America",2462743,2403011,59732,1873728,3122880,"USA",2498304
1,207.0,"Central Asia",1794618,1786214,8404,1086594,1810991,"UZB",1448793
1,207.0,"India",6783784,6222597,561187,4473415,7455692,"IND",5964554
1,208.0,"Western Europe",3904613,3588158,316455,2939467,4899112,"NLD",3919290
1,208.0,"Western Africa",378525,0,378525,284388,473981,"NGA",379185
1,208.0,"Oceania",551655,535349,16306,457577,762628,"NZL",610103
1,208.0,"South America",1990061,1656214,333847,1385751,2309586,"BRA",1847669
1,208.0,"Northern Africa",1604067,0,1604067,1205562,2009271,"EGY",1607417
1,208.0,"Southern Asia",611743,0,611743,459985,766642,"IRN",613314
1,208.0,"Eastern Europe",2874894,2684978,189916,2328807,3881345,"POL",3105076
1,208.0,"Middle Africa",99114,0,99114,75159,125266,"AGO",100213
1,208.0,"Central America",356721,0,356721,268749,447915,"MEX",358332
1,208.0,"Southern Africa",115758,0,115758,88366,147277,"ZAF",117822
1,208.0,"South-Eastern Asia",692042,0,692042,529293,882156,"IDN",705725
1,208.0,"China",9220488,8873623,346865,5876297,9793828,"CPR",7835063
1,208.0,"Pakistan",1630111,1517058,113053,1222523,2037538,"PAK",1630031
1,208.0,"Eastern Asia",643957,0,643957,502415,837358,"JPN",669887
1,208.0,"Russian Federation",3264993,3207516,57477,2870600,4784333,"RUS",3827467
1,208.0,"Western Asia",941246,0,941246,706593,1177656,"IRQ",942125
1,208.0,"Southern Europe",720461,0,720461,541157,901928,"ITA",721543
1,208.0,"Eastern Africa",265142,0,265142,200997,334996,"ETH",267997
1,208.0,"Northern America",484994,473705,11289,363744,606240,"CAN",484992
1,208.0,"Northern Europe",2119711,2000174,119537,1404288,2340480,"GBR",1872384
1,208.0,"United States of America",2462743,2410191,52552,1873728,3122880,"USA",2498304
1,208.0,"Central Asia",1797652,1790049,7603,1086594,1810991,"UZB",1448793
1,208.0,"India",7222739,6703520,519219,4473415,7455692,"IND",5964554
1,209.0,"Western Europe",3911949,3595023,316926,2939467,4899112,"NLD",3919290
1,209.0,"Western Africa",378685,0,378685,284388,473981,"NGA",379185
1,209.0,"Oceania",576980,558273,18707,457577,762628,"NZL",610103
1,209.0,"South America",1980724,1656635,324089,1385751,2309586,"BRA",1847669
1,209.0,"Northern Africa",1604879,0,1604879,1205562,2009271,"EGY",1607417
1,209.0,"Southern Asia",612279,0,612279,459985,766642,"IRN",613314
1,209.0,"Eastern Europe",2940568,2727614,212954,2328807,3881345,"POL",3105076
1,209.0,"Middle Africa",99635,0,99635,75159,125266,"AGO",100213
1,209.0,"Central America",356335,0,356335,268749,447915,"MEX",358332
1,209.0,"Southern Africa",116548,0,116548,88366,147277,"ZAF",117822
1,209.0,"South-Eastern Asia",696308,0,696308,529293,882156,"IDN",705725
1,209.0,"China",9107993,8807198,300795,5876297,9793828,"CPR",7835063
1,209.0,"Pakistan",1633194,1520142,113052,1222523,2037538,"PAK",1630031
1,209.0,"Eastern Asia",652445,0,652445,502415,837358,"JPN",669887
1,209.0,"Russian Federation",3365067,3278612,86455,2870600,4784333,"RUS",3827467
1,209.0,"Western Asia",941643,0,941643,706593,1177656,"IRQ",942125
1,209.0,"Southern Europe",720740,0,720740,541157,901928,"ITA",721543
1,209.0,"Eastern Africa",266337,0,266337,200997,334996,"ETH",267997
1,209.0,"Northern America",483042,470299,12743,363744,606240,"CAN",484992
1,209.0,"Northern Europe",2099442,1986555,112887,1404288,2340480,"GBR",1872384
1,209.0,"United States of America",2469855,2424528,45327,1873728,3122880,"USA",2498304
1,209.0,"Central Asia",1807757,1796980,10777,1086594,1810991,"UZB",1448793
1,209.0,"India",7165457,6705712,459745,4473415,7455692,"IND",5964554
1,210.0,"Western Europe",3919285,3602126,317159,2939467,4899112,"NLD",3919290
1,210.0,"Western Africa",379087,0,379087,284388,473981,"NGA",379185
1,210.0,"Oceania",594515,573623,20892,457577,762628,"NZL",610103
1,210.0,"South America",1974743,1658811,315932,1385751,2309586,"BRA",1847669
1,210.0,"Northern Africa",1606919,0,1606919,1205562,2009271,"EGY",1607417
1,210.0,"Southern Asia",613065,0,613065,459985,766642,"IRN",613314
1,210.0,"Eastern Europe",2998719,2765819,232900,2328807,3881345,"POL",3105076
1,210.0,"Middle Africa",99983,0,99983,75159,125266,"AGO",100213
1,210.0,"Central America",356848,0,356848,268749,447915,"MEX",358332
1,210.0,"Southern Africa",117293,0,117293,88366,147277,"ZAF",117822
1,210.0,"South-Eastern Asia",700395,0,700395,529293,882156,"IDN",705725
1,210.0,"China",8401088,8142911,258177,5876297,9793828,"CPR",7835063
1,210.0,"Pakistan",1491441,1378493,112948,1222523,2037538,"PAK",1630031
1,210.0,"Eastern Asia",659944,0,659944,502415,837358,"JPN",669887
1,210.0,"Russian Federation",3447972,3335454,112518,2870600,4784333,"RUS",3827467
1,210.0,"Western Asia",942025,0,942025,706593,1177656,"IRQ",942125
1,210.0,"Southern Europe",721398,0,721398,541157,901928,"ITA",721543
1,210.0,"Eastern Africa",267405,0,267405,200997,334996,"ETH",267997
1,210.0,"Northern America",481089,466875,14214,363744,606240,"CAN",484992
1,210.0,"Northern Europe",2079168,1972387,106781,1404288,2340480,"GBR",1872384
1,210.0,"United States of America",2484078,2438537,45541,1873728,3122880,"USA",2498304
1,210.0,"Central Asia",1689309,1679738,9571,1086594,1810991,"UZB",1448793
1,210.0,"India",7112193,6701830,410363,4473415,7455692,"IND",5964554
1,211.0,"Western Europe",3919289,3602130,317159,2939467,4899112,"NLD",3919290
1,211.0,"Western Africa",379498,0,379498,284388,473981,"NGA",379185
1,211.0,"Oceania",608154,585250,22904,457577,762628,"NZL",610103
1,211.0,"South America",1965528,1656541,308987,1385751,2309586,"BRA",1847669
1,211.0,"Northern Africa",1609006,0,1609006,1205562,2009271,"EGY",1607417
1,211.0,"Southern Asia",613874,0,613874,459985,766642,"IRN",613314
1,211.0,"Eastern Europe",3048722,2798554,250168,2328807,3881345,"POL",3105076
1,211.0,"Middle Africa",100251,0,100251,75159,125266,"AGO",100213
1,211.0,"Central America",357736,0,357736,268749,447915,"MEX",358332
1,211.0,"Southern Africa",117918,0,117918,88366,147277,"ZAF",117822
1,211.0,"South-Eastern Asia",704191,0,704191,529293,882156,"IDN",705725
1,211.0,"China",7796816,7569868,226948,5876297,9793828,"CPR",7835063
1,211.0,"Pakistan",1500188,1382555,117633,1222523,2037538,"PAK",1630031
1,211.0,"Eastern Asia",666820,0,666820,502415,837358,"JPN",669887
1,211.0,"Russian Federation",3531087,3393955,137132,2870600,4784333,"RUS",3827467
1,211.0,"Western Asia",942403,0,942403,706593,1177656,"IRQ",942125
1,211.0,"Southern Europe",722062,0,722062,541157,901928,"ITA",721543
1,211.0,"Eastern Africa",268107,0,268107,200997,334996,"ETH",267997
1,211.0,"Northern America",484990,469284,15706,363744,606240,"CAN",484992
1,211.0,"Northern Europe",2058895,1957674,101221,1404288,2340480,"GBR",1872384
1,211.0,"United States of America",2491190,2445543,45647,1873728,3122880,"USA",2498304
1,211.0,"Central Asia",1453320,1448536,4784,1086594,1810991,"UZB",1448793
1,211.0,"India",7075443,6700172,375271,4473415,7455692,"IND",5964554
1,212.0,"Western Europe",3919289,3602130,317159,2939467,4899112,"NLD",3919290
1,212.0,"Western Africa",380302,0,380302,284388,473981,"NGA",379185
1,212.0,"Oceania",618869,594111,24758,457577,762628,"NZL",610103
1,212.0,"South America",1960193,1655893,304300,1385751,2309586,"BRA",1847669
1,212.0,"Northern Africa",1613061,0,1613061,1205562,2009271,"EGY",1607417
1,212.0,"Southern Asia",615406,0,615406,459985,766642,"IRN",613314
1,212.0,"Eastern Europe",4397245,4130943,266302,2328807,3881345,"POL",3105076
1,212.0,"Middle Africa",100576,0,100576,75159,125266,"AGO",100213
1,212.0,"Central America",358654,0,358654,268749,447915,"MEX",358332
1,212.0,"Southern Africa",118662,0,118662,88366,147277,"ZAF",117822
1,212.0,"South-Eastern Asia",707498,0,707498,529293,882156,"IDN",705725
1,212.0,"China",8622318,8418408,203910,5876297,9793828,"CPR",7835063
1,212.0,"Pakistan",1513434,1391413,122021,1222523,2037538,"PAK",1630031
1,212.0,"Eastern Asia",674942,0,674942,502415,837358,"JPN",669887
1,212.0,"Russian Federation",3598189,3436780,161409,2870600,4784333,"RUS",3827467
1,212.0,"Western Asia",943143,0,943143,706593,1177656,"IRQ",942125
1,212.0,"Southern Europe",723369,0,723369,541157,901928,"ITA",721543
1,212.0,"Eastern Africa",268940,0,268940,200997,334996,"ETH",267997
1,212.0,"Northern America",488893,471733,17160,363744,606240,"CAN",484992
1,212.0,"Northern Europe",2172421,2076216,96205,1404288,2340480,"GBR",1872384
1,212.0,"United States of America",2498302,2452603,45699,1873728,3122880,"USA",2498304
1,212.0,"Central Asia",1548653,1548215,438,1086594,1810991,"UZB",1448793
1,212.0,"India",7051277,6709264,342013,4473415,7455692,"IND",5964554
1,213.0,"Western Europe",4579606,4262447,317159,2939467,4899112,"NLD",3919290
1,213.0,"Western Africa",389338,0,389338,284388,473981,"NGA",379185
1,213.0,"Oceania",637381,610910,26471,457577,762628,"NZL",610103
1,213.0,"South America",1951570,1656737,294833,1385751,2309586,"BRA",1847669
1,213.0,"Northern Africa",1658720,0,1658720,1205562,2009271,"EGY",1607417
1,213.0,"Southern Asia",632130,0,632130,459985,766642,"IRN",613314
1,213.0,"Eastern Europe",4363073,4147136,215937,2328807,3881345,"POL",3105076
1,213.0,"Middle Africa",102816,0,102816,75159,125266,"AGO",100213
1,213.0,"Central America",354675,0,354675,268749,447915,"MEX",358332
1,213.0,"Southern Africa",123842,0,123842,88366,147277,"ZAF",117822
1,213.0,"South-Eastern Asia",704202,0,704202,529293,882156,"IDN",705725
1,213.0,"China",8530923,8359039,171884,5876297,9793828,"CPR",7835063
1,213.0,"Pakistan",1520696,1394734,125962,1222523,2037538,"PAK",1630031
1,213.0,"Eastern Asia",670011,0,670011,502415,837358,"JPN",669887
1,213.0,"Russian Federation",4902539,4725327,177212,2870600,4784333,"RUS",3827467
1,213.0,"Western Asia",951336,0,951336,706593,1177656,"IRQ",942125
1,213.0,"Southern Europe",738177,0,738177,541157,901928,"ITA",721543
1,213.0,"Eastern Africa",274756,0,274756,200997,334996,"ETH",267997
1,213.0,"Northern America",449872,431303,18569,363744,606240,"CAN",484992
1,213.0,"Northern Europe",2058894,1975907,82987,1404288,2340480,"GBR",1872384
1,213.0,"United States of America",2491191,2445492,45699,1873728,3122880,"USA",2498304
1,213.0,"Central Asia",1537133,1537133,0,1086594,1810991,"UZB",1448793
1,213.0,"India",7015719,6704992,310727,4473415,7455692,"IND",5964554
1,214.0,"Western Europe",4476897,4181064,295833,2939467,4899112,"NLD",3919290
1,214.0,"Western Africa",392416,0,392416,284388,473981,"NGA",379185
1,214.0,"Oceania",635433,607526,27907,457577,762628,"NZL",610103
1,214.0,"South America",1953229,1658663,294566,1385751,2309586,"BRA",1847669
1,214.0,"Northern Africa",1674662,0,1674662,1205562,2009271,"EGY",1607417
1,214.0,"Southern Asia",638949,0,638949,459985,766642,"IRN",613314
1,214.0,"Eastern Europe",4362189,4171527,190662,2328807,3881345,"POL",3105076
1,214.0,"Middle Africa",103408,0,103408,75159,125266,"AGO",100213
1,214.0,"Central America",362834,0,362834,268749,447915,"MEX",358332
1,214.0,"Southern Africa",125212,0,125212,88366,147277,"ZAF",117822
1,214.0,"South-Eastern Asia",716482,0,716482,529293,882156,"IDN",705725
1,214.0,"China",8504561,8362683,141878,5876297,9793828,"CPR",7835063
1,214.0,"Pakistan",1537163,1407336,129827,1222523,2037538,"PAK",1630031
1,214.0,"Eastern Asia",689443,0,689443,502415,837358,"JPN",669887
1,214.0,"Russian Federation",4939152,4781248,157904,2870600,4784333,"RUS",3827467
1,214.0,"Western Asia",954307,0,954307,706593,1177656,"IRQ",942125
1,214.0,"Southern Europe",742990,0,742990,541157,901928,"ITA",721543
1,214.0,"Eastern Africa",276298,0,276298,200997,334996,"ETH",267997
1,214.0,"Northern America",508403,487930,20473,363744,606240,"CAN",484992
1,214.0,"Northern Europe",2067002,1994036,72966,1404288,2340480,"GBR",1872384
1,214.0,"United States of America",2526749,2480999,45750,1873728,3122880,"USA",2498304
1,214.0,"Central Asia",1461806,1461806,0,1086594,1810991,"UZB",1448793
1,214.0,"India",6996082,6710334,285748,4473415,7455692,"IND",5964554
1,215.0,"Western Europe",4403526,4125703,277823,2939471,4899118,"NLD",3919295
1,215.0,"Western Africa",393608,0,393608,284388,473981,"NGA",379185
1,215.0,"Oceania",639330,609983,29347,457581,762635,"NZL",610108
1,215.0,"South America",1957638,1659249,298389,1385754,2309590,"BRA",1847672
1,215.0,"Northern Africa",1680833,0,1680833,1205568,2009280,"EGY",1607424
1,215.0,"Southern Asia",641651,0,641651,459987,766645,"IRN",613316
1,215.0,"Eastern Europe",4371189,4197632,173557,2328809,3881348,"POL",3105079
1,215.0,"Middle Africa",103704,0,103704,75161,125268,"AGO",100215
1,215.0,"Central America",368223,0,368223,268754,447923,"MEX",358339
1,215.0,"Southern Africa",125892,0,125892,88371,147285,"ZAF",117828
1,215.0,"South-Eastern Asia",725075,0,725075,529296,882161,"IDN",705729
1,215.0,"China",8481361,8368207,113154,5876304,9793840,"CPR",7835072
1,215.0,"Pakistan",1564020,1430449,133571,1222523,2037538,"PAK",1630031
1,215.0,"Eastern Asia",704115,0,704115,502417,837362,"JPN",669890
1,215.0,"Russian Federation",4991111,4848162,142949,2870605,4784342,"RUS",3827474
1,215.0,"Western Asia",955462,0,955462,706602,1177670,"IRQ",942136
1,215.0,"Southern Europe",744863,0,744863,541160,901933,"ITA",721547
1,215.0,"Eastern Africa",277061,0,277061,201002,335003,"ETH",268003
1,215.0,"Northern America",533776,512170,21606,363749,606248,"CAN",484999
1,215.0,"Northern Europe",1994022,1930914,63108,1404288,2340480,"GBR",1872384
1,215.0,"United States of America",2562315,2516778,45537,1873730,3122883,"USA",2498307
1,215.0,"Central Asia",1479654,1475603,4051,1086597,1810995,"UZB",1448796
1,215.0,"India",6971361,6710127,261234,4473419,7455698,"IND",5964559
1,216.0,"Western Europe",4344831,4082506,262325,2898592,4830987,"NLD",3864790
1,216.0,"Western Africa",394095,0,394095,350869,584782,"NGA",467826
1,216.0,"Oceania",645173,614475,30698,342706,571177,"NZL",456942
1,216.0,"South America",1963720,1659371,304349,1397424,2329041,"BRA",1863233
1,216.0,"Northern Africa",1683330,0,1683330,1103401,1839002,"EGY",1471202
1,216.0,"Southern Asia",642741,0,642741,658519,1097532,"IRN",878026
1,216.0,"Eastern Europe",4369608,4216396,153212,1995329,3325548,"POL",2660439
1,216.0,"Middle Africa",103878,0,103878,81811,136352,"AGO",109082
1,216.0,"Central America",371613,0,371613,258873,431455,"MEX",345164
1,216.0,"Southern Africa",126303,0,126303,81283,135472,"ZAF",108378
1,216.0,"South-Eastern Asia",737169,0,737169,686656,1144427,"IDN",915542
1,216.0,"China",8436392,8350735,85657,5931314,9885523,"CPR",7908419
1,216.0,"Pakistan",1631909,1490826,141083,1284760,2141267,"PAK",1713014
1,216.0,"Eastern Asia",718253,0,718253,514272,857120,"JPN",685696
1,216.0,"Russian Federation",4995329,4879239,116090,2457128,4095213,"RUS",3276171
1,216.0,"Western Asia",955925,0,955925,647355,1078925,"IRQ",863140
1,216.0,"Southern Europe",745625,0,745625,656247,1093746,"ITA",874997
1,216.0,"Eastern Africa",277522,0,277522,323487,539146,"ETH",431317
1,216.0,"Northern America",543533,521189,22344,403005,671675,"CAN",537340
1,216.0,"Northern Europe",1929149,1874073,55076,1395422,2325703,"GBR",1860563
1,216.0,"United States of America",2597872,2546045,51827,1761601,2936002,"USA",2348802
1,216.0,"Central Asia",1500351,1491963,8388,1190692,1984487,"UZB",1587590
1,216.0,"India",6946518,6709210,237308,4381509,7302516,"IND",5842013
1,217.0,"Western Europe",4278806,4030232,248574,2898592,4830987,"NLD",3864790
1,217.0,"Western Africa",394270,0,394270,350869,584782,"NGA",467826
1,217.0,"Oceania",785453,753985,31468,342706,571177,"NZL",456942
1,217.0,"South America",2869297,2557265,312032,1397424,2329041,"BRA",1863233
1,217.0,"Northern Africa",1684259,0,1684259,1103401,1839002,"EGY",1471202
1,217.0,"Southern Asia",643150,0,643150,658519,1097532,"IRN",878026
1,217.0,"Eastern Europe",4359476,4230806,128670,1995329,3325548,"POL",2660439
1,217.0,"Middle Africa",105793,0,105793,81811,136352,"AGO",109082
1,217.0,"Central America",374463,0,374463,258873,431455,"MEX",345164
1,217.0,"Southern Africa",130736,0,130736,81283,135472,"ZAF",108378
1,217.0,"South-Eastern Asia",770470,0,770470,686656,1144427,"IDN",915542
1,217.0,"China",8412295,8353048,59247,5931314,9885523,"CPR",7908419
1,217.0,"Pakistan",1674405,1528184,146221,1284760,2141267,"PAK",1713014
1,217.0,"Eastern Asia",782190,0,782190,514272,857120,"JPN",685696
1,217.0,"Russian Federation",5005787,4915140,90647,2457128,4095213,"RUS",3276171
1,217.0,"Western Asia",964309,0,964309,647355,1078925,"IRQ",863140
1,217.0,"Southern Europe",745905,0,745905,656247,1093746,"ITA",874997
1,217.0,"Eastern Africa",282502,0,282502,323487,539146,"ETH",431317
1,217.0,"Northern America",553297,530263,23034,403005,671675,"CAN",537340
1,217.0,"Northern Europe",1888604,1840121,48483,1395422,2325703,"GBR",1860563
1,217.0,"United States of America",2626326,2568436,57890,1761601,2936002,"USA",2348802
1,217.0,"Central Asia",1520724,1507864,12860,1190692,1984487,"UZB",1587590
1,217.0,"India",6509360,6311189,198171,4381509,7302516,"IND",5842013
1,218.0,"Western Europe",4114246,3879052,235194,2898592,4830987,"NLD",3864790
1,218.0,"Western Africa",476766,0,476766,350869,584782,"NGA",467826
1,218.0,"Oceania",612804,585853,26951,342706,571177,"NZL",456942
1,218.0,"South America",2774253,2554656,219597,1397424,2329041,"BRA",1863233
1,218.0,"Northern Africa",1536389,0,1536389,1103401,1839002,"EGY",1471202
1,218.0,"Southern Asia",915391,0,915391,658519,1097532,"IRN",878026
1,218.0,"Eastern Europe",4314479,4248639,65840,1995329,3325548,"POL",2660439
1,218.0,"Middle Africa",113638,0,113638,81811,136352,"AGO",109082
1,218.0,"Central America",361065,0,361065,258873,431455,"MEX",345164
1,218.0,"Southern Africa",118956,0,118956,81283,135472,"ZAF",108378
1,218.0,"South-Eastern Asia",968566,0,968566,686656,1144427,"IDN",915542
1,218.0,"China",8108269,8074096,34173,5931314,9885523,"CPR",7908419
1,218.0,"Pakistan",1680024,1525877,154147,1284760,2141267,"PAK",1713014
1,218.0,"Eastern Asia",777702,0,777702,514272,857120,"JPN",685696
1,218.0,"Russian Federation",4475039,4401684,73355,2457128,4095213,"RUS",3276171
1,218.0,"Western Asia",881863,0,881863,647355,1078925,"IRQ",863140
1,218.0,"Southern Europe",891514,0,891514,656247,1093746,"ITA",874997
1,218.0,"Eastern Africa",443188,0,443188,323487,539146,"ETH",431317
1,218.0,"Northern America",562371,537991,24380,403005,671675,"CAN",537340
1,218.0,"Northern Europe",1868675,1826213,42462,1395422,2325703,"GBR",1860563
1,218.0,"United States of America",2519491,2457635,61856,1761601,2936002,"USA",2348802
1,218.0,"Central Asia",1539811,1521613,18198,1190692,1984487,"UZB",1587590
1,218.0,"India",5906379,5739123,167256,4381509,7302516,"IND",5842013
1,219.0,"Western Europe",4099572,3872439,227133,2898592,4830987,"NLD",3864790
1,219.0,"Western Africa",482544,0,482544,350869,584782,"NGA",467826
1,219.0,"Oceania",581535,556245,25290,342706,571177,"NZL",456942
1,219.0,"South America",2595568,2457339,138229,1397424,2329041,"BRA",1863233
1,219.0,"Northern Africa",1546687,0,1546687,1103401,1839002,"EGY",1471202
1,219.0,"Southern Asia",918492,0,918492,658519,1097532,"IRN",878026
1,219.0,"Eastern Europe",3977177,3923203,53974,1995329,3325548,"POL",2660439
1,219.0,"Middle Africa",113944,0,113944,81811,136352,"AGO",109082
1,219.0,"Central America",365295,0,365295,258873,431455,"MEX",345164
1,219.0,"Southern Africa",119624,0,119624,81283,135472,"ZAF",108378
1,219.0,"South-Eastern Asia",971943,0,971943,686656,1144427,"IDN",915542
1,219.0,"China",7698936,7688651,10285,5931314,9885523,"CPR",7908419
1,219.0,"Pakistan",1704822,1537455,167367,1284760,2141267,"PAK",1713014
1,219.0,"Eastern Asia",783525,0,783525,514272,857120,"JPN",685696
1,219.0,"Russian Federation",3282610,3231924,50686,2457128,4095213,"RUS",3276171
1,219.0,"Western Asia",883050,0,883050,647355,1078925,"IRQ",863140
1,219.0,"Southern Europe",898942,0,898942,656247,1093746,"ITA",874997
1,219.0,"Eastern Africa",443948,0,443948,323487,539146,"ETH",431317
1,219.0,"Northern America",595882,570337,25545,403005,671675,"CAN",537340
1,219.0,"Northern Europe",1876784,1840013,36771,1395422,2325703,"GBR",1860563
1,219.0,"United States of America",2562163,2495370,66793,1761601,2936002,"USA",2348802
1,219.0,"Central Asia",1585108,1561619,23489,1190692,1984487,"UZB",1587590
1,219.0,"India",5726540,5573698,152842,4381509,7302516,"IND",5842013
1,220.0,"Western Europe",4084898,3865352,219546,2898592,4830987,"NLD",3864790
1,220.0,"Western Africa",484080,0,484080,350869,584782,"NGA",467826
1,220.0,"Oceania",565083,540885,24198,342706,571177,"NZL",456942
1,220.0,"South America",1890617,1805194,85423,1397424,2329041,"BRA",1863233
1,220.0,"Northern Africa",1553961,0,1553961,1103401,1839002,"EGY",1471202
1,220.0,"Southern Asia",919145,0,919145,658519,1097532,"IRN",878026
1,220.0,"Eastern Europe",2689810,2655515,34295,1995329,3325548,"POL",2660439
1,220.0,"Middle Africa",114022,0,114022,81811,136352,"AGO",109082
1,220.0,"Central America",368719,0,368719,258873,431455,"MEX",345164
1,220.0,"Southern Africa",119806,0,119806,81283,135472,"ZAF",108378
1,220.0,"South-Eastern Asia",972852,0,972852,686656,1144427,"IDN",915542
1,220.0,"China",7744798,7744798,0,5931314,9885523,"CPR",7908419
1,220.0,"Pakistan",1721694,1542745,178949,1284760,2141267,"PAK",1713014
1,220.0,"Eastern Asia",785105,0,785105,514272,857120,"JPN",685696
1,220.0,"Russian Federation",3215954,3175270,40684,2457128,4095213,"RUS",3276171
1,220.0,"Western Asia",883369,0,883369,647355,1078925,"IRQ",863140
1,220.0,"Southern Europe",901286,0,901286,656247,1093746,"ITA",874997
1,220.0,"Eastern Africa",444155,0,444155,323487,539146,"ETH",431317
1,220.0,"Northern America",609542,583502,26040,403005,671675,"CAN",537340
1,220.0,"Northern Europe",1848400,1817398,31002,1395422,2325703,"GBR",1860563
1,220.0,"United States of America",2590611,2519688,70923,1761601,2936002,"USA",2348802
1,220.0,"Central Asia",1626171,1597917,28254,1190692,1984487,"UZB",1587590
1,220.0,"India",5766667,5617233,149434,4381509,7302516,"IND",5842013
1,221.0,"Western Europe",4084899,3872465,212434,2898592,4830987,"NLD",3864790
1,221.0,"Western Africa",483874,0,483874,350869,584782,"NGA",467826
1,221.0,"Oceania",553388,531243,22145,342706,571177,"NZL",456942
1,221.0,"South America",1825277,1734830,90447,1397424,2329041,"BRA",1863233
1,221.0,"Northern Africa",1552954,0,1552954,1103401,1839002,"EGY",1471202
1,221.0,"Southern Asia",917372,0,917372,658519,1097532,"IRN",878026
1,221.0,"Eastern Europe",2532098,2506508,25590,1995329,3325548,"POL",2660439
1,221.0,"Middle Africa",113808,0,113808,81811,136352,"AGO",109082
1,221.0,"Central America",368745,0,368745,258873,431455,"MEX",345164
1,221.0,"Southern Africa",119313,0,119313,81283,135472,"ZAF",108378
1,221.0,"South-Eastern Asia",970379,0,970379,686656,1144427,"IDN",915542
1,221.0,"China",7549748,7549748,0,5931314,9885523,"CPR",7908419
1,221.0,"Pakistan",1745956,1549185,196771,1284760,2141267,"PAK",1713014
1,221.0,"Eastern Asia",780812,0,780812,514272,857120,"JPN",685696
1,221.0,"Russian Federation",3132368,3101704,30664,2457128,4095213,"RUS",3276171
1,221.0,"Western Asia",882495,0,882495,647355,1078925,"IRQ",863140
1,221.0,"Southern Europe",900900,0,900900,656247,1093746,"ITA",874997
1,221.0,"Eastern Africa",443599,0,443599,323487,539146,"ETH",431317
1,221.0,"Northern America",611492,585305,26187,403005,671675,"CAN",537340
1,221.0,"Northern Europe",1795689,1770153,25536,1395422,2325703,"GBR",1860563
1,221.0,"United States of America",2583500,2509164,74336,1761601,2936002,"USA",2348802
1,221.0,"Central Asia",1646581,1612499,34082,1190692,1984487,"UZB",1587590
1,221.0,"India",5658035,5513245,144790,4381509,7302516,"IND",5842013
1,222.0,"Western Europe",4077560,3872240,205320,2898592,4830987,"NLD",3864790
1,222.0,"Western Africa",483090,0,483090,350869,584782,"NGA",467826
1,222.0,"Oceania",538778,517295,21483,342706,571177,"NZL",456942
1,222.0,"South America",1807142,1701759,105383,1397424,2329041,"BRA",1863233
1,222.0,"Northern Africa",1548996,0,1548996,1103401,1839002,"EGY",1471202
1,222.0,"Southern Asia",914312,0,914312,658519,1097532,"IRN",878026
1,222.0,"Eastern Europe",2472917,2455333,17584,1995329,3325548,"POL",2660439
1,222.0,"Middle Africa",113443,0,113443,81811,136352,"AGO",109082
1,222.0,"Central America",368939,0,368939,258873,431455,"MEX",345164
1,222.0,"Southern Africa",118464,0,118464,81283,135472,"ZAF",108378
1,222.0,"South-Eastern Asia",966120,0,966120,686656,1144427,"IDN",915542
1,222.0,"China",7408749,7408749,0,5931314,9885523,"CPR",7908419
1,222.0,"Pakistan",1766144,1549579,216565,1284760,2141267,"PAK",1713014
1,222.0,"Eastern Asia",773421,0,773421,514272,857120,"JPN",685696
1,222.0,"Russian Federation",3074351,3052965,21386,2457128,4095213,"RUS",3276171
1,222.0,"Western Asia",880994,0,880994,647355,1078925,"IRQ",863140
1,222.0,"Southern Europe",899620,0,899620,656247,1093746,"ITA",874997
1,222.0,"Eastern Africa",442648,0,442648,323487,539146,"ETH",431317
1,222.0,"Northern America",605641,579438,26203,403005,671675,"CAN",537340
1,222.0,"Northern Europe",1771363,1750925,20438,1395422,2325703,"GBR",1860563
1,222.0,"United States of America",2576388,2498866,77522,1761601,2936002,"USA",2348802
1,222.0,"Central Asia",1556073,1523361,32712,1190692,1984487,"UZB",1587590
1,222.0,"India",5583049,5441432,141617,4381509,7302516,"IND",5842013
1,223.0,"Western Europe",4070225,3871780,198445,2898592,4830987,"NLD",3864790
1,223.0,"Western Africa",481895,0,481895,350869,584782,"NGA",467826
1,223.0,"Oceania",526113,505095,21018,342706,571177,"NZL",456942
1,223.0,"South America",1909003,1785647,123356,1397424,2329041,"BRA",1863233
1,223.0,"Northern Africa",1542923,0,1542923,1103401,1839002,"EGY",1471202
1,223.0,"Southern Asia",910746,0,910746,658519,1097532,"IRN",878026
1,223.0,"Eastern Europe",2724147,2710852,13295,1995329,3325548,"POL",2660439
1,223.0,"Middle Africa",113014,0,113014,81811,136352,"AGO",109082
1,223.0,"Central America",369611,0,369611,258873,431455,"MEX",345164
1,223.0,"Southern Africa",117473,0,117473,81283,135472,"ZAF",108378
1,223.0,"South-Eastern Asia",961145,0,961145,686656,1144427,"IDN",915542
1,223.0,"China",8089489,8081412,8077,5931314,9885523,"CPR",7908419
1,223.0,"Pakistan",1795836,1560557,235279,1284760,2141267,"PAK",1713014
1,223.0,"Eastern Asia",764797,0,764797,514272,857120,"JPN",685696
1,223.0,"Russian Federation",3353678,3326165,27513,2457128,4095213,"RUS",3276171
1,223.0,"Western Asia",879238,0,879238,647355,1078925,"IRQ",863140
1,223.0,"Southern Europe",897677,0,897677,656247,1093746,"ITA",874997
1,223.0,"Eastern Africa",441531,0,441531,323487,539146,"ETH",431317
1,223.0,"Northern America",595543,569288,26255,403005,671675,"CAN",537340
1,223.0,"Northern Europe",1884888,1869549,15339,1395422,2325703,"GBR",1860563
1,223.0,"United States of America",2555051,2480183,74868,1761601,2936002,"USA",2348802
1,223.0,"Central Asia",1618278,1582562,35716,1190692,1984487,"UZB",1587590
1,223.0,"India",5957237,5818412,138825,4381509,7302516,"IND",5842013
1,224.0,"Western Europe",4055551,3863744,191807,2898592,4830987,"NLD",3864790
1,224.0,"Western Africa",480377,0,480377,350869,584782,"NGA",467826
1,224.0,"Oceania",518320,497584,20736,342706,571177,"NZL",456942
1,224.0,"South America",1834394,1705559,128835,1397424,2329041,"BRA",1863233
1,224.0,"Northern Africa",1535210,0,1535210,1103401,1839002,"EGY",1471202
1,224.0,"Southern Asia",907154,0,907154,658519,1097532,"IRN",878026
1,224.0,"Eastern Europe",2562613,2545898,16715,1995329,3325548,"POL",2660439
1,224.0,"Middle Africa",112584,0,112584,81811,136352,"AGO",109082
1,224.0,"Central America",367031,0,367031,258873,431455,"MEX",345164
1,224.0,"Southern Africa",116475,0,116475,81283,135472,"ZAF",108378
1,224.0,"South-Eastern Asia",956079,0,956079,686656,1144427,"IDN",915542
1,224.0,"China",7633411,7610236,23175,5931314,9885523,"CPR",7908419
1,224.0,"Pakistan",1823877,1570626,253251,1284760,2141267,"PAK",1713014
1,224.0,"Eastern Asia",756113,0,756113,514272,857120,"JPN",685696
1,224.0,"Russian Federation",3169542,3143439,26103,2457128,4095213,"RUS",3276171
1,224.0,"Western Asia",877474,0,877474,647355,1078925,"IRQ",863140
1,224.0,"Southern Europe",895220,0,895220,656247,1093746,"ITA",874997
1,224.0,"Eastern Africa",440412,0,440412,323487,539146,"ETH",431317
1,224.0,"Northern America",589691,563231,26460,403005,671675,"CAN",537340
1,224.0,"Northern Europe",1815964,1806289,9675,1395422,2325703,"GBR",1860563
1,224.0,"United States of America",2533715,2469012,64703,1761601,2936002,"USA",2348802
1,224.0,"Central Asia",1558038,1519765,38273,1190692,1984487,"UZB",1587590
1,224.0,"India",5685111,5554558,130553,4381509,7302516,"IND",5842013
1,225.0,"Western Europe",4004194,3824533,179661,2898592,4830987,"NLD",3864790
1,225.0,"Western Africa",464658,0,464658,350869,584782,"NGA",467826
1,225.0,"Oceania",513447,492905,20542,342706,571177,"NZL",456942
1,225.0,"South America",1872159,1759251,112908,1397424,2329041,"BRA",1863233
1,225.0,"Northern Africa",1449581,0,1449581,1103401,1839002,"EGY",1471202
1,225.0,"Southern Asia",875535,0,875535,658519,1097532,"IRN",878026
1,225.0,"Eastern Europe",2728254,2702024,26230,1995329,3325548,"POL",2660439
1,225.0,"Middle Africa",108789,0,108789,81811,136352,"AGO",109082
1,225.0,"Central America",337320,0,337320,258873,431455,"MEX",345164
1,225.0,"Southern Africa",107689,0,107689,81283,135472,"ZAF",108378
1,225.0,"South-Eastern Asia",912082,0,912082,686656,1144427,"IDN",915542
1,225.0,"China",8082414,8049120,33294,5931314,9885523,"CPR",7908419
1,225.0,"Pakistan",1832221,1581320,250901,1284760,2141267,"PAK",1713014
1,225.0,"Eastern Asia",679614,0,679614,514272,857120,"JPN",685696
1,225.0,"Russian Federation",3344457,3312215,32242,2457128,4095213,"RUS",3276171
1,225.0,"Western Asia",861917,0,861917,647355,1078925,"IRQ",863140
1,225.0,"Southern Europe",867450,0,867450,656247,1093746,"ITA",874997
1,225.0,"Eastern Africa",430541,0,430541,323487,539146,"ETH",431317
1,225.0,"Northern America",576370,552712,23658,403005,671675,"CAN",537340
1,225.0,"Northern Europe",1888944,1884785,4159,1395422,2325703,"GBR",1860563
1,225.0,"United States of America",2035878,1980713,55165,1761601,2936002,"USA",2348802
1,225.0,"Central Asia",1610117,1571709,38408,1190692,1984487,"UZB",1587590
1,225.0,"India",5931927,5809254,122673,4381509,7302516,"IND",5842013
1,226.0,"Western Europe",3776751,3612535,164216,2898592,4830987,"NLD",3864790
1,226.0,"Western Africa",461385,0,461385,350869,584782,"NGA",467826
1,226.0,"Oceania",490069,470965,19104,342706,571177,"NZL",456942
1,226.0,"South America",1811968,1717879,94089,1397424,2329041,"BRA",1863233
1,226.0,"Northern Africa",1435147,0,1435147,1103401,1839002,"EGY",1471202
1,226.0,"Southern Asia",866181,0,866181,658519,1097532,"IRN",878026
1,226.0,"Eastern Europe",2561038,2549237,11801,1995329,3325548,"POL",2660439
1,226.0,"Middle Africa",107657,0,107657,81811,136352,"AGO",109082
1,226.0,"Central America",330147,0,330147,258873,431455,"MEX",345164
1,226.0,"Southern Africa",105084,0,105084,81283,135472,"ZAF",108378
1,226.0,"South-Eastern Asia",899378,0,899378,686656,1144427,"IDN",915542
1,226.0,"China",7651977,7643573,8404,5931314,9885523,"CPR",7908419
1,226.0,"Pakistan",1830773,1587975,242798,1284760,2141267,"PAK",1713014
1,226.0,"Eastern Asia",657639,0,657639,514272,857120,"JPN",685696
1,226.0,"Russian Federation",3166953,3155059,11894,2457128,4095213,"RUS",3276171
1,226.0,"Western Asia",857310,0,857310,647355,1078925,"IRQ",863140
1,226.0,"Southern Europe",861022,0,861022,656247,1093746,"ITA",874997
1,226.0,"Eastern Africa",427615,0,427615,323487,539146,"ETH",431317
1,226.0,"Northern America",513929,492709,21220,403005,671675,"CAN",537340
1,226.0,"Northern Europe",1811909,1811909,0,1395422,2325703,"GBR",1860563
1,226.0,"United States of America",2178112,2111145,66967,1761601,2936002,"USA",2348802
1,226.0,"Central Asia",1555188,1522019,33169,1190692,1984487,"UZB",1587590
1,226.0,"India",5699924,5593814,106110,4381509,7302516,"IND",5842013
1,227.0,"Western Europe",3813429,3658177,155252,2898600,4831001,"NLD",3864801
1,227.0,"Western Africa",463046,0,463046,350870,584783,"NGA",467827
1,227.0,"Oceania",466688,449736,16952,342706,571177,"NZL",456942
1,227.0,"South America",1831112,1745795,85317,1397427,2329045,"BRA",1863236
1,227.0,"Northern Africa",1447072,0,1447072,1103403,1839006,"EGY",1471205
1,227.0,"Southern Asia",869234,0,869234,658526,1097543,"IRN",878035
1,227.0,"Eastern Europe",2596822,2593627,3195,1995334,3325557,"POL",2660446
1,227.0,"Middle Africa",108021,0,108021,81814,136357,"AGO",109086
1,227.0,"Central America",335366,0,335366,258879,431465,"MEX",345172
1,227.0,"Southern Africa",105930,0,105930,81290,135483,"ZAF",108387
1,227.0,"South-Eastern Asia",903412,0,903412,686661,1144435,"IDN",915548
1,227.0,"China",7747859,7743698,4161,5931315,9885525,"CPR",7908420
1,227.0,"Pakistan",1827430,1592915,234515,1284765,2141275,"PAK",1713020
1,227.0,"Eastern Asia",664548,0,664548,514278,857131,"JPN",685705
1,227.0,"Russian Federation",3207499,3205394,2105,2457136,4095227,"RUS",3276182
1,227.0,"Western Asia",858811,0,858811,647355,1078926,"IRQ",863141
1,227.0,"Southern Europe",865975,0,865975,656254,1093757,"ITA",875006
1,227.0,"Eastern Africa",428571,0,428571,323494,539157,"ETH",431326
1,227.0,"Northern America",523677,503612,20065,403010,671683,"CAN",537347
1,227.0,"Northern Europe",1832181,1832181,0,1395426,2325711,"GBR",1860569
1,227.0,"United States of America",2235010,2158129,76881,1761603,2936006,"USA",2348805
1,227.0,"Central Asia",1567054,1538037,29017,1190693,1984488,"UZB",1587591
1,227.0,"India",5755846,5664913,90933,4381510,7302517,"IND",5842014
1,228.0,"Western Europe",3908810,3763624,145186,2858886,4764810,"NLD",3811848
1,228.0,"Western Africa",467460,0,467460,387831,646385,"NGA",517108
1,228.0,"Oceania",457918,442547,15371,476475,794125,"NZL",635300
1,228.0,"South America",1879793,1799292,80501,1521965,2536608,"BRA",2029287
1,228.0,"Northern Africa",1469368,0,1469368,1316664,2194441,"EGY",1755553
1,228.0,"Southern Asia",877355,0,877355,414039,690065,"IRN",552052
1,228.0,"Eastern Europe",2708759,2705150,3609,2250557,3750928,"POL",3000743
1,228.0,"Middle Africa",108999,0,108999,87425,145708,"AGO",116567
1,228.0,"Central America",344180,0,344180,371225,618708,"MEX",494967
1,228.0,"Southern Africa",108189,0,108189,92154,153591,"ZAF",122873
1,228.0,"South-Eastern Asia",914362,0,914362,784509,1307516,"IDN",1046013
1,228.0,"China",8037594,8032923,4671,6576264,10960441,"CPR",8768353
1,228.0,"Pakistan",1828278,1597804,230474,1369593,2282655,"PAK",1826124
1,228.0,"Eastern Asia",683570,0,683570,614727,1024545,"JPN",819636
1,228.0,"Russian Federation",3326542,3323039,3503,1776954,2961591,"RUS",2369273
1,228.0,"Western Asia",862809,0,862809,588156,980260,"IRQ",784208
1,228.0,"Southern Europe",874168,0,874168,615844,1026407,"ITA",821126
1,228.0,"Eastern Africa",431103,0,431103,332490,554150,"ETH",443320
1,228.0,"Northern America",549046,530348,18698,375213,625356,"CAN",500285
1,228.0,"Northern Europe",1884890,1884890,0,1523699,2539498,"GBR",2031599
1,228.0,"United States of America",2284793,2198779,86014,1817139,3028565,"USA",2422852
1,228.0,"Central Asia",1604336,1578853,25483,1233222,2055371,"UZB",1644297
1,228.0,"India",5913671,5839338,74333,4866416,8110693,"IND",6488555
1,229.0,"Western Europe",3828117,3695161,132956,2858886,4764810,"NLD",3811848
1,229.0,"Western Africa",465849,0,465849,387831,646385,"NGA",517108
1,229.0,"Oceania",456943,443495,13448,476475,794125,"NZL",635300
1,229.0,"South America",1760235,1689677,70558,1521965,2536608,"BRA",2029287
1,229.0,"Northern Africa",1461248,0,1461248,1316664,2194441,"EGY",1755553
1,229.0,"Southern Asia",874403,0,874403,414039,690065,"IRN",552052
1,229.0,"Eastern Europe",2622860,2622860,0,2250557,3750928,"POL",3000743
1,229.0,"Middle Africa",108646,0,108646,87425,145708,"AGO",116567
1,229.0,"Central America",341683,0,341683,371225,618708,"MEX",494967
1,229.0,"Southern Africa",107375,0,107375,92154,153591,"ZAF",122873
1,229.0,"South-Eastern Asia",910636,0,910636,784509,1307516,"IDN",1046013
1,229.0,"China",7804422,7804422,0,6576264,10960441,"CPR",8768353
1,229.0,"Pakistan",1824127,1601799,222328,1369593,2282655,"PAK",1826124
1,229.0,"Eastern Asia",677179,0,677179,614727,1024545,"JPN",819636
1,229.0,"Russian Federation",3236588,3236588,0,1776954,2961591,"RUS",2369273
1,229.0,"Western Asia",861350,0,861350,588156,980260,"IRQ",784208
1,229.0,"Southern Europe",871756,0,871756,615844,1026407,"ITA",821126
1,229.0,"Eastern Africa",430189,0,430189,332490,554150,"ETH",443320
1,229.0,"Northern America",527593,510587,17006,375213,625356,"CAN",500285
1,229.0,"Northern Europe",1840297,1840297,0,1523699,2539498,"GBR",2031599
1,229.0,"United States of America",2327467,2232913,94554,1817139,3028565,"USA",2422852
1,229.0,"Central Asia",1573802,1554054,19748,1233222,2055371,"UZB",1644297
1,229.0,"India",5782483,5728046,54437,4866416,8110693,"IND",6488555
1,230.0,"Western Europe",3848534,3718591,129943,2858886,4764810,"NLD",3811848
1,230.0,"Western Africa",513981,0,513981,387831,646385,"NGA",517108
1,230.0,"Oceania",640155,625695,14460,476475,794125,"NZL",635300
1,230.0,"South America",1770688,1689838,80850,1521965,2536608,"BRA",2029287
1,230.0,"Northern Africa",1739768,0,1739768,1316664,2194441,"EGY",1755553
1,230.0,"Southern Asia",546309,0,546309,414039,690065,"IRN",552052
1,230.0,"Eastern Europe",3026619,3018132,8487,2250557,3750928,"POL",3000743
1,230.0,"Middle Africa",115868,0,115868,87425,145708,"AGO",116567
1,230.0,"Central America",485136,0,485136,371225,618708,"MEX",494967
1,230.0,"Southern Africa",121272,0,121272,92154,153591,"ZAF",122873
1,230.0,"South-Eastern Asia",1037865,0,1037865,784509,1307516,"IDN",1046013
1,230.0,"China",8525792,8507353,18439,6576264,10960441,"CPR",8768353
1,230.0,"Pakistan",1853160,1623306,229854,1369593,2282655,"PAK",1826124
1,230.0,"Eastern Asia",805491,0,805491,614727,1024545,"JPN",819636
1,230.0,"Russian Federation",2476138,2476138,0,1776954,2961591,"RUS",2369273
1,230.0,"Western Asia",781387,0,781387,588156,980260,"IRQ",784208
1,230.0,"Southern Europe",816270,0,816270,615844,1026407,"ITA",821126
1,230.0,"Eastern Africa",441521,0,441521,332490,554150,"ETH",443320
1,230.0,"Northern America",510045,494951,15094,375213,625356,"CAN",500285
1,230.0,"Northern Europe",1946454,1946454,0,1523699,2539498,"GBR",2031599
1,230.0,"United States of America",2280611,2176747,103864,1817139,3028565,"USA",2422852
1,230.0,"Central Asia",1656841,1639885,16956,1233222,2055371,"UZB",1644297
1,230.0,"India",6540898,6500615,40283,4866416,8110693,"IND",6488555
1,231.0,"Western Europe",3745817,3628074,117743,2858886,4764810,"NLD",3811848
1,231.0,"Western Africa",511482,0,511482,387831,646385,"NGA",517108
1,231.0,"Oceania",626534,614047,12487,476475,794125,"NZL",635300
1,231.0,"South America",1791158,1694204,96954,1521965,2536608,"BRA",2029287
1,231.0,"Northern Africa",1727162,0,1727162,1316664,2194441,"EGY",1755553
1,231.0,"Southern Asia",541708,0,541708,414039,690065,"IRN",552052
1,231.0,"Eastern Europe",2929304,2929304,0,2250557,3750928,"POL",3000743
1,231.0,"Middle Africa",115318,0,115318,87425,145708,"AGO",116567
1,231.0,"Central America",485789,0,485789,371225,618708,"MEX",494967
1,231.0,"Southern Africa",119995,0,119995,92154,153591,"ZAF",122873
1,231.0,"South-Eastern Asia",1032034,0,1032034,784509,1307516,"IDN",1046013
1,231.0,"China",8538934,8538934,0,6576264,10960441,"CPR",8768353
1,231.0,"Pakistan",1850899,1622633,228266,1369593,2282655,"PAK",1826124
1,231.0,"Eastern Asia",795339,0,795339,614727,1024545,"JPN",819636
1,231.0,"Russian Federation",2299193,2299193,0,1776954,2961591,"RUS",2369273
1,231.0,"Western Asia",779117,0,779117,588156,980260,"IRQ",784208
1,231.0,"Southern Europe",812698,0,812698,615844,1026407,"ITA",821126
1,231.0,"Eastern Africa",440088,0,440088,332490,554150,"ETH",443320
1,231.0,"Northern America",482726,469263,13463,375213,625356,"CAN",500285
1,231.0,"Northern Europe",1966726,1960463,6263,1523699,2539498,"GBR",2031599
1,231.0,"United States of America",2337506,2223115,114391,1817139,3028565,"USA",2422852
1,231.0,"Central Asia",1619920,1607955,11965,1233222,2055371,"UZB",1644297
1,231.0,"India",6380203,6359497,20706,4866416,8110693,"IND",6488555
1,232.0,"Western Europe",3738478,3630927,107551,2858886,4764810,"NLD",3811848
1,232.0,"Western Africa",512106,0,512106,387831,646385,"NGA",517108
1,232.0,"Oceania",625556,614870,10686,476475,794125,"NZL",635300
1,232.0,"South America",1817513,1696733,120780,1521965,2536608,"BRA",2029287
1,232.0,"Northern Africa",1730312,0,1730312,1316664,2194441,"EGY",1755553
1,232.0,"Southern Asia",542856,0,542856,414039,690065,"IRN",552052
1,232.0,"Eastern Europe",2915384,2915384,0,2250557,3750928,"POL",3000743
1,232.0,"Middle Africa",115457,0,115457,87425,145708,"AGO",116567
1,232.0,"Central America",487001,0,487001,371225,618708,"MEX",494967
1,232.0,"Southern Africa",120313,0,120313,92154,153591,"ZAF",122873
1,232.0,"South-Eastern Asia",1033480,0,1033480,784509,1307516,"IDN",1046013
1,232.0,"China",8539487,8539487,0,6576264,10960441,"CPR",8768353
1,232.0,"Pakistan",1847323,1620818,226505,1369593,2282655,"PAK",1826124
1,232.0,"Eastern Asia",797806,0,797806,614727,1024545,"JPN",819636
1,232.0,"Russian Federation",2277564,2277564,0,1776954,2961591,"RUS",2369273
1,232.0,"Western Asia",779680,0,779680,588156,980260,"IRQ",784208
1,232.0,"Southern Europe",813765,0,813765,615844,1026407,"ITA",821126
1,232.0,"Eastern Africa",440445,0,440445,332490,554150,"ETH",443320
1,232.0,"Northern America",480769,468596,12173,375213,625356,"CAN",500285
1,232.0,"Northern Europe",1982943,1970332,12611,1523699,2539498,"GBR",2031599
1,232.0,"United States of America",2365955,2242217,123738,1817139,3028565,"USA",2422852
1,232.0,"Central Asia",1615607,1608504,7103,1233222,2055371,"UZB",1644297
1,232.0,"India",6365644,6364390,1254,4866416,8110693,"IND",6488555
1,233.0,"Western Europe",3811847,3714497,97350,2858886,4764810,"NLD",3811848
1,233.0,"Western Africa",518449,0,518449,387831,646385,"NGA",517108
1,233.0,"Oceania",651857,642981,8876,476475,794125,"NZL",635300
1,233.0,"South America",1853634,1701672,151962,1521965,2536608,"BRA",2029287
1,233.0,"Northern Africa",1762349,0,1762349,1316664,2194441,"EGY",1755553
1,233.0,"Southern Asia",554524,0,554524,414039,690065,"IRN",552052
1,233.0,"Eastern Europe",3134825,3133504,1321,2250557,3750928,"POL",3000743
1,233.0,"Middle Africa",116858,0,116858,87425,145708,"AGO",116567
1,233.0,"Central America",495363,0,495363,371225,618708,"MEX",494967
1,233.0,"Southern Africa",123555,0,123555,92154,153591,"ZAF",122873
1,233.0,"South-Eastern Asia",1049662,0,1049662,784509,1307516,"IDN",1046013
1,233.0,"China",8547570,8539512,8058,6576264,10960441,"CPR",8768353
1,233.0,"Pakistan",1855950,1622153,233797,1369593,2282655,"PAK",1826124
1,233.0,"Eastern Asia",825887,0,825887,614727,1024545,"JPN",819636
1,233.0,"Russian Federation",2509721,2509721,0,1776954,2961591,"RUS",2369273
1,233.0,"Western Asia",785423,0,785423,588156,980260,"IRQ",784208
1,233.0,"Southern Europe",821576,0,821576,615844,1026407,"ITA",821126
1,233.0,"Eastern Africa",444089,0,444089,332490,554150,"ETH",443320
1,233.0,"Northern America",533453,522575,10878,375213,625356,"CAN",500285
1,233.0,"Northern Europe",1995108,1976120,18988,1523699,2539498,"GBR",2031599
1,233.0,"United States of America",2373066,2240593,132473,1817139,3028565,"USA",2422852
1,233.0,"Central Asia",1690139,1687943,2196,1233222,2055371,"UZB",1644297
1,233.0,"India",6693024,6692856,168,4866416,8110693,"IND",6488555
1,234.0,"Western Europe",3811847,3721112,90735,2858886,4764810,"NLD",3811848
1,234.0,"Western Africa",517199,0,517199,387831,646385,"NGA",517108
1,234.0,"Oceania",637251,630408,6843,476475,794125,"NZL",635300
1,234.0,"South America",1882742,1703771,178971,1521965,2536608,"BRA",2029287
1,234.0,"Northern Africa",1755987,0,1755987,1316664,2194441,"EGY",1755553
1,234.0,"Southern Asia",552214,0,552214,414039,690065,"IRN",552052
1,234.0,"Eastern Europe",3024935,3024935,0,2250557,3750928,"POL",3000743
1,234.0,"Middle Africa",116589,0,116589,87425,145708,"AGO",116567
1,234.0,"Central America",494830,0,494830,371225,618708,"MEX",494967
1,234.0,"Southern Africa",122921,0,122921,92154,153591,"ZAF",122873
1,234.0,"South-Eastern Asia",1046376,0,1046376,784509,1307516,"IDN",1046013
1,234.0,"China",8588414,8557131,31283,6576264,10960441,"CPR",8768353
1,234.0,"Pakistan",2085932,1849512,236420,1369593,2282655,"PAK",1826124
1,234.0,"Eastern Asia",820285,0,820285,614727,1024545,"JPN",819636
1,234.0,"Russian Federation",2396883,2396883,0,1776954,2961591,"RUS",2369273
1,234.0,"Western Asia",784292,0,784292,588156,980260,"IRQ",784208
1,234.0,"Southern Europe",821081,0,821081,615844,1026407,"ITA",821126
1,234.0,"Eastern Africa",443374,0,443374,332490,554150,"ETH",443320
1,234.0,"Northern America",504191,495115,9076,375213,625356,"CAN",500285
1,234.0,"Northern Europe",2015380,1990018,25362,1523699,2539498,"GBR",2031599
1,234.0,"United States of America",2415738,2274643,141095,1817139,3028565,"USA",2422852
1,234.0,"Central Asia",1651746,1651746,0,1233222,2055371,"UZB",1644297
1,234.0,"India",6515899,6515899,0,4866416,8110693,"IND",6488555
1,235.0,"Western Europe",3804510,3719434,85076,2858886,4764810,"NLD",3811848
1,235.0,"Western Africa",517225,0,517225,387831,646385,"NGA",517108
1,235.0,"Oceania",635302,630374,4928,476475,794125,"NZL",635300
1,235.0,"South America",1905611,1702806,202805,1521965,2536608,"BRA",2029287
1,235.0,"Northern Africa",1756126,0,1756126,1316664,2194441,"EGY",1755553
1,235.0,"Southern Asia",552265,0,552265,414039,690065,"IRN",552052
1,235.0,"Eastern Europe",3002182,3002182,0,2250557,3750928,"POL",3000743
1,235.0,"Middle Africa",116596,0,116596,87425,145708,"AGO",116567
1,235.0,"Central America",495158,0,495158,371225,618708,"MEX",494967
1,235.0,"Southern Africa",122933,0,122933,92154,153591,"ZAF",122873
1,235.0,"South-Eastern Asia",1046247,0,1046247,784509,1307516,"IDN",1046013
1,235.0,"China",8609826,8552338,57488,6576264,10960441,"CPR",8768353
1,235.0,"Pakistan",1983138,1775557,207581,1369593,2282655,"PAK",1826124
1,235.0,"Eastern Asia",820040,0,820040,614727,1024545,"JPN",819636
1,235.0,"Russian Federation",2371297,2371297,0,1776954,2961591,"RUS",2369273
1,235.0,"Western Asia",784314,0,784314,588156,980260,"IRQ",784208
1,235.0,"Southern Europe",821305,0,821305,615844,1026407,"ITA",821126
1,235.0,"Eastern Africa",443388,0,443388,332490,554150,"ETH",443320
1,235.0,"Northern America",500287,492739,7548,375213,625356,"CAN",500285
1,235.0,"Northern Europe",2039707,2008097,31610,1523699,2539498,"GBR",2031599
1,235.0,"United States of America",2429962,2281397,148565,1817139,3028565,"USA",2422852
1,235.0,"Central Asia",1644609,1644609,0,1233222,2055371,"UZB",1644297
1,235.0,"India",6488969,6488969,0,4866416,8110693,"IND",6488555
1,236.0,"Western Europe",3804509,3724516,79993,2858886,4764810,"NLD",3811848
1,236.0,"Western Africa",517503,0,517503,387831,646385,"NGA",517108
1,236.0,"Oceania",633352,630329,3023,476475,794125,"NZL",635300
1,236.0,"South America",1928933,1704352,224581,1521965,2536608,"BRA",2029287
1,236.0,"Northern Africa",1757536,0,1757536,1316664,2194441,"EGY",1755553
1,236.0,"Southern Asia",552777,0,552777,414039,690065,"IRN",552052
1,236.0,"Eastern Europe",2984610,2984610,0,2250557,3750928,"POL",3000743
1,236.0,"Middle Africa",116655,0,116655,87425,145708,"AGO",116567
1,236.0,"Central America",495866,0,495866,371225,618708,"MEX",494967
1,236.0,"Southern Africa",123075,0,123075,92154,153591,"ZAF",122873
1,236.0,"South-Eastern Asia",1045906,0,1045906,784509,1307516,"IDN",1046013
1,236.0,"China",8652609,8567605,85004,6576264,10960441,"CPR",8768353
1,236.0,"Pakistan",1825565,1638216,187349,1369593,2282655,"PAK",1826124
1,236.0,"Eastern Asia",819737,0,819737,614727,1024545,"JPN",819636
1,236.0,"Russian Federation",2352108,2352108,0,1776954,2961591,"RUS",2369273
1,236.0,"Western Asia",784565,0,784565,588156,980260,"IRQ",784208
1,236.0,"Southern Europe",821971,0,821971,615844,1026407,"ITA",821126
1,236.0,"Eastern Africa",443551,0,443551,332490,554150,"ETH",443320
1,236.0,"Northern America",496383,490335,6048,375213,625356,"CAN",500285
1,236.0,"Northern Europe",2181617,2144005,37612,1523699,2539498,"GBR",2031599
1,236.0,"United States of America",2437078,2281457,155621,1817139,3028565,"USA",2422852
1,236.0,"Central Asia",1638777,1638777,0,1233222,2055371,"UZB",1644297
1,236.0,"India",6464307,6464307,0,4866416,8110693,"IND",6488555
1,237.0,"Western Europe",3701794,3628117,73677,2858886,4764810,"NLD",3811848
1,237.0,"Western Africa",523204,0,523204,387831,646385,"NGA",517108
1,237.0,"Oceania",634324,633205,1119,476475,794125,"NZL",635300
1,237.0,"South America",1958781,1704822,253959,1521965,2536608,"BRA",2029287
1,237.0,"Northern Africa",1786322,0,1786322,1316664,2194441,"EGY",1755553
1,237.0,"Southern Asia",563264,0,563264,414039,690065,"IRN",552052
1,237.0,"Eastern Europe",2992084,2991674,410,2250557,3750928,"POL",3000743
1,237.0,"Middle Africa",117917,0,117917,87425,145708,"AGO",116567
1,237.0,"Central America",505788,0,505788,371225,618708,"MEX",494967
1,237.0,"Southern Africa",125992,0,125992,92154,153591,"ZAF",122873
1,237.0,"South-Eastern Asia",1061553,0,1061553,784509,1307516,"IDN",1046013
1,237.0,"China",9005368,8892604,112764,6576264,10960441,"CPR",8768353
1,237.0,"Pakistan",1820457,1641026,179431,1369593,2282655,"PAK",1826124
1,237.0,"Eastern Asia",846734,0,846734,614727,1024545,"JPN",819636
1,237.0,"Russian Federation",2359357,2359357,0,1776954,2961591,"RUS",2369273
1,237.0,"Western Asia",789728,0,789728,588156,980260,"IRQ",784208
1,237.0,"Southern Europe",831240,0,831240,615844,1026407,"ITA",821126
1,237.0,"Eastern Africa",446821,0,446821,332490,554150,"ETH",443320
1,237.0,"Northern America",498331,493767,4564,375213,625356,"CAN",500285
1,237.0,"Northern Europe",2132962,2091237,41725,1523699,2539498,"GBR",2031599
1,237.0,"United States of America",2678885,2516442,162443,1817139,3028565,"USA",2422852
1,237.0,"Central Asia",1641299,1641299,0,1233222,2055371,"UZB",1644297
1,237.0,"India",6476061,6476061,0,4866416,8110693,"IND",6488555
1,238.0,"Western Europe",3767825,3681099,86726,2858886,4764810,"NLD",3811848
1,238.0,"Western Africa",519999,0,519999,387831,646385,"NGA",517108
1,238.0,"Oceania",624584,624584,0,476475,794125,"NZL",635300
1,238.0,"South America",1979068,1705085,273983,1521965,2536608,"BRA",2029287
1,238.0,"Northern Africa",1770123,0,1770123,1316664,2194441,"EGY",1755553
1,238.0,"Southern Asia",557361,0,557361,414039,690065,"IRN",552052
1,238.0,"Eastern Europe",2911026,2911026,0,2250557,3750928,"POL",3000743
1,238.0,"Middle Africa",117208,0,117208,87425,145708,"AGO",116567
1,238.0,"Central America",501442,0,501442,371225,618708,"MEX",494967
1,238.0,"Southern Africa",124352,0,124352,92154,153591,"ZAF",122873
1,238.0,"South-Eastern Asia",1053411,0,1053411,784509,1307516,"IDN",1046013
1,238.0,"China",9038443,8906343,132100,6576264,10960441,"CPR",8768353
1,238.0,"Pakistan",1789995,1616748,173247,1369593,2282655,"PAK",1826124
1,238.0,"Eastern Asia",832467,0,832467,614727,1024545,"JPN",819636
1,238.0,"Russian Federation",2273317,2273317,0,1776954,2961591,"RUS",2369273
1,238.0,"Western Asia",786821,0,786821,588156,980260,"IRQ",784208
1,238.0,"Southern Europe",827081,0,827081,615844,1026407,"ITA",821126
1,238.0,"Eastern Africa",444982,0,444982,332490,554150,"ETH",443320
1,238.0,"Northern America",478819,475750,3069,375213,625356,"CAN",500285
1,238.0,"Northern Europe",1987002,1952513,34489,1523699,2539498,"GBR",2031599
1,238.0,"United States of America",2607764,2446459,161305,1817139,3028565,"USA",2422852
1,238.0,"Central Asia",1613732,1613732,0,1233222,2055371,"UZB",1644297
1,238.0,"India",6354968,6354968,0,4866416,8110693,"IND",6488555
1,239.0,"Western Europe",3804510,3705619,98891,2858887,4764812,"NLD",3811850
1,239.0,"Western Africa",520049,0,520049,387836,646393,"NGA",517115
1,239.0,"Oceania",629454,629454,0,476476,794127,"NZL",635302
1,239.0,"South America",1995472,1703807,291665,1521971,2536618,"BRA",2029295
1,239.0,"Northern Africa",1770399,0,1770399,1316668,2194447,"EGY",1755558
1,239.0,"Southern Asia",557464,0,557464,414043,690072,"IRN",552058
1,239.0,"Eastern Europe",2946759,2946759,0,2250558,3750930,"POL",3000744
1,239.0,"Middle Africa",117219,0,117219,87426,145711,"AGO",116569
1,239.0,"Central America",500912,0,500912,371232,618721,"MEX",494977
1,239.0,"Southern Africa",124381,0,124381,92159,153598,"ZAF",122879
1,239.0,"South-Eastern Asia",1053517,0,1053517,784512,1307520,"IDN",1046016
1,239.0,"China",9042545,8896951,145594,6576266,10960443,"CPR",8768355
1,239.0,"Pakistan",1804584,1634918,169666,1369600,2282667,"PAK",1826134
1,239.0,"Eastern Asia",832709,0,832709,614734,1024557,"JPN",819646
1,239.0,"Russian Federation",2310295,2310295,0,1776954,2961591,"RUS",2369273
1,239.0,"Western Asia",786875,0,786875,588157,980262,"IRQ",784210
1,239.0,"Southern Europe",826623,0,826623,615849,1026416,"ITA",821133
1,239.0,"Eastern Africa",445015,0,445015,332496,554161,"ETH",443329
1,239.0,"Northern America",488575,486974,1601,375216,625361,"CAN",500289
1,239.0,"Northern Europe",2007270,1978462,28808,1523707,2539512,"GBR",2031610
1,239.0,"United States of America",2557982,2395753,162229,1817141,3028568,"USA",2422855
1,239.0,"Central Asia",1626417,1626417,0,1233229,2055382,"UZB",1644306
1,239.0,"India",6413775,6413775,0,4866419,8110698,"IND",6488559
1,240.0,"Western Europe",3833857,3723396,110461,3226720,5377867,"NLD",4302294
1,240.0,"Western Africa",518724,0,518724,416706,694511,"NGA",555609
1,240.0,"Oceania",625558,625558,0,444324,740541,"NZL",592433
1,240.0,"South America",2009368,1704435,304933,1669054,2781757,"BRA",2225406
1,240.0,"Northern Africa",1763687,0,1763687,1492954,2488257,"EGY",1990606
1,240.0,"Southern Asia",555019,0,555019,357988,596647,"IRN",477318
1,240.0,"Eastern Europe",2916444,2916444,0,2539092,4231821,"POL",3385457
1,240.0,"Middle Africa",116928,0,116928,112264,187107,"AGO",149686
1,240.0,"Central America",498979,0,498979,406210,677017,"MEX",541614
1,240.0,"Southern Africa",123698,0,123698,132246,220410,"ZAF",176328
1,240.0,"South-Eastern Asia",1050489,0,1050489,954939,1591566,"IDN",1273253
1,240.0,"China",8779675,8662450,117225,8045973,13409956,"CPR",10727965
1,240.0,"Pakistan",1792831,1627740,165091,1527854,2546423,"PAK",2037139
1,240.0,"Eastern Asia",827118,0,827118,735293,1225488,"JPN",980391
1,240.0,"Russian Federation",2278378,2278378,0,2109044,3515073,"RUS",2812059
1,240.0,"Western Asia",785669,0,785669,882339,1470565,"IRQ",1176452
1,240.0,"Southern Europe",824822,0,824822,649815,1083025,"ITA",866420
1,240.0,"Eastern Africa",444251,0,444251,431263,718772,"ETH",575018
1,240.0,"Northern America",480771,480669,102,489124,815207,"CAN",652166
1,240.0,"Northern Europe",1991053,1968161,22892,1642345,2737242,"GBR",2189794
1,240.0,"United States of America",2522420,2367371,155049,2042184,3403640,"USA",2722912
1,240.0,"Central Asia",1615879,1615879,0,1424480,2374133,"UZB",1899307
1,240.0,"India",6366154,6366154,0,5251611,8752685,"IND",7002148
1,241.0,"Western Europe",3833863,3719876,113987,3226720,5377867,"NLD",4302294
1,241.0,"Western Africa",517493,0,517493,416706,694511,"NGA",555609
1,241.0,"Oceania",629456,629456,0,444324,740541,"NZL",592433
1,241.0,"South America",1537726,1222898,314828,1669054,2781757,"BRA",2225406
1,241.0,"Northern Africa",1757446,0,1757446,1492954,2488257,"EGY",1990606
1,241.0,"Southern Asia",552750,0,552750,357988,596647,"IRN",477318
1,241.0,"Eastern Europe",2947081,2947081,0,2539092,4231821,"POL",3385457
1,241.0,"Middle Africa",116655,0,116655,112264,187107,"AGO",149686
1,241.0,"Central America",496358,0,496358,406210,677017,"MEX",541614
1,241.0,"Southern Africa",123076,0,123076,132246,220410,"ZAF",176328
1,241.0,"South-Eastern Asia",1047180,0,1047180,954939,1591566,"IDN",1273253
1,241.0,"China",8637305,8552324,84981,8045973,13409956,"CPR",10727965
1,241.0,"Pakistan",1806235,1644205,162030,1527854,2546423,"PAK",2037139
1,241.0,"Eastern Asia",821691,0,821691,735293,1225488,"JPN",980391
1,241.0,"Russian Federation",2310666,2310666,0,2109044,3515073,"RUS",2812059
1,241.0,"Western Asia",784554,0,784554,882339,1470565,"IRQ",1176452
1,241.0,"Southern Europe",822387,0,822387,649815,1083025,"ITA",866420
1,241.0,"Eastern Africa",443548,0,443548,431263,718772,"ETH",575018
1,241.0,"Northern America",488581,488581,0,489124,815207,"CAN",652166
1,241.0,"Northern Europe",2007282,1990748,16534,1642345,2737242,"GBR",2189794
1,241.0,"United States of America",2458416,2314719,143697,2042184,3403640,"USA",2722912
1,241.0,"Central Asia",1626516,1626516,0,1424480,2374133,"UZB",1899307
1,241.0,"India",6413947,6413947,0,5251611,8752685,"IND",7002148
1,242.0,"Western Europe",3730017,3620437,109580,3226720,5377867,"NLD",4302294
1,242.0,"Western Africa",526184,0,526184,416706,694511,"NGA",555609
1,242.0,"Oceania",582695,582695,0,444324,740541,"NZL",592433
1,242.0,"South America",1579011,1221570,357441,1669054,2781757,"BRA",2225406
1,242.0,"Northern Africa",1841994,0,1841994,1492954,2488257,"EGY",1990606
1,242.0,"Southern Asia",423194,0,423194,357988,596647,"IRN",477318
1,242.0,"Eastern Europe",3278331,3278331,0,2539092,4231821,"POL",3385457
1,242.0,"Middle Africa",143173,0,143173,112264,187107,"AGO",149686
1,242.0,"Central America",490516,0,490516,406210,677017,"MEX",541614
1,242.0,"Southern Africa",161282,0,161282,132246,220410,"ZAF",176328
1,242.0,"South-Eastern Asia",1197280,0,1197280,954939,1591566,"IDN",1273253
1,242.0,"China",8931902,8872005,59897,8045973,13409956,"CPR",10727965
1,242.0,"Pakistan",1991469,1822295,169174,1527854,2546423,"PAK",2037139
1,242.0,"Eastern Asia",849010,0,849010,735293,1225488,"JPN",980391
1,242.0,"Russian Federation",2688733,2688733,0,2109044,3515073,"RUS",2812059
1,242.0,"Western Asia",1149821,0,1149821,882339,1470565,"IRQ",1176452
1,242.0,"Southern Europe",818426,0,818426,649815,1083025,"ITA",866420
1,242.0,"Eastern Africa",558116,0,558116,431263,718772,"ETH",575018
1,242.0,"Northern America",542890,542890,0,489124,815207,"CAN",652166
1,242.0,"Northern Europe",2112757,2102218,10539,1642345,2737242,"GBR",2189794
1,242.0,"United States of America",2345977,2202469,143508,2042184,3403640,"USA",2722912
1,242.0,"Central Asia",1860245,1860245,0,1424480,2374133,"UZB",1899307
1,242.0,"India",6714340,6714340,0,5251611,8752685,"IND",7002148
1,243.0,"Western Europe",3803386,3669962,133424,3226720,5377867,"NLD",4302294
1,243.0,"Western Africa",528135,0,528135,416706,694511,"NGA",555609
1,243.0,"Oceania",571001,571001,0,444324,740541,"NZL",592433
1,243.0,"South America",1621304,1222613,398691,1669054,2781757,"BRA",2225406
1,243.0,"Northern Africa",1850877,0,1850877,1492954,2488257,"EGY",1990606
1,243.0,"Southern Asia",426418,0,426418,357988,596647,"IRN",477318
1,243.0,"Eastern Europe",3200690,3200690,0,2539092,4231821,"POL",3385457
1,243.0,"Middle Africa",143570,0,143570,112264,187107,"AGO",149686
1,243.0,"Central America",504598,0,504598,406210,677017,"MEX",541614
1,243.0,"Southern Africa",162182,0,162182,132246,220410,"ZAF",176328
1,243.0,"South-Eastern Asia",1202544,0,1202544,954939,1591566,"IDN",1273253
1,243.0,"China",8965983,8864530,101453,8045973,13409956,"CPR",10727965
1,243.0,"Pakistan",1964784,1799340,165444,1527854,2546423,"PAK",2037139
1,243.0,"Eastern Asia",857560,0,857560,735293,1225488,"JPN",980391
1,243.0,"Russian Federation",2612561,2612561,0,2109044,3515073,"RUS",2812059
1,243.0,"Western Asia",1151414,0,1151414,882339,1470565,"IRQ",1176452
1,243.0,"Southern Europe",822419,0,822419,649815,1083025,"ITA",866420
1,243.0,"Eastern Africa",559130,0,559130,431263,718772,"ETH",575018
1,243.0,"Northern America",552648,550516,2132,489124,815207,"CAN",652166
1,243.0,"Northern Europe",2076267,2072206,4061,1642345,2737242,"GBR",2189794
1,243.0,"United States of America",2367312,2221249,146063,2042184,3403640,"USA",2722912
1,243.0,"Central Asia",1836799,1836799,0,1424480,2374133,"UZB",1899307
1,243.0,"India",6706749,6705766,983,5251611,8752685,"IND",7002148
1,244.0,"Western Europe",3847408,3690620,156788,3226720,5377867,"NLD",4302294
1,244.0,"Western Africa",530641,0,530641,416706,694511,"NGA",555609
1,244.0,"Oceania",577820,577820,0,444324,740541,"NZL",592433
1,244.0,"South America",1661677,1222075,439602,1669054,2781757,"BRA",2225406
1,244.0,"Northern Africa",1863517,0,1863517,1492954,2488257,"EGY",1990606
1,244.0,"Southern Asia",431023,0,431023,357988,596647,"IRN",477318
1,244.0,"Eastern Europe",3252844,3252844,0,2539092,4231821,"POL",3385457
1,244.0,"Middle Africa",144126,0,144126,112264,187107,"AGO",149686
1,244.0,"Central America",508602,0,508602,406210,677017,"MEX",541614
1,244.0,"Southern Africa",163461,0,163461,132246,220410,"ZAF",176328
1,244.0,"South-Eastern Asia",1209324,0,1209324,954939,1591566,"IDN",1273253
1,244.0,"China",9013443,8865482,147961,8045973,13409956,"CPR",10727965
1,244.0,"Pakistan",1956754,1793789,162965,1527854,2546423,"PAK",2037139
1,244.0,"Eastern Asia",884350,0,884350,735293,1225488,"JPN",980391
1,244.0,"Russian Federation",2667578,2667578,0,2109044,3515073,"RUS",2812059
1,244.0,"Western Asia",1153677,0,1153677,882339,1470565,"IRQ",1176452
1,244.0,"Southern Europe",825906,0,825906,649815,1083025,"ITA",866420
1,244.0,"Eastern Africa",560564,0,560564,431263,718772,"ETH",575018
1,244.0,"Northern America",560454,556058,4396,489124,815207,"CAN",652166
1,244.0,"Northern Europe",2055994,2051799,4195,1642345,2737242,"GBR",2189794
1,244.0,"United States of America",2395758,2239581,156177,2042184,3403640,"USA",2722912
1,244.0,"Central Asia",1855190,1855190,0,1424480,2374133,"UZB",1899307
1,244.0,"India",6730889,6728504,2385,5251611,8752685,"IND",7002148
1,245.0,"Western Europe",3898766,3718752,180014,3226720,5377867,"NLD",4302294
1,245.0,"Western Africa",534363,0,534363,416706,694511,"NGA",555609
1,245.0,"Oceania",608016,608016,0,444324,740541,"NZL",592433
1,245.0,"South America",1708575,1225034,483541,1669054,2781757,"BRA",2225406
1,245.0,"Northern Africa",1885285,0,1885285,1492954,2488257,"EGY",1990606
1,245.0,"Southern Asia",438951,0,438951,357988,596647,"IRN",477318
1,245.0,"Eastern Europe",3328926,3328926,0,2539092,4231821,"POL",3385457
1,245.0,"Middle Africa",145074,0,145074,112264,187107,"AGO",149686
1,245.0,"Central America",511845,0,511845,406210,677017,"MEX",541614
1,245.0,"Southern Africa",165663,0,165663,132246,220410,"ZAF",176328
1,245.0,"South-Eastern Asia",1220503,0,1220503,954939,1591566,"IDN",1273253
1,245.0,"China",9069140,8862496,206644,8045973,13409956,"CPR",10727965
1,245.0,"Pakistan",1949926,1789187,160739,1527854,2546423,"PAK",2037139
1,245.0,"Eastern Asia",907197,0,907197,735293,1225488,"JPN",980391
1,245.0,"Russian Federation",2939982,2939982,0,2109044,3515073,"RUS",2812059
1,245.0,"Western Asia",1157576,0,1157576,882339,1470565,"IRQ",1176452
1,245.0,"Southern Europe",830030,0,830030,649815,1083025,"ITA",866420
1,245.0,"Eastern Africa",563040,0,563040,431263,718772,"ETH",575018
1,245.0,"Northern America",572161,565399,6762,489124,815207,"CAN",652166
1,245.0,"Northern Europe",2043830,2032660,11170,1642345,2737242,"GBR",2189794
1,245.0,"United States of America",2424209,2258725,165484,2042184,3403640,"USA",2722912
1,245.0,"Central Asia",1878095,1878095,0,1424480,2374133,"UZB",1899307
1,245.0,"India",6731253,6727185,4068,5251611,8752685,"IND",7002148
1,246.0,"Western Europe",3950123,3747392,202731,3226720,5377867,"NLD",4302294
1,246.0,"Western Africa",536048,0,536048,416706,694511,"NGA",555609
1,246.0,"Oceania",584643,584643,0,444324,740541,"NZL",592433
1,246.0,"South America",1750025,1225960,524065,1669054,2781757,"BRA",2225406
1,246.0,"Northern Africa",1891826,0,1891826,1492954,2488257,"EGY",1990606
1,246.0,"Southern Asia",441336,0,441336,357988,596647,"IRN",477318
1,246.0,"Eastern Europe",3292898,3292898,0,2539092,4231821,"POL",3385457
1,246.0,"Middle Africa",145361,0,145361,112264,187107,"AGO",149686
1,246.0,"Central America",515403,0,515403,406210,677017,"MEX",541614
1,246.0,"Southern Africa",166325,0,166325,132246,220410,"ZAF",176328
1,246.0,"South-Eastern Asia",1224050,0,1224050,954939,1591566,"IDN",1273253
1,246.0,"China",9108361,8848090,260271,8045973,13409956,"CPR",10727965
1,246.0,"Pakistan",2208197,2043244,164953,1527854,2546423,"PAK",2037139
1,246.0,"Eastern Asia",912437,0,912437,735293,1225488,"JPN",980391
1,246.0,"Russian Federation",2864723,2864723,0,2109044,3515073,"RUS",2812059
1,246.0,"Western Asia",1158750,0,1158750,882339,1470565,"IRQ",1176452
1,246.0,"Southern Europe",834544,0,834544,649815,1083025,"ITA",866420
1,246.0,"Eastern Africa",563783,0,563783,431263,718772,"ETH",575018
1,246.0,"Northern America",583869,574690,9179,489124,815207,"CAN",652166
1,246.0,"Northern Europe",2035721,2017279,18442,1642345,2737242,"GBR",2189794
1,246.0,"United States of America",2459766,2285786,173980,2042184,3403640,"USA",2722912
1,246.0,"Central Asia",1867983,1865175,2808,1424480,2374133,"UZB",1899307
1,246.0,"India",6753820,6730837,22983,5251611,8752685,"IND",7002148
1,247.0,"Western Europe",3994143,3769400,224743,3226720,5377867,"NLD",4302294
1,247.0,"Western Africa",536705,0,536705,416706,694511,"NGA",555609
1,247.0,"Oceania",565156,565156,0,444324,740541,"NZL",592433
1,247.0,"South America",1787211,1226427,560784,1669054,2781757,"BRA",2225406
1,247.0,"Northern Africa",1895531,0,1895531,1492954,2488257,"EGY",1990606
1,247.0,"Southern Asia",442683,0,442683,357988,596647,"IRN",477318
1,247.0,"Eastern Europe",3274538,3265477,9061,2539092,4231821,"POL",3385457
1,247.0,"Middle Africa",145524,0,145524,112264,187107,"AGO",149686
1,247.0,"Central America",517831,0,517831,406210,677017,"MEX",541614
1,247.0,"Southern Africa",166702,0,166702,132246,220410,"ZAF",176328
1,247.0,"South-Eastern Asia",1225882,0,1225882,954939,1591566,"IDN",1273253
1,247.0,"China",9170005,8860104,309901,8045973,13409956,"CPR",10727965
1,247.0,"Pakistan",2035546,1884664,150882,1527854,2546423,"PAK",2037139
1,247.0,"Eastern Asia",913025,0,913025,735293,1225488,"JPN",980391
1,247.0,"Russian Federation",2781291,2781291,0,2109044,3515073,"RUS",2812059
1,247.0,"Western Asia",1159412,0,1159412,882339,1470565,"IRQ",1176452
1,247.0,"Southern Europe",837754,0,837754,649815,1083025,"ITA",866420
1,247.0,"Eastern Africa",564205,0,564205,431263,718772,"ETH",575018
1,247.0,"Northern America",591674,580061,11613,489124,815207,"CAN",652166
1,247.0,"Northern Europe",2031667,2005648,26019,1642345,2737242,"GBR",2189794
1,247.0,"United States of America",2481102,2299638,181464,2042184,3403640,"USA",2722912
1,247.0,"Central Asia",1870327,1861733,8594,1424480,2374133,"UZB",1899307
1,247.0,"India",6779554,6735154,44400,5251611,8752685,"IND",7002148
1,248.0,"Western Europe",4023491,3777416,246075,3226720,5377867,"NLD",4302294
1,248.0,"Western Africa",539014,0,539014,416706,694511,"NGA",555609
1,248.0,"Oceania",558337,558337,0,444324,740541,"NZL",592433
1,248.0,"South America",1820959,1226954,594005,1669054,2781757,"BRA",2225406
1,248.0,"Northern Africa",1898751,0,1898751,1492954,2488257,"EGY",1990606
1,248.0,"Southern Asia",443855,0,443855,357988,596647,"IRN",477318
1,248.0,"Eastern Europe",3208572,3189034,19538,2539092,4231821,"POL",3385457
1,248.0,"Middle Africa",145765,0,145765,112264,187107,"AGO",149686
1,248.0,"Central America",519061,0,519061,406210,677017,"MEX",541614
1,248.0,"Southern Africa",167026,0,167026,132246,220410,"ZAF",176328
1,248.0,"South-Eastern Asia",1235726,0,1235726,954939,1591566,"IDN",1273253
1,248.0,"China",9214170,8855631,358539,8045973,13409956,"CPR",10727965
1,248.0,"Pakistan",2084360,1939519,144841,1527854,2546423,"PAK",2037139
1,248.0,"Eastern Asia",915791,0,915791,735293,1225488,"JPN",980391
1,248.0,"Russian Federation",2705918,2705918,0,2109044,3515073,"RUS",2812059
1,248.0,"Western Asia",1159989,0,1159989,882339,1470565,"IRQ",1176452
1,248.0,"Southern Europe",839527,0,839527,649815,1083025,"ITA",866420
1,248.0,"Eastern Africa",564572,0,564572,431263,718772,"ETH",575018
1,248.0,"Northern America",597529,583466,14063,489124,815207,"CAN",652166
1,248.0,"Northern Europe",1861378,1827494,33884,1642345,2737242,"GBR",2189794
1,248.0,"United States of America",2502439,2314098,188341,2042184,3403640,"USA",2722912
1,248.0,"Central Asia",1870423,1855995,14428,1424480,2374133,"UZB",1899307
1,248.0,"India",6804708,6738090,66618,5251611,8752685,"IND",7002148
1,249.0,"Western Europe",4030829,3763825,267004,3226720,5377867,"NLD",4302294
1,249.0,"Western Africa",548775,0,548775,416706,694511,"NGA",555609
1,249.0,"Oceania",558335,556494,1841,444324,740541,"NZL",592433
1,249.0,"South America",1864552,1224070,640482,1669054,2781757,"BRA",2225406
1,249.0,"Northern Africa",1947773,0,1947773,1492954,2488257,"EGY",1990606
1,249.0,"Southern Asia",461714,0,461714,357988,596647,"IRN",477318
1,249.0,"Eastern Europe",3196548,3166073,30475,2539092,4231821,"POL",3385457
1,249.0,"Middle Africa",147811,0,147811,112264,187107,"AGO",149686
1,249.0,"Central America",536023,0,536023,406210,677017,"MEX",541614
1,249.0,"Southern Africa",171988,0,171988,132246,220410,"ZAF",176328
1,249.0,"South-Eastern Asia",1262045,0,1262045,954939,1591566,"IDN",1273253
1,249.0,"China",10443307,10035116,408191,8045973,13409956,"CPR",10727965
1,249.0,"Pakistan",2037029,1900318,136711,1527854,2546423,"PAK",2037139
1,249.0,"Eastern Asia",958588,0,958588,735293,1225488,"JPN",980391
1,249.0,"Russian Federation",3029363,3028900,463,2109044,3515073,"RUS",2812059
1,249.0,"Western Asia",1168774,0,1168774,882339,1470565,"IRQ",1176452
1,249.0,"Southern Europe",855489,0,855489,649815,1083025,"ITA",866420
1,249.0,"Eastern Africa",570144,0,570144,431263,718772,"ETH",575018
1,249.0,"Northern America",572162,555635,16527,489124,815207,"CAN",652166
1,249.0,"Northern Europe",1877595,1833928,43667,1642345,2737242,"GBR",2189794
1,249.0,"United States of America",2858036,2663425,194611,2042184,3403640,"USA",2722912
1,249.0,"Central Asia",1870428,1850112,20316,1424480,2374133,"UZB",1899307
1,249.0,"India",6829349,6740310,89039,5251611,8752685,"IND",7002148
1,250.0,"Western Europe",4089522,3801423,288099,3226720,5377867,"NLD",4302294
1,250.0,"Western Africa",549038,0,549038,416706,694511,"NGA",555609
1,250.0,"Oceania",571973,568228,3745,444324,740541,"NZL",592433
1,250.0,"South America",1908458,1225643,682815,1669054,2781757,"BRA",2225406
1,250.0,"Northern Africa",1952039,0,1952039,1492954,2488257,"EGY",1990606
1,250.0,"Southern Asia",463266,0,463266,357988,596647,"IRN",477318
1,250.0,"Eastern Europe",3195833,3154090,41743,2539092,4231821,"POL",3385457
1,250.0,"Middle Africa",147994,0,147994,112264,187107,"AGO",149686
1,250.0,"Central America",537117,0,537117,406210,677017,"MEX",541614
1,250.0,"Southern Africa",172420,0,172420,132246,220410,"ZAF",176328
1,250.0,"South-Eastern Asia",1264383,0,1264383,954939,1591566,"IDN",1273253
1,250.0,"China",10470530,10030566,439964,8045973,13409956,"CPR",10727965
1,250.0,"Pakistan",1970876,1840272,130604,1527854,2546423,"PAK",2037139
1,250.0,"Eastern Asia",963922,0,963922,735293,1225488,"JPN",980391
1,250.0,"Russian Federation",2845304,2845304,0,2109044,3515073,"RUS",2812059
1,250.0,"Western Asia",1169538,0,1169538,882339,1470565,"IRQ",1176452
1,250.0,"Southern Europe",855755,0,855755,649815,1083025,"ITA",866420
1,250.0,"Eastern Africa",570629,0,570629,431263,718772,"ETH",575018
1,250.0,"Northern America",605332,586017,19315,489124,815207,"CAN",652166
1,250.0,"Northern Europe",1897867,1844116,53751,1642345,2737242,"GBR",2189794
1,250.0,"United States of America",2758476,2567706,190770,2042184,3403640,"USA",2722912
1,250.0,"Central Asia",1721004,1694746,26258,1424480,2374133,"UZB",1899307
1,250.0,"India",6853979,6742404,111575,5251611,8752685,"IND",7002148
1,251.0,"Western Europe",4133545,3825833,307712,3226722,5377871,"NLD",4302297
1,251.0,"Western Africa",549512,0,549512,416706,694511,"NGA",555609
1,251.0,"Oceania",577819,572185,5634,444324,740541,"NZL",592433
1,251.0,"South America",1945795,1224957,720838,1669062,2781770,"BRA",2225416
1,251.0,"Northern Africa",1956781,0,1956781,1492962,2488270,"EGY",1990616
1,251.0,"Southern Asia",464774,0,464774,357994,596657,"IRN",477326
1,251.0,"Eastern Europe",3195791,3142504,53287,2539092,4231821,"POL",3385457
1,251.0,"Middle Africa",148177,0,148177,112269,187115,"AGO",149692
1,251.0,"Central America",537283,0,537283,406215,677026,"MEX",541621
1,251.0,"Southern Africa",172841,0,172841,132249,220416,"ZAF",176333
1,251.0,"South-Eastern Asia",1264570,0,1264570,954948,1591580,"IDN",1273264
1,251.0,"China",10517037,10043872,473165,8045979,13409966,"CPR",10727973
1,251.0,"Pakistan",1960301,1833229,127072,1527856,2546427,"PAK",2037142
1,251.0,"Eastern Asia",964592,0,964592,735301,1225502,"JPN",980402
1,251.0,"Russian Federation",2719267,2719267,0,2109045,3515075,"RUS",2812060
1,251.0,"Western Asia",1170280,0,1170280,882339,1470565,"IRQ",1176452
1,251.0,"Southern Europe",856523,0,856523,649821,1083035,"ITA",866428
1,251.0,"Eastern Africa",571100,0,571100,431264,718773,"ETH",575019
1,251.0,"Northern America",620944,599136,21808,489124,815207,"CAN",652166
1,251.0,"Northern Europe",1918141,1854132,64009,1642350,2737251,"GBR",2189801
1,251.0,"United States of America",2715803,2526042,189761,2042188,3403647,"USA",2722918
1,251.0,"Central Asia",1731367,1697564,33803,1424485,2374142,"UZB",1899314
1,251.0,"India",6878610,6752828,125782,5251615,8752692,"IND",7002154
1,252.0,"Western Europe",4148218,3835188,313030,2754267,4590445,"NLD",3672356
1,252.0,"Western Africa",549510,0,549510,338753,564588,"NGA",451671
1,252.0,"Oceania",580742,573226,7516,442299,737165,"NZL",589732
1,252.0,"South America",1978695,1224482,754213,1479207,2465346,"BRA",1972277
1,252.0,"Northern Africa",1959347,0,1959347,1183118,1971863,"EGY",1577491
1,252.0,"Southern Asia",465084,0,465084,538524,897541,"IRN",718033
1,252.0,"Eastern Europe",3195788,3130692,65096,2085708,3476180,"POL",2780944
1,252.0,"Middle Africa",148211,0,148211,105147,175245,"AGO",140196
1,252.0,"Central America",536580,0,536580,411949,686582,"MEX",549266
1,252.0,"Southern Africa",172928,0,172928,107739,179565,"ZAF",143652
1,252.0,"South-Eastern Asia",1263983,0,1263983,973325,1622208,"IDN",1297767
1,252.0,"China",10541503,10035013,506490,7238028,12063381,"CPR",9650705
1,252.0,"Pakistan",1953309,1825362,127947,1387656,2312760,"PAK",1850208
1,252.0,"Eastern Asia",963637,0,963637,716114,1193523,"JPN",954819
1,252.0,"Russian Federation",2822570,2822570,0,1730008,2883347,"RUS",2306678
1,252.0,"Western Asia",1170430,0,1170430,875120,1458533,"IRQ",1166827
1,252.0,"Southern Europe",856522,0,856522,596781,994636,"ITA",795709
1,252.0,"Eastern Africa",571197,0,571197,318222,530371,"ETH",424297
1,252.0,"Northern America",628748,604595,24153,471794,786323,"CAN",629059
1,252.0,"Northern Europe",1966794,1892432,74362,1479730,2466217,"GBR",1972974
1,252.0,"United States of America",2687348,2497388,189960,2179317,3632195,"USA",2905756
1,252.0,"Central Asia",1742870,1701335,41535,1171911,1953185,"UZB",1562548
1,252.0,"India",6891114,6742903,148211,4691154,7818590,"IND",6254872
1,253.0,"Western Europe",4162894,3845008,317886,2754267,4590445,"NLD",3672356
1,253.0,"Western Africa",549701,0,549701,338753,564588,"NGA",451671
1,253.0,"Oceania",600223,590835,9388,442299,737165,"NZL",589732
1,253.0,"South America",3053662,2268770,784892,1479207,2465346,"BRA",1972277
1,253.0,"Northern Africa",1961027,0,1961027,1183118,1971863,"EGY",1577491
1,253.0,"Southern Asia",468119,0,468119,538524,897541,"IRN",718033
1,253.0,"Eastern Europe",3203898,3128595,75303,2085708,3476180,"POL",2780944
1,253.0,"Middle Africa",148522,0,148522,105147,175245,"AGO",140196
1,253.0,"Central America",536122,0,536122,411949,686582,"MEX",549266
1,253.0,"Southern Africa",173845,0,173845,107739,179565,"ZAF",143652
1,253.0,"South-Eastern Asia",1266423,0,1266423,973325,1622208,"IDN",1297767
1,253.0,"China",10591809,10050007,541802,7238028,12063381,"CPR",9650705
1,253.0,"Pakistan",1952863,1821705,131158,1387656,2312760,"PAK",1850208
1,253.0,"Eastern Asia",967832,0,967832,716114,1193523,"JPN",954819
1,253.0,"Russian Federation",2708946,2708946,0,1730008,2883347,"RUS",2306678
1,253.0,"Western Asia",1171669,0,1171669,875120,1458533,"IRQ",1166827
1,253.0,"Southern Europe",856832,0,856832,596781,994636,"ITA",795709
1,253.0,"Eastern Africa",571983,0,571983,318222,530371,"ETH",424297
1,253.0,"Northern America",632651,606297,26354,471794,786323,"CAN",629059
1,253.0,"Northern Europe",2011399,1927766,83633,1479730,2466217,"GBR",1972974
1,253.0,"United States of America",2673131,2482162,190969,2179317,3632195,"USA",2905756
1,253.0,"Central Asia",1751658,1703327,48331,1171911,1953185,"UZB",1562548
1,253.0,"India",6915564,6747149,168415,4691154,7818590,"IND",6254872
1,254.0,"Western Europe",4193277,3890853,302424,2754267,4590445,"NLD",3672356
1,254.0,"Western Africa",466300,0,466300,338753,564588,"NGA",451671
1,254.0,"Oceania",593630,582584,11046,442299,737165,"NZL",589732
1,254.0,"South America",2930238,2267991,662247,1479207,2465346,"BRA",1972277
1,254.0,"Northern Africa",1655642,0,1655642,1183118,1971863,"EGY",1577491
1,254.0,"Southern Asia",740332,0,740332,538524,897541,"IRN",718033
1,254.0,"Eastern Europe",3276401,3197376,79025,2085708,3476180,"POL",2780944
1,254.0,"Middle Africa",142956,0,142956,105147,175245,"AGO",140196
1,254.0,"Central America",551733,0,551733,411949,686582,"MEX",549266
1,254.0,"Southern Africa",150277,0,150277,107739,179565,"ZAF",143652
1,254.0,"South-Eastern Asia",1301107,0,1301107,973325,1622208,"IDN",1297767
1,254.0,"China",10607100,10057026,550074,7238028,12063381,"CPR",9650705
1,254.0,"Pakistan",1957785,1830559,127226,1387656,2312760,"PAK",1850208
1,254.0,"Eastern Asia",968889,0,968889,716114,1193523,"JPN",954819
1,254.0,"Russian Federation",2292880,2292880,0,1730008,2883347,"RUS",2306678
1,254.0,"Western Asia",1178056,0,1178056,875120,1458533,"IRQ",1166827
1,254.0,"Southern Europe",816593,0,816593,596781,994636,"ITA",795709
1,254.0,"Eastern Africa",431897,0,431897,318222,530371,"ETH",424297
1,254.0,"Northern America",673938,645748,28190,471794,786323,"CAN",629059
1,254.0,"Northern Europe",2074338,1985405,88933,1479730,2466217,"GBR",1972974
1,254.0,"United States of America",2898642,2701057,197585,2179317,3632195,"USA",2905756
1,254.0,"Central Asia",1755842,1705621,50221,1171911,1953185,"UZB",1562548
1,254.0,"India",6931967,6754320,177647,4691154,7818590,"IND",6254872
1,255.0,"Western Europe",4134579,3848576,286003,2754267,4590445,"NLD",3672356
1,255.0,"Western Africa",465618,0,465618,338753,564588,"NGA",451671
1,255.0,"Oceania",601424,588656,12768,442299,737165,"NZL",589732
1,255.0,"South America",2826061,2266455,559606,1479207,2465346,"BRA",1972277
1,255.0,"Northern Africa",1647885,0,1647885,1183118,1971863,"EGY",1577491
1,255.0,"Southern Asia",744317,0,744317,538524,897541,"IRN",718033
1,255.0,"Eastern Europe",3305034,3223650,81384,2085708,3476180,"POL",2780944
1,255.0,"Middle Africa",143285,0,143285,105147,175245,"AGO",140196
1,255.0,"Central America",558057,0,558057,411949,686582,"MEX",549266
1,255.0,"Southern Africa",150831,0,150831,107739,179565,"ZAF",143652
1,255.0,"South-Eastern Asia",1318437,0,1318437,973325,1622208,"IDN",1297767
1,255.0,"China",10631805,10072537,559268,7238028,12063381,"CPR",9650705
1,255.0,"Pakistan",1945483,1822674,122809,1387656,2312760,"PAK",1850208
1,255.0,"Eastern Asia",981507,0,981507,716114,1193523,"JPN",954819
1,255.0,"Russian Federation",2219095,2219095,0,1730008,2883347,"RUS",2306678
1,255.0,"Western Asia",1179760,0,1179760,875120,1458533,"IRQ",1166827
1,255.0,"Southern Europe",818311,0,818311,596781,994636,"ITA",795709
1,255.0,"Eastern Africa",432318,0,432318,318222,530371,"ETH",424297
1,255.0,"Northern America",675892,646505,29387,471794,786323,"CAN",629059
1,255.0,"Northern Europe",2122992,2029882,93110,1479730,2466217,"GBR",1972974
1,255.0,"United States of America",2969761,2771976,197785,2179317,3632195,"USA",2905756
1,255.0,"Central Asia",1769852,1718070,51782,1171911,1953185,"UZB",1562548
1,255.0,"India",6944342,6758733,185609,4691154,7818590,"IND",6254872
1,256.0,"Western Europe",4083223,3811789,271434,2754267,4590445,"NLD",3672356
1,256.0,"Western Africa",466460,0,466460,338753,564588,"NGA",451671
1,256.0,"Oceania",610190,595816,14374,442299,737165,"NZL",589732
1,256.0,"South America",2740554,2267092,473462,1479207,2465346,"BRA",1972277
1,256.0,"Northern Africa",1651287,0,1651287,1183118,1971863,"EGY",1577491
1,256.0,"Southern Asia",746875,0,746875,538524,897541,"IRN",718033
1,256.0,"Eastern Europe",3185095,3102347,82748,2085708,3476180,"POL",2780944
1,256.0,"Middle Africa",143711,0,143711,105147,175245,"AGO",140196
1,256.0,"Central America",561909,0,561909,411949,686582,"MEX",549266
1,256.0,"Southern Africa",151495,0,151495,107739,179565,"ZAF",143652
1,256.0,"South-Eastern Asia",1336693,0,1336693,973325,1622208,"IDN",1297767
1,256.0,"China",10635216,10065853,569363,7238028,12063381,"CPR",9650705
1,256.0,"Pakistan",1881591,1767807,113784,1387656,2312760,"PAK",1850208
1,256.0,"Eastern Asia",993267,0,993267,716114,1193523,"JPN",954819
1,256.0,"Russian Federation",2369514,2369514,0,1730008,2883347,"RUS",2306678
1,256.0,"Western Asia",1181017,0,1181017,875120,1458533,"IRQ",1166827
1,256.0,"Southern Europe",819746,0,819746,596781,994636,"ITA",795709
1,256.0,"Eastern Africa",433059,0,433059,318222,530371,"ETH",424297
1,256.0,"Northern America",681746,651239,30507,471794,786323,"CAN",629059
1,256.0,"Northern Europe",2159483,2063195,96288,1479730,2466217,"GBR",1972974
1,256.0,"United States of America",3012437,2816471,195966,2179317,3632195,"USA",2905756
1,256.0,"Central Asia",1781506,1728692,52814,1171911,1953185,"UZB",1562548
1,256.0,"India",6799008,6615499,183509,4691154,7818590,"IND",6254872
1,257.0,"Western Europe",4031864,3773381,258483,2754267,4590445,"NLD",3672356
1,257.0,"Western Africa",466885,0,466885,338753,564588,"NGA",451671
1,257.0,"Oceania",619933,604111,15822,442299,737165,"NZL",589732
1,257.0,"South America",2667375,2266830,400545,1479207,2465346,"BRA",1972277
1,257.0,"Northern Africa",1654952,0,1654952,1183118,1971863,"EGY",1577491
1,257.0,"Southern Asia",748705,0,748705,538524,897541,"IRN",718033
1,257.0,"Eastern Europe",2959022,2889454,69568,2085708,3476180,"POL",2780944
1,257.0,"Middle Africa",143879,0,143879,105147,175245,"AGO",140196
1,257.0,"Central America",564631,0,564631,411949,686582,"MEX",549266
1,257.0,"Southern Africa",151964,0,151964,107739,179565,"ZAF",143652
1,257.0,"South-Eastern Asia",1339106,0,1339106,973325,1622208,"IDN",1297767
1,257.0,"China",10660041,10078933,581108,7238028,12063381,"CPR",9650705
1,257.0,"Pakistan",1912178,1805032,107146,1387656,2312760,"PAK",1850208
1,257.0,"Eastern Asia",1003193,0,1003193,716114,1193523,"JPN",954819
1,257.0,"Russian Federation",2475770,2475770,0,1730008,2883347,"RUS",2306678
1,257.0,"Western Asia",1181919,0,1181919,875120,1458533,"IRQ",1166827
1,257.0,"Southern Europe",820430,0,820430,596781,994636,"ITA",795709
1,257.0,"Eastern Africa",433828,0,433828,318222,530371,"ETH",424297
1,257.0,"Northern America",687600,656122,31478,471794,786323,"CAN",629059
1,257.0,"Northern Europe",2191920,2093330,98590,1479730,2466217,"GBR",1972974
1,257.0,"United States of America",3040886,2847953,192933,2179317,3632195,"USA",2905756
1,257.0,"Central Asia",1790294,1736998,53296,1171911,1953185,"UZB",1562548
1,257.0,"India",6493608,6337053,156555,4691154,7818590,"IND",6254872
1,258.0,"Western Europe",3995181,3748029,247152,2754267,4590445,"NLD",3672356
1,258.0,"Western Africa",467333,0,467333,338753,564588,"NGA",451671
1,258.0,"Oceania",622855,605792,17063,442299,737165,"NZL",589732
1,258.0,"South America",2606544,2268066,338478,1479207,2465346,"BRA",1972277
1,258.0,"Northern Africa",1663143,0,1663143,1183118,1971863,"EGY",1577491
1,258.0,"Southern Asia",749833,0,749833,538524,897541,"IRN",718033
1,258.0,"Eastern Europe",3010471,2951121,59350,2085708,3476180,"POL",2780944
1,258.0,"Middle Africa",144015,0,144015,105147,175245,"AGO",140196
1,258.0,"Central America",567092,0,567092,411949,686582,"MEX",549266
1,258.0,"Southern Africa",152509,0,152509,107739,179565,"ZAF",143652
1,258.0,"South-Eastern Asia",1340480,0,1340480,973325,1622208,"IDN",1297767
1,258.0,"China",10683709,10091782,591927,7238028,12063381,"CPR",9650705
1,258.0,"Pakistan",1772173,1672616,99557,1387656,2312760,"PAK",1850208
1,258.0,"Eastern Asia",1020585,0,1020585,716114,1193523,"JPN",954819
1,258.0,"Russian Federation",2552817,2552817,0,1730008,2883347,"RUS",2306678
1,258.0,"Western Asia",1182472,0,1182472,875120,1458533,"IRQ",1166827
1,258.0,"Southern Europe",821157,0,821157,596781,994636,"ITA",795709
1,258.0,"Eastern Africa",434225,0,434225,318222,530371,"ETH",424297
1,258.0,"Northern America",693454,661168,32286,471794,786323,"CAN",629059
1,258.0,"Northern Europe",2220300,2120293,100007,1479730,2466217,"GBR",1972974
1,258.0,"United States of America",3062221,2873131,189090,2179317,3632195,"USA",2905756
1,258.0,"Central Asia",1660605,1615776,44829,1171911,1953185,"UZB",1562548
1,258.0,"India",6585955,6451326,134629,4691154,7818590,"IND",6254872
1,259.0,"Western Europe",3965832,3728856,236976,2754267,4590445,"NLD",3672356
1,259.0,"Western Africa",467444,0,467444,338753,564588,"NGA",451671
1,259.0,"Oceania",624806,608321,16485,442299,737165,"NZL",589732
1,259.0,"South America",2551520,2266681,284839,1479207,2465346,"BRA",1972277
1,259.0,"Northern Africa",1665893,0,1665893,1183118,1971863,"EGY",1577491
1,259.0,"Southern Asia",750236,0,750236,538524,897541,"IRN",718033
1,259.0,"Eastern Europe",2697263,2648333,48930,2085708,3476180,"POL",2780944
1,259.0,"Middle Africa",144065,0,144065,105147,175245,"AGO",140196
1,259.0,"Central America",569278,0,569278,411949,686582,"MEX",549266
1,259.0,"Southern Africa",152599,0,152599,107739,179565,"ZAF",143652
1,259.0,"South-Eastern Asia",1340871,0,1340871,973325,1622208,"IDN",1297767
1,259.0,"China",10707055,10105583,601472,7238028,12063381,"CPR",9650705
1,259.0,"Pakistan",1816782,1708964,107818,1387656,2312760,"PAK",1850208
1,259.0,"Eastern Asia",1029790,0,1029790,716114,1193523,"JPN",954819
1,259.0,"Russian Federation",2220836,2220836,0,1730008,2883347,"RUS",2306678
1,259.0,"Western Asia",1182671,0,1182671,875120,1458533,"IRQ",1166827
1,259.0,"Southern Europe",821335,0,821335,596781,994636,"ITA",795709
1,259.0,"Eastern Africa",434351,0,434351,318222,530371,"ETH",424297
1,259.0,"Northern America",695405,662489,32916,471794,786323,"CAN",629059
1,259.0,"Northern Europe",2244628,2144088,100540,1479730,2466217,"GBR",1972974
1,259.0,"United States of America",3076445,2891805,184640,2179317,3632195,"USA",2905756
1,259.0,"Central Asia",1533438,1494840,38598,1171911,1953185,"UZB",1562548
1,259.0,"India",6114411,6002320,112091,4691154,7818590,"IND",6254872
1,260.0,"Western Europe",3943823,3716097,227726,2754267,4590445,"NLD",3672356
1,260.0,"Western Africa",467350,0,467350,338753,564588,"NGA",451671
1,260.0,"Oceania",603373,589204,14169,442299,737165,"NZL",589732
1,260.0,"South America",2503423,2267434,235989,1479207,2465346,"BRA",1972277
1,260.0,"Northern Africa",1658856,0,1658856,1183118,1971863,"EGY",1577491
1,260.0,"Southern Asia",747674,0,747674,538524,897541,"IRN",718033
1,260.0,"Eastern Europe",2638116,2596900,41216,2085708,3476180,"POL",2780944
1,260.0,"Middle Africa",143754,0,143754,105147,175245,"AGO",140196
1,260.0,"Central America",570094,0,570094,411949,686582,"MEX",549266
1,260.0,"Southern Africa",151893,0,151893,107739,179565,"ZAF",143652
1,260.0,"South-Eastern Asia",1337293,0,1337293,973325,1622208,"IDN",1297767
1,260.0,"China",10723721,10120740,602981,7238028,12063381,"CPR",9650705
1,260.0,"Pakistan",1860672,1746084,114588,1387656,2312760,"PAK",1850208
1,260.0,"Eastern Asia",1023838,0,1023838,716114,1193523,"JPN",954819
1,260.0,"Russian Federation",2153214,2153214,0,1730008,2883347,"RUS",2306678
1,260.0,"Western Asia",1181409,0,1181409,875120,1458533,"IRQ",1166827
1,260.0,"Southern Europe",821182,0,821182,596781,994636,"ITA",795709
1,260.0,"Eastern Africa",433551,0,433551,318222,530371,"ETH",424297
1,260.0,"Northern America",697355,663922,33433,471794,786323,"CAN",629059
1,260.0,"Northern Europe",2232466,2132270,100196,1479730,2466217,"GBR",1972974
1,260.0,"United States of America",3083558,2903771,179787,2179317,3632195,"USA",2905756
1,260.0,"Central Asia",1514290,1479977,34313,1171911,1953185,"UZB",1562548
1,260.0,"India",6046562,5951902,94660,4691154,7818590,"IND",6254872
1,261.0,"Western Europe",3452253,3233083,219170,2754267,4590445,"NLD",3672356
1,261.0,"Western Africa",459546,0,459546,338753,564588,"NGA",451671
1,261.0,"Oceania",587786,575572,12214,442299,737165,"NZL",589732
1,261.0,"South America",2461923,2266337,195586,1479207,2465346,"BRA",1972277
1,261.0,"Northern Africa",1614662,0,1614662,1183118,1971863,"EGY",1577491
1,261.0,"Southern Asia",731576,0,731576,538524,897541,"IRN",718033
1,261.0,"Eastern Europe",2756242,2722513,33729,2085708,3476180,"POL",2780944
1,261.0,"Middle Africa",141825,0,141825,105147,175245,"AGO",140196
1,261.0,"Central America",572057,0,572057,411949,686582,"MEX",549266
1,261.0,"Southern Africa",147417,0,147417,107739,179565,"ZAF",143652
1,261.0,"South-Eastern Asia",1314752,0,1314752,973325,1622208,"IDN",1297767
1,261.0,"China",10522609,9924398,598211,7238028,12063381,"CPR",9650705
1,261.0,"Pakistan",1898210,1778471,119739,1387656,2312760,"PAK",1850208
1,261.0,"Eastern Asia",984543,0,984543,716114,1193523,"JPN",954819
1,261.0,"Russian Federation",2278114,2278114,0,1730008,2883347,"RUS",2306678
1,261.0,"Western Asia",1173488,0,1173488,875120,1458533,"IRQ",1166827
1,261.0,"Southern Europe",808366,0,808366,596781,994636,"ITA",795709
1,261.0,"Eastern Africa",428527,0,428527,318222,530371,"ETH",424297
1,261.0,"Northern America",757845,724014,33831,471794,786323,"CAN",629059
1,261.0,"Northern Europe",2256791,2157013,99778,1479730,2466217,"GBR",1972974
1,261.0,"United States of America",2998213,2823483,174730,2179317,3632195,"USA",2905756
1,261.0,"Central Asia",1554998,1524796,30202,1171911,1953185,"UZB",1562548
1,261.0,"India",6227432,6149951,77481,4691154,7818590,"IND",6254872
1,262.0,"Western Europe",3540291,3302818,237473,2754267,4590445,"NLD",3672356
1,262.0,"Western Africa",458312,0,458312,338753,564588,"NGA",451671
1,262.0,"Oceania",595576,585109,10467,442299,737165,"NZL",589732
1,262.0,"South America",2227990,2072541,155449,1479207,2465346,"BRA",1972277
1,262.0,"Northern Africa",1611809,0,1611809,1183118,1971863,"EGY",1577491
1,262.0,"Southern Asia",730535,0,730535,538524,897541,"IRN",718033
1,262.0,"Eastern Europe",2828132,2802634,25498,2085708,3476180,"POL",2780944
1,262.0,"Middle Africa",141703,0,141703,105147,175245,"AGO",140196
1,262.0,"Central America",567705,0,567705,411949,686582,"MEX",549266
1,262.0,"Southern Africa",147131,0,147131,107739,179565,"ZAF",143652
1,262.0,"South-Eastern Asia",1313179,0,1313179,973325,1622208,"IDN",1297767
1,262.0,"China",10517429,9916687,600742,7238028,12063381,"CPR",9650705
1,262.0,"Pakistan",1903783,1788521,115262,1387656,2312760,"PAK",1850208
1,262.0,"Eastern Asia",991207,0,991207,716114,1193523,"JPN",954819
1,262.0,"Russian Federation",2356527,2356527,0,1730008,2883347,"RUS",2306678
1,262.0,"Western Asia",1172980,0,1172980,875120,1458533,"IRQ",1166827
1,262.0,"Southern Europe",806473,0,806473,596781,994636,"ITA",795709
1,262.0,"Eastern Africa",428202,0,428202,318222,530371,"ETH",424297
1,262.0,"Northern America",703212,670460,32752,471794,786323,"CAN",629059
1,262.0,"Northern Europe",2256792,2158437,98355,1479730,2466217,"GBR",1972974
1,262.0,"United States of America",3019549,2838863,180686,2179317,3632195,"USA",2905756
1,262.0,"Central Asia",1578835,1553244,25591,1171911,1953185,"UZB",1562548
1,262.0,"India",6327214,6268340,58874,4691154,7818590,"IND",6254872
1,263.0,"Western Europe",3613659,3360595,253064,2754267,4590446,"NLD",3672357
1,263.0,"Western Africa",457808,0,457808,338755,564592,"NGA",451674
1,263.0,"Oceania",593631,584988,8643,442303,737172,"NZL",589738
1,263.0,"South America",2005758,1872400,133358,1479216,2465360,"BRA",1972288
1,263.0,"Northern Africa",1608823,0,1608823,1183121,1971868,"EGY",1577495
1,263.0,"Southern Asia",729449,0,729449,538528,897547,"IRN",718038
1,263.0,"Eastern Europe",2816185,2799172,17013,2085708,3476181,"POL",2780945
1,263.0,"Middle Africa",141569,0,141569,105153,175255,"AGO",140204
1,263.0,"Central America",563990,0,563990,411954,686590,"MEX",549272
1,263.0,"Southern Africa",146826,0,146826,107745,179576,"ZAF",143661
1,263.0,"South-Eastern Asia",1312802,0,1312802,973328,1622213,"IDN",1297771
1,263.0,"China",10538603,9936896,601707,7238028,12063381,"CPR",9650705
1,263.0,"Pakistan",1872593,1764789,107804,1387656,2312760,"PAK",1850208
1,263.0,"Eastern Asia",991078,0,991078,716121,1193536,"JPN",954829
1,263.0,"Russian Federation",2344961,2344961,0,1730016,2883360,"RUS",2306688
1,263.0,"Western Asia",1172447,0,1172447,875123,1458538,"IRQ",1166831
1,263.0,"Southern Europe",805668,0,805668,596783,994638,"ITA",795711
1,263.0,"Eastern Africa",427862,0,427862,318229,530382,"ETH",424306
1,263.0,"Northern America",673942,642644,31298,471799,786332,"CAN",629066
1,263.0,"Northern Europe",2244628,2148138,96490,1479732,2466221,"GBR",1972977
1,263.0,"United States of America",3019548,2833707,185841,2179319,3632198,"USA",2905759
1,263.0,"Central Asia",1574298,1553527,20771,1171917,1953196,"UZB",1562557
1,263.0,"India",6304487,6264661,39826,4691157,7818595,"IND",6254876
1,264.0,"Western Europe",3672354,3406152,266202,3300082,5500137,"NLD",4400110
1,264.0,"Western Africa",457152,0,457152,459093,765155,"NGA",612124
1,264.0,"Oceania",589734,582889,6845,521704,869507,"NZL",695606
1,264.0,"South America",1982904,1849570,133334,1819174,3031957,"BRA",2425566
1,264.0,"Northern Africa",1604383,0,1604383,1422706,2371177,"EGY",1896942
1,264.0,"Southern Asia",727832,0,727832,616301,1027168,"IRN",821735
1,264.0,"Eastern Europe",2783038,2774421,8617,2526639,4211065,"POL",3368852
1,264.0,"Middle Africa",141377,0,141377,134405,224008,"AGO",179207
1,264.0,"Central America",560520,0,560520,449573,749288,"MEX",599431
1,264.0,"Southern Africa",146375,0,146375,92608,154347,"ZAF",123478
1,264.0,"South-Eastern Asia",1311422,0,1311422,997688,1662813,"IDN",1330251
1,264.0,"China",10538270,9938681,599589,8632995,14388326,"CPR",11510661
1,264.0,"Pakistan",1851653,1750154,101499,1657396,2762327,"PAK",2209862
1,264.0,"Eastern Asia",983653,0,983653,789603,1316006,"JPN",1052805
1,264.0,"Russian Federation",2309485,2309485,0,2360121,3933535,"RUS",3146828
1,264.0,"Western Asia",1171649,0,1171649,899769,1499616,"IRQ",1199693
1,264.0,"Southern Europe",804600,0,804600,445337,742228,"ITA",593783
1,264.0,"Eastern Africa",427360,0,427360,341898,569831,"ETH",455865
1,264.0,"Northern America",660281,629290,30991,574107,956846,"CAN",765477
1,264.0,"Northern Europe",2017576,1933997,83579,1693888,2823147,"GBR",2258518
1,264.0,"United States of America",3012436,2821607,190829,2315447,3859078,"USA",3087263
1,264.0,"Central Asia",1563040,1547030,16010,1409299,2348832,"UZB",1879066
1,264.0,"India",6255632,6234672,20960,5873450,9789083,"IND",7831267
1,265.0,"Western Europe",3716377,3436975,279402,3300082,5500137,"NLD",4400110
1,265.0,"Western Africa",456666,0,456666,459093,765155,"NGA",612124
1,265.0,"Oceania",581880,577185,4695,521704,869507,"NZL",695606
1,265.0,"South America",1953857,1821629,132228,1819174,3031957,"BRA",2425566
1,265.0,"Northern Africa",1599617,0,1599617,1422706,2371177,"EGY",1896942
1,265.0,"Southern Asia",726101,0,726101,616301,1027168,"IRN",821735
1,265.0,"Eastern Europe",2716195,2716195,0,2526639,4211065,"POL",3368852
1,265.0,"Middle Africa",141174,0,141174,134405,224008,"AGO",179207
1,265.0,"Central America",557855,0,557855,449573,749288,"MEX",599431
1,265.0,"Southern Africa",145905,0,145905,92608,154347,"ZAF",123478
1,265.0,"South-Eastern Asia",1309004,0,1309004,997688,1662813,"IDN",1330251
1,265.0,"China",10539081,9936763,602318,8632995,14388326,"CPR",11510661
1,265.0,"Pakistan",1825063,1730237,94826,1657396,2762327,"PAK",2209862
1,265.0,"Eastern Asia",974874,0,974874,789603,1316006,"JPN",1052805
1,265.0,"Russian Federation",2237637,2237637,0,2360121,3933535,"RUS",3146828
1,265.0,"Western Asia",1170799,0,1170799,899769,1499616,"IRQ",1199693
1,265.0,"Southern Europe",803811,0,803811,445337,742228,"ITA",593783
1,265.0,"Eastern Africa",426825,0,426825,341898,569831,"ETH",455865
1,265.0,"Northern America",646629,618621,28008,574107,956846,"CAN",765477
1,265.0,"Northern Europe",1940543,1864793,75750,1693888,2823147,"GBR",2258518
1,265.0,"United States of America",3005330,2808904,196426,2315447,3859078,"USA",3087263
1,265.0,"Central Asia",1540442,1530070,10372,1409299,2348832,"UZB",1879066
1,265.0,"India",6157871,6157871,0,5873450,9789083,"IND",7831267
1,266.0,"Western Europe",3813159,3493387,319772,3300082,5500137,"NLD",4400110
1,266.0,"Western Africa",588084,0,588084,459093,765155,"NGA",612124
1,266.0,"Oceania",690719,687775,2944,521704,869507,"NZL",695606
1,266.0,"South America",2374221,2219683,154538,1819174,3031957,"BRA",2425566
1,266.0,"Northern Africa",1783997,0,1783997,1422706,2371177,"EGY",1896942
1,266.0,"Southern Asia",780589,0,780589,616301,1027168,"IRN",821735
1,266.0,"Eastern Europe",3273330,3273330,0,2526639,4211065,"POL",3368852
1,266.0,"Middle Africa",174265,0,174265,134405,224008,"AGO",179207
1,266.0,"Central America",573884,0,573884,449573,749288,"MEX",599431
1,266.0,"Southern Africa",112056,0,112056,92608,154347,"ZAF",123478
1,266.0,"South-Eastern Asia",1283015,0,1283015,997688,1662813,"IDN",1330251
1,266.0,"China",10571833,9928280,643553,8632995,14388326,"CPR",11510661
1,266.0,"Pakistan",1895166,1795289,99877,1657396,2762327,"PAK",2209862
1,266.0,"Eastern Asia",989341,0,989341,789603,1316006,"JPN",1052805
1,266.0,"Russian Federation",2500151,2500151,0,2360121,3933535,"RUS",3146828
1,266.0,"Western Asia",1179449,0,1179449,899769,1499616,"IRQ",1199693
1,266.0,"Southern Europe",560691,0,560691,445337,742228,"ITA",593783
1,266.0,"Eastern Africa",443023,0,443023,341898,569831,"ETH",455865
1,266.0,"Northern America",662057,633941,28116,574107,956846,"CAN",765477
1,266.0,"Northern Europe",2197699,2121874,75825,1693888,2823147,"GBR",2258518
1,266.0,"United States of America",2923686,2722208,201478,2315447,3859078,"USA",3087263
1,266.0,"Central Asia",1851091,1845717,5374,1409299,2348832,"UZB",1879066
1,266.0,"India",6970021,6968911,1110,5873450,9789083,"IND",7831267
1,267.0,"Western Europe",3901202,3543943,357259,3300082,5500137,"NLD",4400110
1,267.0,"Western Africa",593995,0,593995,459093,765155,"NGA",612124
1,267.0,"Oceania",706320,705458,862,521704,869507,"NZL",695606
1,267.0,"South America",2442211,2307226,134985,1819174,3031957,"BRA",2425566
1,267.0,"Northern Africa",1805386,0,1805386,1422706,2371177,"EGY",1896942
1,267.0,"Southern Asia",788384,0,788384,616301,1027168,"IRN",821735
1,267.0,"Eastern Europe",3184774,3184774,0,2526639,4211065,"POL",3368852
1,267.0,"Middle Africa",175201,0,175201,134405,224008,"AGO",179207
1,267.0,"Central America",578950,0,578950,449573,749288,"MEX",599431
1,267.0,"Southern Africa",114207,0,114207,92608,154347,"ZAF",123478
1,267.0,"South-Eastern Asia",1302237,0,1302237,997688,1662813,"IDN",1330251
1,267.0,"China",10601560,9934053,667507,8632995,14388326,"CPR",11510661
1,267.0,"Pakistan",1934554,1821739,112815,1657396,2762327,"PAK",2209862
1,267.0,"Eastern Asia",1003171,0,1003171,789603,1316006,"JPN",1052805
1,267.0,"Russian Federation",2484715,2474347,10368,2360121,3933535,"RUS",3146828
1,267.0,"Western Asia",1183286,0,1183286,899769,1499616,"IRQ",1199693
1,267.0,"Southern Europe",562462,0,562462,445337,742228,"ITA",593783
1,267.0,"Eastern Africa",445449,0,445449,341898,569831,"ETH",455865
1,267.0,"Northern America",691325,661118,30207,574107,956846,"CAN",765477
1,267.0,"Northern Europe",2177426,2107184,70242,1693888,2823147,"GBR",2258518
1,267.0,"United States of America",2923685,2716524,207161,2315447,3859078,"USA",3087263
1,267.0,"Central Asia",1888967,1888967,0,1409299,2348832,"UZB",1879066
1,267.0,"India",7007885,6979258,28627,5873450,9789083,"IND",7831267
1,268.0,"Western Europe",3981906,3590042,391864,3300082,5500137,"NLD",4400110
1,268.0,"Western Africa",596701,0,596701,459093,765155,"NGA",612124
1,268.0,"Oceania",702427,702427,0,521704,869507,"NZL",695606
1,268.0,"South America",2433925,2322893,111032,1819174,3031957,"BRA",2425566
1,268.0,"Northern Africa",1819051,0,1819051,1422706,2371177,"EGY",1896942
1,268.0,"Southern Asia",793361,0,793361,616301,1027168,"IRN",821735
1,268.0,"Eastern Europe",3147078,3144011,3067,2526639,4211065,"POL",3368852
1,268.0,"Middle Africa",175797,0,175797,134405,224008,"AGO",179207
1,268.0,"Central America",582217,0,582217,449573,749288,"MEX",599431
1,268.0,"Southern Africa",115590,0,115590,92608,154347,"ZAF",123478
1,268.0,"South-Eastern Asia",1307413,0,1307413,997688,1662813,"IDN",1330251
1,268.0,"China",10624228,9921521,702707,8632995,14388326,"CPR",11510661
1,268.0,"Pakistan",1961518,1830615,130903,1657396,2762327,"PAK",2209862
1,268.0,"Eastern Asia",1010701,0,1010701,789603,1316006,"JPN",1052805
1,268.0,"Russian Federation",2503912,2479229,24683,2360121,3933535,"RUS",3146828
1,268.0,"Western Asia",1185731,0,1185731,899769,1499616,"IRQ",1199693
1,268.0,"Southern Europe",567318,0,567318,445337,742228,"ITA",593783
1,268.0,"Eastern Africa",447007,0,447007,341898,569831,"ETH",455865
1,268.0,"Northern America",708887,677181,31706,574107,956846,"CAN",765477
1,268.0,"Northern Europe",2173371,2107374,65997,1693888,2823147,"GBR",2258518
1,268.0,"United States of America",2937908,2725064,212844,2315447,3859078,"USA",3087263
1,268.0,"Central Asia",1788165,1788165,0,1409299,2348832,"UZB",1879066
1,268.0,"India",7638743,7581472,57271,5873450,9789083,"IND",7831267
1,269.0,"Western Europe",4055273,3631663,423610,3300082,5500137,"NLD",4400110
1,269.0,"Western Africa",598801,0,598801,459093,765155,"NGA",612124
1,269.0,"Oceania",694633,694633,0,521704,869507,"NZL",695606
1,269.0,"South America",2409830,2319648,90182,1819174,3031957,"BRA",2425566
1,269.0,"Northern Africa",1829672,0,1829672,1422706,2371177,"EGY",1896942
1,269.0,"Southern Asia",797227,0,797227,616301,1027168,"IRN",821735
1,269.0,"Eastern Europe",3120511,3115791,4720,2526639,4211065,"POL",3368852
1,269.0,"Middle Africa",176262,0,176262,134405,224008,"AGO",179207
1,269.0,"Central America",584838,0,584838,449573,749288,"MEX",599431
1,269.0,"Southern Africa",116664,0,116664,92608,154347,"ZAF",123478
1,269.0,"South-Eastern Asia",1310305,0,1310305,997688,1662813,"IDN",1330251
1,269.0,"China",10644762,9909907,734855,8632995,14388326,"CPR",11510661
1,269.0,"Pakistan",1978086,1830468,147618,1657396,2762327,"PAK",2209862
1,269.0,"Eastern Asia",1015621,0,1015621,789603,1316006,"JPN",1052805
1,269.0,"Russian Federation",2550676,2508858,41818,2360121,3933535,"RUS",3146828
1,269.0,"Western Asia",1187637,0,1187637,899769,1499616,"IRQ",1199693
1,269.0,"Southern Europe",571618,0,571618,445337,742228,"ITA",593783
1,269.0,"Eastern Africa",448212,0,448212,341898,569831,"ETH",455865
1,269.0,"Northern America",722546,689697,32849,574107,956846,"CAN",765477
1,269.0,"Northern Europe",2169317,2108719,60598,1693888,2823147,"GBR",2258518
1,269.0,"United States of America",2952132,2734101,218031,2315447,3859078,"USA",3087263
1,269.0,"Central Asia",1745215,1745215,0,1409299,2348832,"UZB",1879066
1,269.0,"India",7646705,7564573,82132,5873450,9789083,"IND",7831267
1,270.0,"Western Europe",4113970,3661391,452579,3300082,5500137,"NLD",4400110
1,270.0,"Western Africa",600655,0,600655,459093,765155,"NGA",612124
1,270.0,"Oceania",694631,694631,0,521704,869507,"NZL",695606
1,270.0,"South America",2416560,2337365,79195,1819174,3031957,"BRA",2425566
1,270.0,"Northern Africa",1839031,0,1839031,1422706,2371177,"EGY",1896942
1,270.0,"Southern Asia",800639,0,800639,616301,1027168,"IRN",821735
1,270.0,"Eastern Europe",3092246,3084127,8119,2526639,4211065,"POL",3368852
1,270.0,"Middle Africa",176670,0,176670,134405,224008,"AGO",179207
1,270.0,"Central America",586573,0,586573,449573,749288,"MEX",599431
1,270.0,"Southern Africa",117612,0,117612,92608,154347,"ZAF",123478
1,270.0,"South-Eastern Asia",1312646,0,1312646,997688,1662813,"IDN",1330251
1,270.0,"China",10689359,9923106,766253,8632995,14388326,"CPR",11510661
1,270.0,"Pakistan",1969532,1805536,163996,1657396,2762327,"PAK",2209862
1,270.0,"Eastern Asia",1020268,0,1020268,789603,1316006,"JPN",1052805
1,270.0,"Russian Federation",2597009,2537942,59067,2360121,3933535,"RUS",3146828
1,270.0,"Western Asia",1189313,0,1189313,899769,1499616,"IRQ",1199693
1,270.0,"Southern Europe",574722,0,574722,445337,742228,"ITA",593783
1,270.0,"Eastern Africa",449277,0,449277,341898,569831,"ETH",455865
1,270.0,"Northern America",728399,694684,33715,574107,956846,"CAN",765477
1,270.0,"Northern Europe",2169316,2107689,61627,1693888,2823147,"GBR",2258518
1,270.0,"United States of America",2966357,2743632,222725,2315447,3859078,"USA",3087263
1,270.0,"Central Asia",1735766,1729228,6538,1409299,2348832,"UZB",1879066
1,270.0,"India",7658938,7551687,107251,5873450,9789083,"IND",7831267
1,271.0,"Western Europe",4172663,3693419,479244,3300082,5500137,"NLD",4400110
1,271.0,"Western Africa",601708,0,601708,459093,765155,"NGA",612124
1,271.0,"Oceania",684889,684889,0,521704,869507,"NZL",695606
1,271.0,"South America",2388305,2316640,71665,1819174,3031957,"BRA",2425566
1,271.0,"Northern Africa",1844345,0,1844345,1422706,2371177,"EGY",1896942
1,271.0,"Southern Asia",802572,0,802572,616301,1027168,"IRN",821735
1,271.0,"Eastern Europe",3084726,3065778,18948,2526639,4211065,"POL",3368852
1,271.0,"Middle Africa",176904,0,176904,134405,224008,"AGO",179207
1,271.0,"Central America",587824,0,587824,449573,749288,"MEX",599431
1,271.0,"Southern Africa",118152,0,118152,92608,154347,"ZAF",123478
1,271.0,"South-Eastern Asia",1312847,0,1312847,997688,1662813,"IDN",1330251
1,271.0,"China",10710141,9916902,793239,8632995,14388326,"CPR",11510661
1,271.0,"Pakistan",1984013,1803729,180284,1657396,2762327,"PAK",2209862
1,271.0,"Eastern Asia",1020896,0,1020896,789603,1316006,"JPN",1052805
1,271.0,"Russian Federation",2641353,2567029,74324,2360121,3933535,"RUS",3146828
1,271.0,"Western Asia",1190266,0,1190266,899769,1499616,"IRQ",1199693
1,271.0,"Southern Europe",577468,0,577468,445337,742228,"ITA",593783
1,271.0,"Eastern Africa",449883,0,449883,341898,569831,"ETH",455865
1,271.0,"Northern America",734253,699790,34463,574107,956846,"CAN",765477
1,271.0,"Northern Europe",2173370,2110312,63058,1693888,2823147,"GBR",2258518
1,271.0,"United States of America",2973468,2746544,226924,2315447,3859078,"USA",3087263
1,271.0,"Central Asia",1734885,1722017,12868,1409299,2348832,"UZB",1879066
1,271.0,"India",7682704,7550806,131898,5873450,9789083,"IND",7831267
1,272.0,"Western Europe",4216685,3713244,503441,3300082,5500137,"NLD",4400110
1,272.0,"Western Africa",601279,0,601279,459093,765155,"NGA",612124
1,272.0,"Oceania",666381,666381,0,521704,869507,"NZL",695606
1,272.0,"South America",2400413,2336940,63473,1819174,3031957,"BRA",2425566
1,272.0,"Northern Africa",1842189,0,1842189,1422706,2371177,"EGY",1896942
1,272.0,"Southern Asia",801790,0,801790,616301,1027168,"IRN",821735
1,272.0,"Eastern Europe",3611381,3581189,30192,2526639,4211065,"POL",3368852
1,272.0,"Middle Africa",176808,0,176808,134405,224008,"AGO",179207
1,272.0,"Central America",588268,0,588268,449573,749288,"MEX",599431
1,272.0,"Southern Africa",117930,0,117930,92608,154347,"ZAF",123478
1,272.0,"South-Eastern Asia",1311426,0,1311426,997688,1662813,"IDN",1330251
1,272.0,"China",10727547,9913363,814184,8632995,14388326,"CPR",11510661
1,272.0,"Pakistan",1995366,1801197,194169,1657396,2762327,"PAK",2209862
1,272.0,"Eastern Asia",1018489,0,1018489,789603,1316006,"JPN",1052805
1,272.0,"Russian Federation",2683807,2598080,85727,2360121,3933535,"RUS",3146828
1,272.0,"Western Asia",1189879,0,1189879,899769,1499616,"IRQ",1199693
1,272.0,"Southern Europe",578649,0,578649,445337,742228,"ITA",593783
1,272.0,"Eastern Africa",449636,0,449636,341898,569831,"ETH",455865
1,272.0,"Northern America",736206,701113,35093,574107,956846,"CAN",765477
1,272.0,"Northern Europe",1946320,1881895,64425,1693888,2823147,"GBR",2258518
1,272.0,"United States of America",2987693,2756816,230877,2315447,3859078,"USA",3087263
1,272.0,"Central Asia",1756154,1737531,18623,1409299,2348832,"UZB",1879066
1,272.0,"India",7669662,7538104,131558,5873450,9789083,"IND",7831267
1,273.0,"Western Europe",4803633,4291324,512309,3300082,5500137,"NLD",4400110
1,273.0,"Western Africa",621171,0,621171,459093,765155,"NGA",612124
1,273.0,"Oceania",641050,641050,0,521704,869507,"NZL",695606
1,273.0,"South America",2420905,2362999,57906,1819174,3031957,"BRA",2425566
1,273.0,"Northern Africa",1941401,0,1941401,1422706,2371177,"EGY",1896942
1,273.0,"Southern Asia",837923,0,837923,616301,1027168,"IRN",821735
1,273.0,"Eastern Europe",3602288,3563287,39001,2526639,4211065,"POL",3368852
1,273.0,"Middle Africa",181149,0,181149,134405,224008,"AGO",179207
1,273.0,"Central America",607800,0,607800,449573,749288,"MEX",599431
1,273.0,"Southern Africa",128227,0,128227,92608,154347,"ZAF",123478
1,273.0,"South-Eastern Asia",1334296,0,1334296,997688,1662813,"IDN",1330251
1,273.0,"China",10677123,9849856,827267,8632995,14388326,"CPR",11510661
1,273.0,"Pakistan",2019512,1813418,206094,1657396,2762327,"PAK",2209862
1,273.0,"Eastern Asia",1058054,0,1058054,789603,1316006,"JPN",1052805
1,273.0,"Russian Federation",2871933,2780114,91819,2360121,3933535,"RUS",3146828
1,273.0,"Western Asia",1207941,0,1207941,899769,1499616,"IRQ",1199693
1,273.0,"Southern Europe",613433,0,613433,445337,742228,"ITA",593783
1,273.0,"Eastern Africa",460917,0,460917,341898,569831,"ETH",455865
1,273.0,"Northern America",833767,798084,35683,574107,956846,"CAN",765477
1,273.0,"Northern Europe",1974700,1897958,76742,1693888,2823147,"GBR",2258518
1,273.0,"United States of America",3137044,2902709,234335,2315447,3859078,"USA",3087263
1,273.0,"Central Asia",1761341,1738111,23230,1409299,2348832,"UZB",1879066
1,273.0,"India",7667796,7524438,143358,5873450,9789083,"IND",7831267
1,274.0,"Western Europe",4737610,4244814,492796,3300082,5500137,"NLD",4400110
1,274.0,"Western Africa",621817,0,621817,459093,765155,"NGA",612124
1,274.0,"Oceania",672218,670022,2196,521704,869507,"NZL",695606
1,274.0,"South America",2450913,2397187,53726,1819174,3031957,"BRA",2425566
1,274.0,"Northern Africa",1938756,0,1938756,1422706,2371177,"EGY",1896942
1,274.0,"Southern Asia",837353,0,837353,616301,1027168,"IRN",821735
1,274.0,"Eastern Europe",3617964,3576652,41312,2526639,4211065,"POL",3368852
1,274.0,"Middle Africa",180964,0,180964,134405,224008,"AGO",179207
1,274.0,"Central America",607824,0,607824,449573,749288,"MEX",599431
1,274.0,"Southern Africa",128027,0,128027,92608,154347,"ZAF",123478
1,274.0,"South-Eastern Asia",1337601,0,1337601,997688,1662813,"IDN",1330251
1,274.0,"China",10706080,9854991,851089,8632995,14388326,"CPR",11510661
1,274.0,"Pakistan",2055116,1835288,219828,1657396,2762327,"PAK",2209862
1,274.0,"Eastern Asia",1065613,0,1065613,789603,1316006,"JPN",1052805
1,274.0,"Russian Federation",2942410,2841074,101336,2360121,3933535,"RUS",3146828
1,274.0,"Western Asia",1207682,0,1207682,899769,1499616,"IRQ",1199693
1,274.0,"Southern Europe",609612,0,609612,445337,742228,"ITA",593783
1,274.0,"Eastern Africa",460946,0,460946,341898,569831,"ETH",455865
1,274.0,"Northern America",804507,770202,34305,574107,956846,"CAN",765477
1,274.0,"Northern Europe",2003082,1914082,89000,1693888,2823147,"GBR",2258518
1,274.0,"United States of America",3144162,2911554,232608,2315447,3859078,"USA",3087263
1,274.0,"Central Asia",1641185,1611814,29371,1409299,2348832,"UZB",1879066
1,274.0,"India",7694106,7526617,167489,5873450,9789083,"IND",7831267
1,275.0,"Western Europe",4693587,4217112,476475,3300082,5500137,"NLD",4400110
1,275.0,"Western Africa",620543,0,620543,459096,765160,"NGA",612128
1,275.0,"Oceania",683913,679539,4374,521706,869511,"NZL",695609
1,275.0,"South America",2445216,2398454,46762,1819181,3031968,"BRA",2425575
1,275.0,"Northern Africa",1939761,0,1939761,1422708,2371181,"EGY",1896945
1,275.0,"Southern Asia",836166,0,836166,616305,1027176,"IRN",821741
1,275.0,"Eastern Europe",3529698,3499593,30105,2526643,4211072,"POL",3368858
1,275.0,"Middle Africa",180938,0,180938,134413,224022,"AGO",179218
1,275.0,"Central America",606180,0,606180,449574,749290,"MEX",599432
1,275.0,"Southern Africa",127500,0,127500,92611,154352,"ZAF",123482
1,275.0,"South-Eastern Asia",1337359,0,1337359,997692,1662821,"IDN",1330257
1,275.0,"China",10732401,9855215,877186,8632995,14388326,"CPR",11510661
1,275.0,"Pakistan",2093131,1856629,236502,1657396,2762327,"PAK",2209862
1,275.0,"Eastern Asia",1065729,0,1065729,789604,1316007,"JPN",1052806
1,275.0,"Russian Federation",3022424,2906449,115975,2360126,3933543,"RUS",3146835
1,275.0,"Western Asia",1206753,0,1206753,899770,1499617,"IRQ",1199694
1,275.0,"Southern Europe",606828,0,606828,445342,742237,"ITA",593790
1,275.0,"Eastern Africa",460358,0,460358,341904,569841,"ETH",455873
1,275.0,"Northern America",788895,755378,33517,574116,956860,"CAN",765488
1,275.0,"Northern Europe",2027410,1926324,101086,1693896,2823161,"GBR",2258529
1,275.0,"United States of America",3144162,2913529,230633,2315455,3859092,"USA",3087274
1,275.0,"Central Asia",1648301,1610302,37999,1409303,2348838,"UZB",1879071
1,275.0,"India",7707369,7515099,192270,5873454,9789090,"IND",7831272
1,276.0,"Western Europe",4649567,4187283,462284,3160221,5267036,"NLD",4213629
1,276.0,"Western Africa",619617,0,619617,467672,779453,"NGA",623563
1,276.0,"Oceania",688785,682257,6528,523754,872923,"NZL",698339
1,276.0,"South America",2411444,2372100,39344,1676506,2794177,"BRA",2235342
1,276.0,"Northern Africa",1935394,0,1935394,1448138,2413563,"EGY",1930851
1,276.0,"Southern Asia",834373,0,834373,325048,541747,"IRN",433398
1,276.0,"Eastern Europe",3410896,3391369,19527,2219920,3699867,"POL",2959894
1,276.0,"Middle Africa",180723,0,180723,107690,179483,"AGO",143587
1,276.0,"Central America",605126,0,605126,381239,635398,"MEX",508319
1,276.0,"Southern Africa",127001,0,127001,125496,209161,"ZAF",167329
1,276.0,"South-Eastern Asia",1336882,0,1336882,969194,1615323,"IDN",1292259
1,276.0,"China",10756680,9852971,903709,7926789,13211315,"CPR",10569052
1,276.0,"Pakistan",2126793,1875381,251412,1540483,2567472,"PAK",2053978
1,276.0,"Eastern Asia",1064973,0,1064973,673410,1122350,"JPN",897880
1,276.0,"Russian Federation",3099224,2967635,131589,2260715,3767858,"RUS",3014287
1,276.0,"Western Asia",1205872,0,1205872,574432,957387,"IRQ",765910
1,276.0,"Southern Europe",604826,0,604826,631939,1053232,"ITA",842586
1,276.0,"Eastern Africa",459797,0,459797,365953,609922,"ETH",487938
1,276.0,"Northern America",781090,748045,33045,712305,1187176,"CAN",949741
1,276.0,"Northern Europe",2051736,1938749,112987,1641240,2735401,"GBR",2188321
1,276.0,"United States of America",3144162,2915504,228658,2102022,3503370,"USA",2802696
1,276.0,"Central Asia",1657087,1610008,47079,1116564,1860941,"UZB",1488753
1,276.0,"India",7732127,7514751,217376,5457369,9095616,"IND",7276493
1,277.0,"Western Europe",4612882,4162661,450221,3160221,5267036,"NLD",4213629
1,277.0,"Western Africa",618694,0,618694,467672,779453,"NGA",623563
1,277.0,"Oceania",494938,486263,8675,523754,872923,"NZL",698339
1,277.0,"South America",847902,813532,34370,1676506,2794177,"BRA",2235342
1,277.0,"Northern Africa",1930662,0,1930662,1448138,2413563,"EGY",1930851
1,277.0,"Southern Asia",811098,0,811098,325048,541747,"IRN",433398
1,277.0,"Eastern Europe",3298385,3287804,10581,2219920,3699867,"POL",2959894
1,277.0,"Middle Africa",177943,0,177943,107690,179483,"AGO",143587
1,277.0,"Central America",604568,0,604568,381239,635398,"MEX",508319
1,277.0,"Southern Africa",120535,0,120535,125496,209161,"ZAF",167329
1,277.0,"South-Eastern Asia",1306108,0,1306108,969194,1615323,"IDN",1292259
1,277.0,"China",10756967,9872070,884897,7926789,13211315,"CPR",10569052
1,277.0,"Pakistan",2139564,1892839,246725,1540483,2567472,"PAK",2053978
1,277.0,"Eastern Asia",1011545,0,1011545,673410,1122350,"JPN",897880
1,277.0,"Russian Federation",3080509,2985259,95250,2260715,3767858,"RUS",3014287
1,277.0,"Western Asia",1194424,0,1194424,574432,957387,"IRQ",765910
1,277.0,"Southern Europe",603410,0,603410,631939,1053232,"ITA",842586
1,277.0,"Eastern Africa",452542,0,452542,365953,609922,"ETH",487938
1,277.0,"Northern America",777198,744467,32731,712305,1187176,"CAN",949741
1,277.0,"Northern Europe",2067966,1943561,124405,1641240,2735401,"GBR",2188321
1,277.0,"United States of America",3144173,2917490,226683,2102022,3503370,"USA",2802696
1,277.0,"Central Asia",1704028,1657674,46354,1116564,1860941,"UZB",1488753
1,277.0,"India",7731636,7504040,227596,5457369,9095616,"IND",7276493
1,278.0,"Western Europe",4609822,4178910,430912,3160221,5267036,"NLD",4213629
1,278.0,"Western Africa",637543,0,637543,467672,779453,"NGA",623563
1,278.0,"Oceania",650577,640334,10243,523754,872923,"NZL",698339
1,278.0,"South America",1085956,912429,173527,1676506,2794177,"BRA",2235342
1,278.0,"Northern Africa",2002297,0,2002297,1448138,2413563,"EGY",1930851
1,278.0,"Southern Asia",457689,0,457689,325048,541747,"IRN",433398
1,278.0,"Eastern Europe",3215280,3213665,1615,2219920,3699867,"POL",2959894
1,278.0,"Middle Africa",146253,0,146253,107690,179483,"AGO",143587
1,278.0,"Central America",534031,0,534031,381239,635398,"MEX",508319
1,278.0,"Southern Africa",172544,0,172544,125496,209161,"ZAF",167329
1,278.0,"South-Eastern Asia",1304261,0,1304261,969194,1615323,"IDN",1292259
1,278.0,"China",10765842,9873313,892529,7926789,13211315,"CPR",10569052
1,278.0,"Pakistan",2174862,1933472,241390,1540483,2567472,"PAK",2053978
1,278.0,"Eastern Asia",933390,0,933390,673410,1122350,"JPN",897880
1,278.0,"Russian Federation",3107902,3028507,79395,2260715,3767858,"RUS",3014287
1,278.0,"Western Asia",777801,0,777801,574432,957387,"IRQ",765910
1,278.0,"Southern Europe",861627,0,861627,631939,1053232,"ITA",842586
1,278.0,"Eastern Africa",494178,0,494178,365953,609922,"ETH",487938
1,278.0,"Northern America",930221,894002,36219,712305,1187176,"CAN",949741
1,278.0,"Northern Europe",2058575,1931346,127229,1641240,2735401,"GBR",2188321
1,278.0,"United States of America",3065840,2851023,214817,2102022,3503370,"USA",2802696
1,278.0,"Central Asia",1760272,1719803,40469,1116564,1860941,"UZB",1488753
1,278.0,"India",7728127,7511998,216129,5457369,9095616,"IND",7276493
1,279.0,"Western Europe",4536453,4124701,411752,3160221,5267036,"NLD",4213629
1,279.0,"Western Africa",634386,0,634386,467672,779453,"NGA",623563
1,279.0,"Oceania",696383,685772,10611,523754,872923,"NZL",698339
1,279.0,"South America",1336746,1028079,308667,1676506,2794177,"BRA",2235342
1,279.0,"Northern Africa",1986539,0,1986539,1448138,2413563,"EGY",1930851
1,279.0,"Southern Asia",452450,0,452450,325048,541747,"IRN",433398
1,279.0,"Eastern Europe",3104895,3104895,0,2219920,3699867,"POL",2959894
1,279.0,"Middle Africa",145869,0,145869,107690,179483,"AGO",143587
1,279.0,"Central America",519846,0,519846,381239,635398,"MEX",508319
1,279.0,"Southern Africa",172622,0,172622,125496,209161,"ZAF",167329
1,279.0,"South-Eastern Asia",1318600,0,1318600,969194,1615323,"IDN",1292259
1,279.0,"China",10790393,9888253,902140,7926789,13211315,"CPR",10569052
1,279.0,"Pakistan",2169187,1936197,232990,1540483,2567472,"PAK",2053978
1,279.0,"Eastern Asia",922864,0,922864,673410,1122350,"JPN",897880
1,279.0,"Russian Federation",3133665,3047345,86320,2260715,3767858,"RUS",3014287
1,279.0,"Western Asia",775216,0,775216,574432,957387,"IRQ",765910
1,279.0,"Southern Europe",859260,0,859260,631939,1053232,"ITA",842586
1,279.0,"Eastern Africa",493854,0,493854,365953,609922,"ETH",487938
1,279.0,"Northern America",947786,911174,36612,712305,1187176,"CAN",949741
1,279.0,"Northern Europe",2062630,1932356,130274,1641240,2735401,"GBR",2188321
1,279.0,"United States of America",2952051,2746376,205675,2102022,3503370,"USA",2802696
1,279.0,"Central Asia",1761663,1724015,37648,1116564,1860941,"UZB",1488753
1,279.0,"India",7731138,7523353,207785,5457369,9095616,"IND",7276493
1,280.0,"Western Europe",4455750,4059609,396141,3160221,5267036,"NLD",4213629
1,280.0,"Western Africa",631303,0,631303,467672,779453,"NGA",623563
1,280.0,"Oceania",722690,712065,10625,523754,872923,"NZL",698339
1,280.0,"South America",1524398,1094682,429716,1676506,2794177,"BRA",2235342
1,280.0,"Northern Africa",1970752,0,1970752,1448138,2413563,"EGY",1930851
1,280.0,"Southern Asia",449858,0,449858,325048,541747,"IRN",433398
1,280.0,"Eastern Europe",2992882,2992882,0,2219920,3699867,"POL",2959894
1,280.0,"Middle Africa",145562,0,145562,107690,179483,"AGO",143587
1,280.0,"Central America",515202,0,515202,381239,635398,"MEX",508319
1,280.0,"Southern Africa",171917,0,171917,125496,209161,"ZAF",167329
1,280.0,"South-Eastern Asia",1315095,0,1315095,969194,1615323,"IDN",1292259
1,280.0,"China",10790105,9880444,909661,7926789,13211315,"CPR",10569052
1,280.0,"Pakistan",2172863,1935807,237056,1540483,2567472,"PAK",2053978
1,280.0,"Eastern Asia",921601,0,921601,673410,1122350,"JPN",897880
1,280.0,"Russian Federation",3187389,3085009,102380,2260715,3767858,"RUS",3014287
1,280.0,"Western Asia",773957,0,773957,574432,957387,"IRQ",765910
1,280.0,"Southern Europe",854361,0,854361,631939,1053232,"ITA",842586
1,280.0,"Eastern Africa",493061,0,493061,365953,609922,"ETH",487938
1,280.0,"Northern America",955593,918943,36650,712305,1187176,"CAN",949741
1,280.0,"Northern Europe",2066685,1933461,133224,1641240,2735401,"GBR",2188321
1,280.0,"United States of America",2888044,2687556,200488,2102022,3503370,"USA",2802696
1,280.0,"Central Asia",1762899,1729030,33869,1116564,1860941,"UZB",1488753
1,280.0,"India",8121004,7919861,201143,5457369,9095616,"IND",7276493
1,281.0,"Western Europe",4397053,4012620,384433,3160221,5267036,"NLD",4213629
1,281.0,"Western Africa",629374,0,629374,467672,779453,"NGA",623563
1,281.0,"Oceania",734387,723948,10439,523754,872923,"NZL",698339
1,281.0,"South America",1672399,1145510,526889,1676506,2794177,"BRA",2235342
1,281.0,"Northern Africa",1960777,0,1960777,1448138,2413563,"EGY",1930851
1,281.0,"Southern Asia",447779,0,447779,325048,541747,"IRN",433398
1,281.0,"Eastern Europe",2880772,2880772,0,2219920,3699867,"POL",2959894
1,281.0,"Middle Africa",145311,0,145311,107690,179483,"AGO",143587
1,281.0,"Central America",513208,0,513208,381239,635398,"MEX",508319
1,281.0,"Southern Africa",171335,0,171335,125496,209161,"ZAF",167329
1,281.0,"South-Eastern Asia",1312211,0,1312211,969194,1615323,"IDN",1292259
1,281.0,"China",10811193,9894823,916370,7926789,13211315,"CPR",10569052
1,281.0,"Pakistan",2182010,1940709,241301,1540483,2567472,"PAK",2053978
1,281.0,"Eastern Asia",921854,0,921854,673410,1122350,"JPN",897880
1,281.0,"Russian Federation",3240215,3125655,114560,2260715,3767858,"RUS",3014287
1,281.0,"Western Asia",772942,0,772942,574432,957387,"IRQ",765910
1,281.0,"Southern Europe",851289,0,851289,631939,1053232,"ITA",842586
1,281.0,"Eastern Africa",492411,0,492411,365953,609922,"ETH",487938
1,281.0,"Northern America",957548,921015,36533,712305,1187176,"CAN",949741
1,281.0,"Northern Europe",2066684,1930605,136079,1641240,2735401,"GBR",2188321
1,281.0,"United States of America",2859594,2662070,197524,2102022,3503370,"USA",2802696
1,281.0,"Central Asia",1763475,1732879,30596,1116564,1860941,"UZB",1488753
1,281.0,"India",8114901,7926709,188192,5457369,9095616,"IND",7276493
1,282.0,"Western Europe",4353033,3977469,375564,3160221,5267036,"NLD",4213629
1,282.0,"Western Africa",627850,0,627850,467672,779453,"NGA",623563
1,282.0,"Oceania",738284,727704,10580,523754,872923,"NZL",698339
1,282.0,"South America",1797987,1192944,605043,1676506,2794177,"BRA",2235342
1,282.0,"Northern Africa",1952940,0,1952940,1448138,2413563,"EGY",1930851
1,282.0,"Southern Asia",445513,0,445513,325048,541747,"IRN",433398
1,282.0,"Eastern Europe",2784872,2784872,0,2219920,3699867,"POL",2959894
1,282.0,"Middle Africa",145041,0,145041,107690,179483,"AGO",143587
1,282.0,"Central America",511766,0,511766,381239,635398,"MEX",508319
1,282.0,"Southern Africa",170707,0,170707,125496,209161,"ZAF",167329
1,282.0,"South-Eastern Asia",1309066,0,1309066,969194,1615323,"IDN",1292259
1,282.0,"China",10809594,9889661,919933,7926789,13211315,"CPR",10569052
1,282.0,"Pakistan",2367579,2123778,243801,1540483,2567472,"PAK",2053978
1,282.0,"Eastern Asia",927065,0,927065,673410,1122350,"JPN",897880
1,282.0,"Russian Federation",3291801,3170194,121607,2260715,3767858,"RUS",3014287
1,282.0,"Western Asia",771833,0,771833,574432,957387,"IRQ",765910
1,282.0,"Southern Europe",848873,0,848873,631939,1053232,"ITA",842586
1,282.0,"Eastern Africa",491708,0,491708,365953,609922,"ETH",487938
1,282.0,"Northern America",957549,921172,36377,712305,1187176,"CAN",949741
1,282.0,"Northern Europe",2070739,1931806,138933,1641240,2735401,"GBR",2188321
1,282.0,"United States of America",2838258,2642710,195548,2102022,3503370,"USA",2802696
1,282.0,"Central Asia",1764212,1734123,30089,1116564,1860941,"UZB",1488753
1,282.0,"India",7739139,7582988,156151,5457369,9095616,"IND",7276493
1,283.0,"Western Europe",4316348,3947524,368824,3160221,5267036,"NLD",4213629
1,283.0,"Western Africa",626800,0,626800,467672,779453,"NGA",623563
1,283.0,"Oceania",734390,722098,12292,523754,872923,"NZL",698339
1,283.0,"South America",1906589,1234093,672496,1676506,2794177,"BRA",2235342
1,283.0,"Northern Africa",1947513,0,1947513,1448138,2413563,"EGY",1930851
1,283.0,"Southern Asia",443221,0,443221,325048,541747,"IRN",433398
1,283.0,"Eastern Europe",2787255,2787255,0,2219920,3699867,"POL",2959894
1,283.0,"Middle Africa",144765,0,144765,107690,179483,"AGO",143587
1,283.0,"Central America",510972,0,510972,381239,635398,"MEX",508319
1,283.0,"Southern Africa",170068,0,170068,125496,209161,"ZAF",167329
1,283.0,"South-Eastern Asia",1305878,0,1305878,969194,1615323,"IDN",1292259
1,283.0,"China",10812528,9885982,926546,7926789,13211315,"CPR",10569052
1,283.0,"Pakistan",2358146,2126723,231423,1540483,2567472,"PAK",2053978
1,283.0,"Eastern Asia",921618,0,921618,673410,1122350,"JPN",897880
1,283.0,"Russian Federation",3345390,3219855,125535,2260715,3767858,"RUS",3014287
1,283.0,"Western Asia",770710,0,770710,574432,957387,"IRQ",765910
1,283.0,"Southern Europe",847214,0,847214,631939,1053232,"ITA",842586
1,283.0,"Eastern Africa",490993,0,490993,365953,609922,"ETH",487938
1,283.0,"Northern America",955653,919377,36276,712305,1187176,"CAN",949741
1,283.0,"Northern Europe",2074792,1933100,141692,1641240,2735401,"GBR",2188321
1,283.0,"United States of America",2831147,2645187,185960,2102022,3503370,"USA",2802696
1,283.0,"Central Asia",1736573,1705193,31380,1116564,1860941,"UZB",1488753
1,283.0,"India",7357886,7227948,129938,5457369,9095616,"IND",7276493
1,284.0,"Western Europe",4294337,3930479,363858,3160221,5267036,"NLD",4213629
1,284.0,"Western Africa",626147,0,626147,467672,779453,"NGA",623563
1,284.0,"Oceania",724647,710665,13982,523754,872923,"NZL",698339
1,284.0,"South America",2005647,1274275,731372,1676506,2794177,"BRA",2235342
1,284.0,"Northern Africa",1944134,0,1944134,1448138,2413563,"EGY",1930851
1,284.0,"Southern Asia",440973,0,440973,325048,541747,"IRN",433398
1,284.0,"Eastern Europe",3444250,3435120,9130,2219920,3699867,"POL",2959894
1,284.0,"Middle Africa",144499,0,144499,107690,179483,"AGO",143587
1,284.0,"Central America",510474,0,510474,381239,635398,"MEX",508319
1,284.0,"Southern Africa",169443,0,169443,125496,209161,"ZAF",167329
1,284.0,"South-Eastern Asia",1302761,0,1302761,969194,1615323,"IDN",1292259
1,284.0,"China",10851805,9891997,959808,7926789,13211315,"CPR",10569052
1,284.0,"Pakistan",2341164,2128417,212747,1540483,2567472,"PAK",2053978
1,284.0,"Eastern Asia",916189,0,916189,673410,1122350,"JPN",897880
1,284.0,"Russian Federation",3368596,3238284,130312,2260715,3767858,"RUS",3014287
1,284.0,"Western Asia",769611,0,769611,574432,957387,"IRQ",765910
1,284.0,"Southern Europe",850533,0,850533,631939,1053232,"ITA",842586
1,284.0,"Eastern Africa",490294,0,490294,365953,609922,"ETH",487938
1,284.0,"Northern America",955599,919439,36160,712305,1187176,"CAN",949741
1,284.0,"Northern Europe",2991111,2846756,144355,1641240,2735401,"GBR",2188321
1,284.0,"United States of America",2824034,2644395,179639,2102022,3503370,"USA",2802696
1,284.0,"Central Asia",1527773,1503309,24464,1116564,1860941,"UZB",1488753
1,284.0,"India",7400618,7291788,108830,5457369,9095616,"IND",7276493
1,285.0,"Western Europe",4587812,4227855,359957,3160221,5267036,"NLD",4213629
1,285.0,"Western Africa",617555,0,617555,467672,779453,"NGA",623563
1,285.0,"Oceania",720749,705012,15737,523754,872923,"NZL",698339
1,285.0,"South America",2060557,1299195,761362,1676506,2794177,"BRA",2235342
1,285.0,"Northern Africa",1898310,0,1898310,1448138,2413563,"EGY",1930851
1,285.0,"Southern Asia",423885,0,423885,325048,541747,"IRN",433398
1,285.0,"Eastern Europe",3061805,3061573,232,2219920,3699867,"POL",2959894
1,285.0,"Middle Africa",142444,0,142444,107690,179483,"AGO",143587
1,285.0,"Central America",485666,0,485666,381239,635398,"MEX",508319
1,285.0,"Southern Africa",164697,0,164697,125496,209161,"ZAF",167329
1,285.0,"South-Eastern Asia",1278959,0,1278959,969194,1615323,"IDN",1292259
1,285.0,"China",11485628,10497671,987957,7926789,13211315,"CPR",10569052
1,285.0,"Pakistan",2331935,2129389,202546,1540483,2567472,"PAK",2053978
1,285.0,"Eastern Asia",874876,0,874876,673410,1122350,"JPN",897880
1,285.0,"Russian Federation",4506528,4369997,136531,2260715,3767858,"RUS",3014287
1,285.0,"Western Asia",761211,0,761211,574432,957387,"IRQ",765910
1,285.0,"Southern Europe",835683,0,835683,631939,1053232,"ITA",842586
1,285.0,"Eastern Africa",484966,0,484966,365953,609922,"ETH",487938
1,285.0,"Northern America",809254,773210,36044,712305,1187176,"CAN",949741
1,285.0,"Northern Europe",2978953,2853441,125512,1641240,2735401,"GBR",2188321
1,285.0,"United States of America",2646238,2467284,178954,2102022,3503370,"USA",2802696
1,285.0,"Central Asia",1515446,1495763,19683,1116564,1860941,"UZB",1488753
1,285.0,"India",7388804,7301648,87156,5457369,9095616,"IND",7276493
1,286.0,"Western Europe",4441074,4099214,341860,3160221,5267036,"NLD",4213629
1,286.0,"Western Africa",622642,0,622642,467672,779453,"NGA",623563
1,286.0,"Oceania",725619,708115,17504,523754,872923,"NZL",698339
1,286.0,"South America",2106547,1315026,791521,1676506,2794177,"BRA",2235342
1,286.0,"Northern Africa",1924029,0,1924029,1448138,2413563,"EGY",1930851
1,286.0,"Southern Asia",430852,0,430852,325048,541747,"IRN",433398
1,286.0,"Eastern Europe",3120058,3120058,0,2219920,3699867,"POL",2959894
1,286.0,"Middle Africa",143601,0,143601,107690,179483,"AGO",143587
1,286.0,"Central America",502752,0,502752,381239,635398,"MEX",508319
1,286.0,"Southern Africa",167527,0,167527,125496,209161,"ZAF",167329
1,286.0,"South-Eastern Asia",1288764,0,1288764,969194,1615323,"IDN",1292259
1,286.0,"China",11466796,10496690,970106,7926789,13211315,"CPR",10569052
1,286.0,"Pakistan",2318778,2129079,189699,1540483,2567472,"PAK",2053978
1,286.0,"Eastern Asia",891732,0,891732,673410,1122350,"JPN",897880
1,286.0,"Russian Federation",4474595,4371736,102859,2260715,3767858,"RUS",3014287
1,286.0,"Western Asia",764683,0,764683,574432,957387,"IRQ",765910
1,286.0,"Southern Europe",841226,0,841226,631939,1053232,"ITA",842586
1,286.0,"Eastern Africa",488324,0,488324,365953,609922,"ETH",487938
1,286.0,"Northern America",883396,844508,38888,712305,1187176,"CAN",949741
1,286.0,"Northern Europe",2954625,2845425,109200,1641240,2735401,"GBR",2188321
1,286.0,"United States of America",2703124,2519120,184004,2102022,3503370,"USA",2802696
1,286.0,"Central Asia",1542552,1527501,15051,1116564,1860941,"UZB",1488753
1,286.0,"India",7510242,7444085,66157,5457369,9095616,"IND",7276493
1,287.0,"Western Europe",4367704,4026151,341553,3160226,5267043,"NLD",4213635
1,287.0,"Western Africa",624572,0,624572,467678,779463,"NGA",623571
1,287.0,"Oceania",720749,701598,19151,523759,872932,"NZL",698346
1,287.0,"South America",2145125,1326388,818737,1676506,2794177,"BRA",2235342
1,287.0,"Northern Africa",1935828,0,1935828,1448139,2413565,"EGY",1930852
1,287.0,"Southern Asia",437451,0,437451,325052,541753,"IRN",433403
1,287.0,"Eastern Europe",3123729,3123537,192,2219928,3699881,"POL",2959905
1,287.0,"Middle Africa",144118,0,144118,107696,179493,"AGO",143595
1,287.0,"Central America",509994,0,509994,381240,635400,"MEX",508320
1,287.0,"Southern Africa",168557,0,168557,125505,209175,"ZAF",167340
1,287.0,"South-Eastern Asia",1297112,0,1297112,969201,1615335,"IDN",1292268
1,287.0,"China",11457926,10492267,965659,7926790,13211317,"CPR",10569054
1,287.0,"Pakistan",2305097,2127812,177285,1540488,2567480,"PAK",2053984
1,287.0,"Eastern Asia",906163,0,906163,673410,1122351,"JPN",897881
1,287.0,"Russian Federation",3663734,3576618,87116,2260720,3767867,"RUS",3014294
1,287.0,"Western Asia",767750,0,767750,574432,957387,"IRQ",765910
1,287.0,"Southern Europe",844264,0,844264,631941,1053235,"ITA",842588
1,287.0,"Eastern Africa",489318,0,489318,365961,609935,"ETH",487948
1,287.0,"Northern America",926324,883146,43178,712313,1187188,"CAN",949751
1,287.0,"Northern Europe",2760009,2663714,96295,1641248,2735413,"GBR",2188331
1,287.0,"United States of America",2738687,2551469,187218,2102029,3503382,"USA",2802706
1,287.0,"Central Asia",1543793,1533444,10349,1116569,1860948,"UZB",1488759
1,287.0,"India",7511550,7467328,44222,5457375,9095626,"IND",7276501
1,288.0,"Western Europe",4331021,3984804,346217,3006224,5010373,"NLD",4008299
1,288.0,"Western Africa",625318,0,625318,447191,745318,"NGA",596255
1,288.0,"Oceania",719773,698935,20838,466524,777540,"NZL",622032
1,288.0,"South America",2178861,1336558,842303,1482404,2470673,"BRA",1976539
1,288.0,"Northern Africa",1939758,0,1939758,1229260,2048767,"EGY",1639014
1,288.0,"Southern Asia",438968,0,438968,574011,956686,"IRN",765349
1,288.0,"Eastern Europe",3229962,3229171,791,2156298,3593830,"POL",2875064
1,288.0,"Middle Africa",144218,0,144218,113941,189902,"AGO",151922
1,288.0,"Central America",511396,0,511396,388438,647397,"MEX",517918
1,288.0,"Southern Africa",168879,0,168879,179822,299703,"ZAF",239763
1,288.0,"South-Eastern Asia",1300019,0,1300019,990856,1651427,"IDN",1321142
1,288.0,"China",11464713,10497140,967573,7791810,12986351,"CPR",10389081
1,288.0,"Pakistan",2292478,2129209,163269,1439473,2399122,"PAK",1919298
1,288.0,"Eastern Asia",911342,0,911342,658962,1098271,"JPN",878617
1,288.0,"Russian Federation",3341649,3271346,70303,2438927,4064878,"RUS",3251903
1,288.0,"Western Asia",768653,0,768653,472707,787846,"IRQ",630277
1,288.0,"Southern Europe",845447,0,845447,599652,999421,"ITA",799537
1,288.0,"Eastern Africa",489678,0,489678,338517,564196,"ETH",451357
1,288.0,"Northern America",951689,905122,46567,696204,1160340,"CAN",928272
1,288.0,"Northern Europe",2318066,2241870,76196,1559760,2599600,"GBR",2079680
1,288.0,"United States of America",2774246,2584962,189284,2042478,3404130,"USA",2723304
1,288.0,"Central Asia",1580515,1574078,6437,1140768,1901280,"UZB",1521024
1,288.0,"India",7669154,7646465,22689,5172716,8621193,"IND",6896955
1,289.0,"Western Europe",4309017,3957064,351953,3006224,5010373,"NLD",4008299
1,289.0,"Western Africa",626268,0,626268,447191,745318,"NGA",596255
1,289.0,"Oceania",746082,723803,22279,466524,777540,"NZL",622032
1,289.0,"South America",2603928,1738519,865409,1482404,2470673,"BRA",1976539
1,289.0,"Northern Africa",1944579,0,1944579,1229260,2048767,"EGY",1639014
1,289.0,"Southern Asia",443611,0,443611,574011,956686,"IRN",765349
1,289.0,"Eastern Europe",3195447,3194936,511,2156298,3593830,"POL",2875064
1,289.0,"Middle Africa",144824,0,144824,113941,189902,"AGO",151922
1,289.0,"Central America",513052,0,513052,388438,647397,"MEX",517918
1,289.0,"Southern Africa",170181,0,170181,179822,299703,"ZAF",239763
1,289.0,"South-Eastern Asia",1306489,0,1306489,990856,1651427,"IDN",1321142
1,289.0,"China",11470250,10497459,972791,7791810,12986351,"CPR",10389081
1,289.0,"Pakistan",2285953,2130113,155840,1439473,2399122,"PAK",1919298
1,289.0,"Eastern Asia",922549,0,922549,658962,1098271,"JPN",878617
1,289.0,"Russian Federation",3273846,3216216,57630,2438927,4064878,"RUS",3251903
1,289.0,"Western Asia",770934,0,770934,472707,787846,"IRQ",630277
1,289.0,"Southern Europe",846985,0,846985,599652,999421,"ITA",799537
1,289.0,"Eastern Africa",491138,0,491138,338517,564196,"ETH",451357
1,289.0,"Northern America",967315,918010,49305,696204,1160340,"CAN",928272
1,289.0,"Northern Europe",2297804,2230667,67137,1559760,2599600,"GBR",2079680
1,289.0,"United States of America",2788479,2598278,190201,2042478,3404130,"USA",2723304
1,289.0,"Central Asia",1569197,1565847,3350,1140768,1901280,"UZB",1521024
1,289.0,"India",7612404,7608342,4062,5172716,8621193,"IND",6896955
1,290.0,"Western Europe",4265091,3917775,347316,3006224,5010373,"NLD",4008299
1,290.0,"Western Africa",608135,0,608135,447191,745318,"NGA",596255
1,290.0,"Oceania",671732,650257,21475,466524,777540,"NZL",622032
1,290.0,"South America",2554670,1739420,815250,1482404,2470673,"BRA",1976539
1,290.0,"Northern Africa",1705873,0,1705873,1229260,2048767,"EGY",1639014
1,290.0,"Southern Asia",789763,0,789763,574011,956686,"IRN",765349
1,290.0,"Eastern Europe",2772468,2772468,0,2156298,3593830,"POL",2875064
1,290.0,"Middle Africa",154843,0,154843,113941,189902,"AGO",151922
1,290.0,"Central America",535802,0,535802,388438,647397,"MEX",517918
1,290.0,"Southern Africa",246543,0,246543,179822,299703,"ZAF",239763
1,290.0,"South-Eastern Asia",1355175,0,1355175,990856,1651427,"IDN",1321142
1,290.0,"China",11482351,10504037,978314,7791810,12986351,"CPR",10389081
1,290.0,"Pakistan",1962660,1824270,138390,1439473,2399122,"PAK",1919298
1,290.0,"Eastern Asia",937667,0,937667,658962,1098271,"JPN",878617
1,290.0,"Russian Federation",3123738,3076057,47681,2438927,4064878,"RUS",3251903
1,290.0,"Western Asia",642293,0,642293,472707,787846,"IRQ",630277
1,290.0,"Southern Europe",817096,0,817096,599652,999421,"ITA",799537
1,290.0,"Eastern Africa",458984,0,458984,338517,564196,"ETH",451357
1,290.0,"Northern America",977055,925978,51077,696204,1160340,"CAN",928272
1,290.0,"Northern Europe",2018863,1962265,56598,1559760,2599600,"GBR",2079680
1,290.0,"United States of America",2815762,2627663,188099,2042478,3404130,"USA",2723304
1,290.0,"Central Asia",1483544,1481675,1869,1140768,1901280,"UZB",1521024
1,290.0,"India",6727989,6726438,1551,5172716,8621193,"IND",6896955
1,291.0,"Western Europe",4228407,3883787,344620,3006224,5010373,"NLD",4008299
1,291.0,"Western Africa",609855,0,609855,447191,745318,"NGA",596255
1,291.0,"Oceania",658084,635905,22179,466524,777540,"NZL",622032
1,291.0,"South America",2512882,1741282,771600,1482404,2470673,"BRA",1976539
1,291.0,"Northern Africa",1707697,0,1707697,1229260,2048767,"EGY",1639014
1,291.0,"Southern Asia",790370,0,790370,574011,956686,"IRN",765349
1,291.0,"Eastern Europe",2901403,2901403,0,2156298,3593830,"POL",2875064
1,291.0,"Middle Africa",154932,0,154932,113941,189902,"AGO",151922
1,291.0,"Central America",538400,0,538400,388438,647397,"MEX",517918
1,291.0,"Southern Africa",246720,0,246720,179822,299703,"ZAF",239763
1,291.0,"South-Eastern Asia",1356012,0,1356012,990856,1651427,"IDN",1321142
1,291.0,"China",11476713,10501036,975677,7791810,12986351,"CPR",10389081
1,291.0,"Pakistan",1940609,1804150,136459,1439473,2399122,"PAK",1919298
1,291.0,"Eastern Asia",939105,0,939105,658962,1098271,"JPN",878617
1,291.0,"Russian Federation",3284320,3237824,46496,2438927,4064878,"RUS",3251903
1,291.0,"Western Asia",642587,0,642587,472707,787846,"IRQ",630277
1,291.0,"Southern Europe",818536,0,818536,599652,999421,"ITA",799537
1,291.0,"Eastern Africa",459170,0,459170,338517,564196,"ETH",451357
1,291.0,"Northern America",988762,936234,52528,696204,1160340,"CAN",928272
1,291.0,"Northern Europe",2095897,2044471,51426,1559760,2599600,"GBR",2079680
1,291.0,"United States of America",2844212,2659096,185116,2042478,3404130,"USA",2723304
1,291.0,"Central Asia",1532324,1530446,1878,1140768,1901280,"UZB",1521024
1,291.0,"India",6946139,6942801,3338,5172716,8621193,"IND",6896955
1,292.0,"Western Europe",4199060,3855472,343588,3006224,5010373,"NLD",4008299
1,292.0,"Western Africa",610019,0,610019,447191,745318,"NGA",596255
1,292.0,"Oceania",659055,635924,23131,466524,777540,"NZL",622032
1,292.0,"South America",2477307,1744076,733231,1482404,2470673,"BRA",1976539
1,292.0,"Northern Africa",1708505,0,1708505,1229260,2048767,"EGY",1639014
1,292.0,"Southern Asia",790664,0,790664,574011,956686,"IRN",765349
1,292.0,"Eastern Europe",2798402,2795537,2865,2156298,3593830,"POL",2875064
1,292.0,"Middle Africa",154964,0,154964,113941,189902,"AGO",151922
1,292.0,"Central America",538641,0,538641,388438,647397,"MEX",517918
1,292.0,"Southern Africa",246799,0,246799,179822,299703,"ZAF",239763
1,292.0,"South-Eastern Asia",1356423,0,1356423,990856,1651427,"IDN",1321142
1,292.0,"China",11473580,10504803,968777,7791810,12986351,"CPR",10389081
1,292.0,"Pakistan",1896629,1759393,137236,1439473,2399122,"PAK",1919298
1,292.0,"Eastern Asia",939817,0,939817,658962,1098271,"JPN",878617
1,292.0,"Russian Federation",3180573,3131260,49313,2438927,4064878,"RUS",3251903
1,292.0,"Western Asia",642731,0,642731,472707,787846,"IRQ",630277
1,292.0,"Southern Europe",818725,0,818725,599652,999421,"ITA",799537
1,292.0,"Eastern Africa",459261,0,459261,338517,564196,"ETH",451357
1,292.0,"Northern America",994618,941046,53572,696204,1160340,"CAN",928272
1,292.0,"Northern Europe",2039136,1994199,44937,1559760,2599600,"GBR",2079680
1,292.0,"United States of America",2858434,2677220,181214,2042478,3404130,"USA",2723304
1,292.0,"Central Asia",1496020,1493839,2181,1140768,1901280,"UZB",1521024
1,292.0,"India",6503505,6497519,5986,5172716,8621193,"IND",6896955
1,293.0,"Western Europe",3949606,3628396,321210,3006224,5010373,"NLD",4008299
1,293.0,"Western Africa",605516,0,605516,447191,745318,"NGA",596255
1,293.0,"Oceania",655160,634758,20402,466524,777540,"NZL",622032
1,293.0,"South America",2433325,1742362,690963,1482404,2470673,"BRA",1976539
1,293.0,"Northern Africa",1685771,0,1685771,1229260,2048767,"EGY",1639014
1,293.0,"Southern Asia",782383,0,782383,574011,956686,"IRN",765349
1,293.0,"Eastern Europe",2797568,2797568,0,2156298,3593830,"POL",2875064
1,293.0,"Middle Africa",153974,0,153974,113941,189902,"AGO",151922
1,293.0,"Central America",531159,0,531159,388438,647397,"MEX",517918
1,293.0,"Southern Africa",244501,0,244501,179822,299703,"ZAF",239763
1,293.0,"South-Eastern Asia",1344880,0,1344880,990856,1651427,"IDN",1321142
1,293.0,"China",11451490,10513118,938372,7791810,12986351,"CPR",10389081
1,293.0,"Pakistan",1891406,1756975,134431,1439473,2399122,"PAK",1919298
1,293.0,"Eastern Asia",919797,0,919797,658962,1098271,"JPN",878617
1,293.0,"Russian Federation",3173821,3128685,45136,2438927,4064878,"RUS",3251903
1,293.0,"Western Asia",638658,0,638658,472707,787846,"IRQ",630277
1,293.0,"Southern Europe",811724,0,811724,599652,999421,"ITA",799537
1,293.0,"Eastern Africa",456677,0,456677,338517,564196,"ETH",451357
1,293.0,"Northern America",994617,940270,54347,696204,1160340,"CAN",928272
1,293.0,"Northern Europe",2043189,2003953,39236,1559760,2599600,"GBR",2079680
1,293.0,"United States of America",2865546,2688694,176852,2042478,3404130,"USA",2723304
1,293.0,"Central Asia",1496688,1495067,1621,1140768,1901280,"UZB",1521024
1,293.0,"India",6518245,6510181,8064,5172716,8621193,"IND",6896955
1,294.0,"Western Europe",4022970,3710250,312720,3006224,5010373,"NLD",4008299
1,294.0,"Western Africa",604503,0,604503,447191,745318,"NGA",596255
1,294.0,"Oceania",623987,606152,17835,466524,777540,"NZL",622032
1,294.0,"South America",2395645,1743420,652225,1482404,2470673,"BRA",1976539
1,294.0,"Northern Africa",1680664,0,1680664,1229260,2048767,"EGY",1639014
1,294.0,"Southern Asia",780524,0,780524,574011,956686,"IRN",765349
1,294.0,"Eastern Europe",2887055,2886721,334,2156298,3593830,"POL",2875064
1,294.0,"Middle Africa",153747,0,153747,113941,189902,"AGO",151922
1,294.0,"Central America",532516,0,532516,388438,647397,"MEX",517918
1,294.0,"Southern Africa",243982,0,243982,179822,299703,"ZAF",239763
1,294.0,"South-Eastern Asia",1342290,0,1342290,990856,1651427,"IDN",1321142
1,294.0,"China",11427299,10521436,905863,7791810,12986351,"CPR",10389081
1,294.0,"Pakistan",1925111,1793979,131132,1439473,2399122,"PAK",1919298
1,294.0,"Eastern Asia",915297,0,915297,658962,1098271,"JPN",878617
1,294.0,"Russian Federation",3266854,3227685,39169,2438927,4064878,"RUS",3251903
1,294.0,"Western Asia",637742,0,637742,472707,787846,"IRQ",630277
1,294.0,"Southern Europe",813067,0,813067,599652,999421,"ITA",799537
1,294.0,"Eastern Africa",456097,0,456097,338517,564196,"ETH",451357
1,294.0,"Northern America",988764,933745,55019,696204,1160340,"CAN",928272
1,294.0,"Northern Europe",2087788,2054384,33404,1559760,2599600,"GBR",2079680
1,294.0,"United States of America",2858433,2682209,176224,2042478,3404130,"USA",2723304
1,294.0,"Central Asia",1525748,1525552,196,1140768,1901280,"UZB",1521024
1,294.0,"India",6566271,6537210,29061,5172716,8621193,"IND",6896955
1,295.0,"Western Europe",4111018,3810807,300211,3006224,5010373,"NLD",4008299
1,295.0,"Western Africa",606252,0,606252,447191,745318,"NGA",596255
1,295.0,"Oceania",635671,619738,15933,466524,777540,"NZL",622032
1,295.0,"South America",2366199,1744987,621212,1482404,2470673,"BRA",1976539
1,295.0,"Northern Africa",1689486,0,1689486,1229260,2048767,"EGY",1639014
1,295.0,"Southern Asia",783739,0,783739,574011,956686,"IRN",765349
1,295.0,"Eastern Europe",2994203,2989300,4903,2156298,3593830,"POL",2875064
1,295.0,"Middle Africa",154134,0,154134,113941,189902,"AGO",151922
1,295.0,"Central America",534371,0,534371,388438,647397,"MEX",517918
1,295.0,"Southern Africa",244876,0,244876,179822,299703,"ZAF",239763
1,295.0,"South-Eastern Asia",1346768,0,1346768,990856,1651427,"IDN",1321142
1,295.0,"China",11371289,10517221,854068,7791810,12986351,"CPR",10389081
1,295.0,"Pakistan",1964342,1835542,128800,1439473,2399122,"PAK",1919298
1,295.0,"Eastern Asia",923068,0,923068,658962,1098271,"JPN",878617
1,295.0,"Russian Federation",3382689,3344840,37849,2438927,4064878,"RUS",3251903
1,295.0,"Western Asia",639325,0,639325,472707,787846,"IRQ",630277
1,295.0,"Southern Europe",814788,0,814788,599652,999421,"ITA",799537
1,295.0,"Eastern Africa",457100,0,457100,338517,564196,"ETH",451357
1,295.0,"Northern America",980959,925178,55781,696204,1160340,"CAN",928272
1,295.0,"Northern Europe",2136444,2109352,27092,1559760,2599600,"GBR",2079680
1,295.0,"United States of America",2851321,2671599,179722,2042478,3404130,"USA",2723304
1,295.0,"Central Asia",1561775,1559958,1817,1140768,1901280,"UZB",1521024
1,295.0,"India",6642030,6586225,55805,5172716,8621193,"IND",6896955
1,296.0,"Western Europe",4133027,3849795,283232,3006224,5010373,"NLD",4008299
1,296.0,"Western Africa",606744,0,606744,447191,745318,"NGA",596255
1,296.0,"Oceania",638596,624756,13840,466524,777540,"NZL",622032
1,296.0,"South America",2337746,1743134,594612,1482404,2470673,"BRA",1976539
1,296.0,"Northern Africa",1691970,0,1691970,1229260,2048767,"EGY",1639014
1,296.0,"Southern Asia",784642,0,784642,574011,956686,"IRN",765349
1,296.0,"Eastern Europe",3024178,3019808,4370,2156298,3593830,"POL",2875064
1,296.0,"Middle Africa",154240,0,154240,113941,189902,"AGO",151922
1,296.0,"Central America",534972,0,534972,388438,647397,"MEX",517918
1,296.0,"Southern Africa",245127,0,245127,179822,299703,"ZAF",239763
1,296.0,"South-Eastern Asia",1348031,0,1348031,990856,1651427,"IDN",1321142
1,296.0,"China",11131832,10352321,779511,7791810,12986351,"CPR",10389081
1,296.0,"Pakistan",1941379,1816615,124764,1439473,2399122,"PAK",1919298
1,296.0,"Eastern Asia",925255,0,925255,658962,1098271,"JPN",878617
1,296.0,"Russian Federation",3416180,3380829,35351,2438927,4064878,"RUS",3251903
1,296.0,"Western Asia",639771,0,639771,472707,787846,"IRQ",630277
1,296.0,"Southern Europe",815330,0,815330,599652,999421,"ITA",799537
1,296.0,"Eastern Africa",457380,0,457380,338517,564196,"ETH",451357
1,296.0,"Northern America",979008,924899,54109,696204,1160340,"CAN",928272
1,296.0,"Northern Europe",2148608,2128151,20457,1559760,2599600,"GBR",2079680
1,296.0,"United States of America",2851322,2668056,183266,2042478,3404130,"USA",2723304
1,296.0,"Central Asia",1571590,1569714,1876,1140768,1901280,"UZB",1521024
1,296.0,"India",6728521,6645320,83201,5172716,8621193,"IND",6896955
1,297.0,"Western Europe",4000964,3735562,265402,3006224,5010373,"NLD",4008299
1,297.0,"Western Africa",618845,0,618845,447191,745318,"NGA",596255
1,297.0,"Oceania",621062,609327,11735,466524,777540,"NZL",622032
1,297.0,"South America",2336775,1743488,593287,1482404,2470673,"BRA",1976539
1,297.0,"Northern Africa",1753107,0,1753107,1229260,2048767,"EGY",1639014
1,297.0,"Southern Asia",806913,0,806913,574011,956686,"IRN",765349
1,297.0,"Eastern Europe",2882713,2875439,7274,2156298,3593830,"POL",2875064
1,297.0,"Middle Africa",156914,0,156914,113941,189902,"AGO",151922
1,297.0,"Central America",558096,0,558096,388438,647397,"MEX",517918
1,297.0,"Southern Africa",251314,0,251314,179822,299703,"ZAF",239763
1,297.0,"South-Eastern Asia",1379068,0,1379068,990856,1651427,"IDN",1321142
1,297.0,"China",10409261,9681421,727840,7791810,12986351,"CPR",10389081
1,297.0,"Pakistan",1945156,1821012,124144,1439473,2399122,"PAK",1919298
1,297.0,"Eastern Asia",979097,0,979097,658962,1098271,"JPN",878617
1,297.0,"Russian Federation",3266312,3229725,36587,2438927,4064878,"RUS",3251903
1,297.0,"Western Asia",650723,0,650723,472707,787846,"IRQ",630277
1,297.0,"Southern Europe",836957,0,836957,599652,999421,"ITA",799537
1,297.0,"Eastern Africa",464332,0,464332,338517,564196,"ETH",451357
1,297.0,"Northern America",1185838,1130732,55106,696204,1160340,"CAN",928272
1,297.0,"Northern Europe",2075626,2061742,13884,1559760,2599600,"GBR",2079680
1,297.0,"United States of America",2958002,2771398,186604,2042478,3404130,"USA",2723304
1,297.0,"Central Asia",1522106,1520258,1848,1140768,1901280,"UZB",1521024
1,297.0,"India",6797549,6680059,117490,5172716,8621193,"IND",6896955
1,298.0,"Western Europe",4000960,3746936,254024,3006224,5010373,"NLD",4008299
1,298.0,"Western Africa",603234,0,603234,447191,745318,"NGA",596255
1,298.0,"Oceania",621057,611177,9880,466524,777540,"NZL",622032
1,298.0,"South America",2308594,1745033,563561,1482404,2470673,"BRA",1976539
1,298.0,"Northern Africa",1674246,0,1674246,1229260,2048767,"EGY",1639014
1,298.0,"Southern Asia",778184,0,778184,574011,956686,"IRN",765349
1,298.0,"Eastern Europe",2867378,2867378,0,2156298,3593830,"POL",2875064
1,298.0,"Middle Africa",153470,0,153470,113941,189902,"AGO",151922
1,298.0,"Central America",531268,0,531268,388438,647397,"MEX",517918
1,298.0,"Southern Africa",243335,0,243335,179822,299703,"ZAF",239763
1,298.0,"South-Eastern Asia",1339030,0,1339030,990856,1651427,"IDN",1321142
1,298.0,"China",10371879,9672148,699731,7791810,12986351,"CPR",10389081
1,298.0,"Pakistan",1922614,1806593,116021,1439473,2399122,"PAK",1919298
1,298.0,"Eastern Asia",909644,0,909644,658962,1098271,"JPN",878617
1,298.0,"Russian Federation",3243612,3217447,26165,2438927,4064878,"RUS",3251903
1,298.0,"Western Asia",636592,0,636592,472707,787846,"IRQ",630277
1,298.0,"Southern Europe",811644,0,811644,599652,999421,"ITA",799537
1,298.0,"Eastern Africa",455368,0,455368,338517,564196,"ETH",451357
1,298.0,"Northern America",926323,882625,43698,696204,1160340,"CAN",928272
1,298.0,"Northern Europe",2075625,2067970,7655,1559760,2599600,"GBR",2079680
1,298.0,"United States of America",2958001,2772475,185526,2042478,3404130,"USA",2723304
1,298.0,"Central Asia",1518299,1518299,0,1140768,1901280,"UZB",1521024
1,298.0,"India",6892511,6751438,141073,5172716,8621193,"IND",6896955
1,299.0,"Western Europe",4059656,3817025,242631,3006224,5010373,"NLD",4008299
1,299.0,"Western Africa",603587,0,603587,447192,745320,"NGA",596256
1,299.0,"Oceania",628849,620827,8022,466527,777545,"NZL",622036
1,299.0,"South America",2279894,1741985,537909,1482404,2470673,"BRA",1976539
1,299.0,"Northern Africa",1676031,0,1676031,1229265,2048775,"EGY",1639020
1,299.0,"Southern Asia",778835,0,778835,574017,956695,"IRN",765356
1,299.0,"Eastern Europe",2933343,2931404,1939,2156304,3593840,"POL",2875072
1,299.0,"Middle Africa",153542,0,153542,113948,189913,"AGO",151931
1,299.0,"Central America",530389,0,530389,388446,647411,"MEX",517929
1,299.0,"Southern Africa",243514,0,243514,179830,299717,"ZAF",239774
1,299.0,"South-Eastern Asia",1339937,0,1339937,990861,1651436,"IDN",1321149
1,299.0,"China",10576601,9872576,704025,7791816,12986361,"CPR",10389089
1,299.0,"Pakistan",1903520,1790420,113100,1439479,2399132,"PAK",1919306
1,299.0,"Eastern Asia",911215,0,911215,658965,1098275,"JPN",878620
1,299.0,"Russian Federation",3314795,3295514,19281,2438930,4064883,"RUS",3251907
1,299.0,"Western Asia",636913,0,636913,472710,787851,"IRQ",630281
1,299.0,"Southern Europe",811071,0,811071,599654,999423,"ITA",799539
1,299.0,"Eastern Africa",455568,0,455568,338525,564208,"ETH",451367
1,299.0,"Northern America",941929,900955,40974,696204,1160340,"CAN",928272
1,299.0,"Northern Europe",2108060,2106642,1418,1559763,2599605,"GBR",2079684
1,299.0,"United States of America",2886881,2705249,181632,2042478,3404130,"USA",2723304
1,299.0,"Central Asia",1541860,1540288,1572,1140768,1901280,"UZB",1521024
1,299.0,"India",6977794,6807839,169955,5172719,8621198,"IND",6896959
1,300.0,"Western Europe",4103679,3874951,228728,3219997,5366662,"NLD",4293330
1,300.0,"Western Africa",604184,0,604184,517837,863062,"NGA",690450
1,300.0,"Oceania",634699,628593,6106,526623,877706,"NZL",702165
1,300.0,"South America",2261412,1744537,516875,1768392,2947321,"BRA",2357857
1,300.0,"Northern Africa",1679040,0,1679040,2081997,3469995,"EGY",2775996
1,300.0,"Southern Asia",779931,0,779931,556167,926945,"IRN",741556
1,300.0,"Eastern Europe",2990859,2983687,7172,2153070,3588450,"POL",2870760
1,300.0,"Middle Africa",153677,0,153677,131555,219258,"AGO",175407
1,300.0,"Central America",530793,0,530793,418850,698083,"MEX",558467
1,300.0,"Southern Africa",243818,0,243818,110946,184910,"ZAF",147928
1,300.0,"South-Eastern Asia",1341466,0,1341466,1104151,1840252,"IDN",1472202
1,300.0,"China",10711138,10015832,695306,8760971,14601618,"CPR",11681295
1,300.0,"Pakistan",1908865,1793460,115405,1593169,2655282,"PAK",2124226
1,300.0,"Eastern Asia",913871,0,913871,737760,1229600,"JPN",983680
1,300.0,"Russian Federation",3379404,3359195,20209,2766478,4610797,"RUS",3688638
1,300.0,"Western Asia",637452,0,637452,872015,1453358,"IRQ",1162687
1,300.0,"Southern Europe",811461,0,811461,257773,429622,"ITA",343698
1,300.0,"Eastern Africa",455913,0,455913,414669,691116,"ETH",552893
1,300.0,"Northern America",953640,915848,37792,815799,1359666,"CAN",1087733
1,300.0,"Northern Europe",2132389,2132389,0,1693697,2822828,"GBR",2258263
1,300.0,"United States of America",2844211,2670600,173611,2319513,3865855,"USA",3092684
1,300.0,"Central Asia",1563011,1557789,5222,1281025,2135042,"UZB",1708034
1,300.0,"India",7051220,6854086,197134,5739038,9565063,"IND",7652051
1,301.0,"Western Europe",4111016,3898694,212322,3219997,5366662,"NLD",4293330
1,301.0,"Western Africa",604504,0,604504,517837,863062,"NGA",690450
1,301.0,"Oceania",635676,631738,3938,526623,877706,"NZL",702165
1,301.0,"South America",2731406,2231721,499685,1768392,2947321,"BRA",2357857
1,301.0,"Northern Africa",1680667,0,1680667,2081997,3469995,"EGY",2775996
1,301.0,"Southern Asia",780529,0,780529,556167,926945,"IRN",741556
1,301.0,"Eastern Europe",3001744,2994785,6959,2153070,3588450,"POL",2870760
1,301.0,"Middle Africa",153757,0,153757,131555,219258,"AGO",175407
1,301.0,"Central America",532053,0,532053,418850,698083,"MEX",558467
1,301.0,"Southern Africa",243992,0,243992,110946,184910,"ZAF",147928
1,301.0,"South-Eastern Asia",1342294,0,1342294,1104151,1840252,"IDN",1472202
1,301.0,"China",10734773,10060113,674660,8760971,14601618,"CPR",11681295
1,301.0,"Pakistan",1919442,1796610,122832,1593169,2655282,"PAK",2124226
1,301.0,"Eastern Asia",915299,0,915299,737760,1229600,"JPN",983680
1,301.0,"Russian Federation",3398882,3372359,26523,2766478,4610797,"RUS",3688638
1,301.0,"Western Asia",637747,0,637747,872015,1453358,"IRQ",1162687
1,301.0,"Southern Europe",811899,0,811899,257773,429622,"ITA",343698
1,301.0,"Eastern Africa",456106,0,456106,414669,691116,"ETH",552893
1,301.0,"Northern America",955592,921738,33854,815799,1359666,"CAN",1087733
1,301.0,"Northern Europe",2136447,2136447,0,1693697,2822828,"GBR",2258263
1,301.0,"United States of America",2844210,2678953,165257,2319513,3865855,"USA",3092684
1,301.0,"Central Asia",1565895,1561160,4735,1281025,2135042,"UZB",1708034
1,301.0,"India",7100091,6875518,224573,5739038,9565063,"IND",7652051
1,302.0,"Western Europe",4271318,4064681,206637,3219997,5366662,"NLD",4293330
1,302.0,"Western Africa",675273,0,675273,517837,863062,"NGA",690450
1,302.0,"Oceania",639810,637825,1985,526623,877706,"NZL",702165
1,302.0,"South America",2659720,2232219,427501,1768392,2947321,"BRA",2357857
1,302.0,"Northern Africa",2699352,0,2699352,2081997,3469995,"EGY",2775996
1,302.0,"Southern Asia",713643,0,713643,556167,926945,"IRN",741556
1,302.0,"Eastern Europe",2853226,2853226,0,2153070,3588450,"POL",2870760
1,302.0,"Middle Africa",172042,0,172042,131555,219258,"AGO",175407
1,302.0,"Central America",537838,0,537838,418850,698083,"MEX",558467
1,302.0,"Southern Africa",140177,0,140177,110946,184910,"ZAF",147928
1,302.0,"South-Eastern Asia",1433286,0,1433286,1104151,1840252,"IDN",1472202
1,302.0,"China",11581375,10906438,674937,8760971,14601618,"CPR",11681295
1,302.0,"Pakistan",1923495,1792861,130634,1593169,2655282,"PAK",2124226
1,302.0,"Eastern Asia",916179,0,916179,737760,1229600,"JPN",983680
1,302.0,"Russian Federation",3650390,3628757,21633,2766478,4610797,"RUS",3688638
1,302.0,"Western Asia",1148950,0,1148950,872015,1453358,"IRQ",1162687
1,302.0,"Southern Europe",331975,0,331975,257773,429622,"ITA",343698
1,302.0,"Eastern Africa",544175,0,544175,414669,691116,"ETH",552893
1,302.0,"Northern America",1081877,1048099,33778,815799,1359666,"CAN",1087733
1,302.0,"Northern Europe",2246099,2246099,0,1693697,2822828,"GBR",2258263
1,302.0,"United States of America",2751307,2580889,170418,2319513,3865855,"USA",3092684
1,302.0,"Central Asia",1696476,1694999,1477,1281025,2135042,"UZB",1708034
1,302.0,"India",7138102,6889642,248460,5739038,9565063,"IND",7652051
1,303.0,"Western Europe",4205287,4010444,194843,3219997,5366662,"NLD",4293330
1,303.0,"Western Africa",679142,0,679142,517837,863062,"NGA",690450
1,303.0,"Oceania",676828,674569,2259,526623,877706,"NZL",702165
1,303.0,"South America",2601506,2229727,371779,1768392,2947321,"BRA",2357857
1,303.0,"Northern Africa",2718898,0,2718898,2081997,3469995,"EGY",2775996
1,303.0,"Southern Asia",720756,0,720756,556167,926945,"IRN",741556
1,303.0,"Eastern Europe",2772538,2772538,0,2153070,3588450,"POL",2870760
1,303.0,"Middle Africa",172906,0,172906,131555,219258,"AGO",175407
1,303.0,"Central America",540829,0,540829,418850,698083,"MEX",558467
1,303.0,"Southern Africa",142148,0,142148,110946,184910,"ZAF",147928
1,303.0,"South-Eastern Asia",1443212,0,1443212,1104151,1840252,"IDN",1472202
1,303.0,"China",11394924,10771252,623672,8760971,14601618,"CPR",11681295
1,303.0,"Pakistan",1923852,1785440,138412,1593169,2655282,"PAK",2124226
1,303.0,"Eastern Asia",933396,0,933396,737760,1229600,"JPN",983680
1,303.0,"Russian Federation",3581547,3571828,9719,2766478,4610797,"RUS",3688638
1,303.0,"Western Asia",1152456,0,1152456,872015,1453358,"IRQ",1162687
1,303.0,"Southern Europe",327484,0,327484,257773,429622,"ITA",343698
1,303.0,"Eastern Africa",546399,0,546399,414669,691116,"ETH",552893
1,303.0,"Northern America",1064317,1033676,30641,815799,1359666,"CAN",1087733
1,303.0,"Northern Europe",2209609,2209609,0,1693697,2822828,"GBR",2258263
1,303.0,"United States of America",2879322,2685802,193520,2319513,3865855,"USA",3092684
1,303.0,"Central Asia",1674451,1674451,0,1281025,2135042,"UZB",1708034
1,303.0,"India",7178753,6902326,276427,5739038,9565063,"IND",7652051
1,304.0,"Western Europe",4241970,4056780,185190,3219997,5366662,"NLD",4293330
1,304.0,"Western Africa",683724,0,683724,517837,863062,"NGA",690450
1,304.0,"Oceania",694367,689882,4485,526623,877706,"NZL",702165
1,304.0,"South America",2564134,2232047,332087,1768392,2947321,"BRA",2357857
1,304.0,"Northern Africa",2742033,0,2742033,2081997,3469995,"EGY",2775996
1,304.0,"Southern Asia",729180,0,729180,556167,926945,"IRN",741556
1,304.0,"Eastern Europe",2808900,2808900,0,2153070,3588450,"POL",2870760
1,304.0,"Middle Africa",173915,0,173915,131555,219258,"AGO",175407
1,304.0,"Central America",547072,0,547072,418850,698083,"MEX",558467
1,304.0,"Southern Africa",144488,0,144488,110946,184910,"ZAF",147928
1,304.0,"South-Eastern Asia",1454956,0,1454956,1104151,1840252,"IDN",1472202
1,304.0,"China",11513180,10919486,593694,8760971,14601618,"CPR",11681295
1,304.0,"Pakistan",1933543,1784006,149537,1593169,2655282,"PAK",2124226
1,304.0,"Eastern Asia",953767,0,953767,737760,1229600,"JPN",983680
1,304.0,"Russian Federation",3621630,3621630,0,2766478,4610797,"RUS",3688638
1,304.0,"Western Asia",1156597,0,1156597,872015,1453358,"IRQ",1162687
1,304.0,"Southern Europe",333191,0,333191,257773,429622,"ITA",343698
1,304.0,"Eastern Africa",549028,0,549028,414669,691116,"ETH",552893
1,304.0,"Northern America",1074072,1046239,27833,815799,1359666,"CAN",1087733
1,304.0,"Northern Europe",2229882,2229882,0,1693697,2822828,"GBR",2258263
1,304.0,"United States of America",2950443,2738591,211852,2319513,3865855,"USA",3092684
1,304.0,"Central Asia",1687568,1687568,0,1281025,2135042,"UZB",1708034
1,304.0,"India",8214604,7905640,308964,5739038,9565063,"IND",7652051
1,305.0,"Western Europe",4219959,4045756,174203,3219997,5366662,"NLD",4293330
1,305.0,"Western Africa",685401,0,685401,517837,863062,"NGA",690450
1,305.0,"Oceania",702163,695518,6645,526623,877706,"NZL",702165
1,305.0,"South America",2532030,2230939,301091,1768392,2947321,"BRA",2357857
1,305.0,"Northern Africa",2750507,0,2750507,2081997,3469995,"EGY",2775996
1,305.0,"Southern Asia",732269,0,732269,556167,926945,"IRN",741556
1,305.0,"Eastern Europe",2786458,2786458,0,2153070,3588450,"POL",2870760
1,305.0,"Middle Africa",174289,0,174289,131555,219258,"AGO",175407
1,305.0,"Central America",549336,0,549336,418850,698083,"MEX",558467
1,305.0,"Southern Africa",145343,0,145343,110946,184910,"ZAF",147928
1,305.0,"South-Eastern Asia",1459258,0,1459258,1104151,1840252,"IDN",1472202
1,305.0,"China",11447537,10892224,555313,8760971,14601618,"CPR",11681295
1,305.0,"Pakistan",1983791,1817534,166257,1593169,2655282,"PAK",2124226
1,305.0,"Eastern Asia",961231,0,961231,737760,1229600,"JPN",983680
1,305.0,"Russian Federation",3598058,3598058,0,2766478,4610797,"RUS",3688638
1,305.0,"Western Asia",1158118,0,1158118,872015,1453358,"IRQ",1162687
1,305.0,"Southern Europe",335254,0,335254,257773,429622,"ITA",343698
1,305.0,"Eastern Africa",549988,0,549988,414669,691116,"ETH",552893
1,305.0,"Northern America",1068219,1043415,24804,815799,1359666,"CAN",1087733
1,305.0,"Northern Europe",2217718,2217718,0,1693697,2822828,"GBR",2258263
1,305.0,"United States of America",3014450,2787020,227430,2319513,3865855,"USA",3092684
1,305.0,"Central Asia",1679695,1679695,0,1281025,2135042,"UZB",1708034
1,305.0,"India",8192212,7909014,283198,5739038,9565063,"IND",7652051
1,306.0,"Western Europe",4263982,4100248,163734,3219997,5366662,"NLD",4293330
1,306.0,"Western Africa",688220,0,688220,517837,863062,"NGA",690450
1,306.0,"Oceania",697293,688542,8751,526623,877706,"NZL",702165
1,306.0,"South America",2505580,2231789,273791,1768392,2947321,"BRA",2357857
1,306.0,"Northern Africa",2764751,0,2764751,2081997,3469995,"EGY",2775996
1,306.0,"Southern Asia",737459,0,737459,556167,926945,"IRN",741556
1,306.0,"Eastern Europe",2833950,2833950,0,2153070,3588450,"POL",2870760
1,306.0,"Middle Africa",174911,0,174911,131555,219258,"AGO",175407
1,306.0,"Central America",554861,0,554861,418850,698083,"MEX",558467
1,306.0,"Southern Africa",146787,0,146787,110946,184910,"ZAF",147928
1,306.0,"South-Eastern Asia",1466492,0,1466492,1104151,1840252,"IDN",1472202
1,306.0,"China",11563286,11036330,526956,8760971,14601618,"CPR",11681295
1,306.0,"Pakistan",2160234,1978900,181334,1593169,2655282,"PAK",2124226
1,306.0,"Eastern Asia",973777,0,973777,737760,1229600,"JPN",983680
1,306.0,"Russian Federation",3648589,3648589,0,2766478,4610797,"RUS",3688638
1,306.0,"Western Asia",1160668,0,1160668,872015,1453358,"IRQ",1162687
1,306.0,"Southern Europe",340400,0,340400,257773,429622,"ITA",343698
1,306.0,"Eastern Africa",551611,0,551611,414669,691116,"ETH",552893
1,306.0,"Northern America",1079927,1058095,21832,815799,1359666,"CAN",1087733
1,306.0,"Northern Europe",2242045,2242045,0,1693697,2822828,"GBR",2258263
1,306.0,"United States of America",3064234,2823921,240313,2319513,3865855,"USA",3092684
1,306.0,"Central Asia",1684972,1684972,0,1281025,2135042,"UZB",1708034
1,306.0,"India",8175157,7909721,265436,5739038,9565063,"IND",7652051
1,307.0,"Western Europe",4344686,4192750,151936,3219997,5366662,"NLD",4293330
1,307.0,"Western Africa",692041,0,692041,517837,863062,"NGA",690450
1,307.0,"Oceania",698266,687354,10912,526623,877706,"NZL",702165
1,307.0,"South America",2486096,2229202,256894,1768392,2947321,"BRA",2357857
1,307.0,"Northern Africa",2784042,0,2784042,2081997,3469995,"EGY",2775996
1,307.0,"Southern Asia",744483,0,744483,556167,926945,"IRN",741556
1,307.0,"Eastern Europe",2925615,2925615,0,2153070,3588450,"POL",2870760
1,307.0,"Middle Africa",175754,0,175754,131555,219258,"AGO",175407
1,307.0,"Central America",561589,0,561589,418850,698083,"MEX",558467
1,307.0,"Southern Africa",148739,0,148739,110946,184910,"ZAF",147928
1,307.0,"South-Eastern Asia",1476285,0,1476285,1104151,1840252,"IDN",1472202
1,307.0,"China",11511763,11006654,505109,8760971,14601618,"CPR",11681295
1,307.0,"Pakistan",2193549,2006355,187194,1593169,2655282,"PAK",2124226
1,307.0,"Eastern Asia",990764,0,990764,737760,1229600,"JPN",983680
1,307.0,"Russian Federation",3746842,3746842,0,2766478,4610797,"RUS",3688638
1,307.0,"Western Asia",1164125,0,1164125,872015,1453358,"IRQ",1162687
1,307.0,"Southern Europe",346649,0,346649,257773,429622,"ITA",343698
1,307.0,"Eastern Africa",553804,0,553804,414669,691116,"ETH",552893
1,307.0,"Northern America",1101391,1082723,18668,815799,1359666,"CAN",1087733
1,307.0,"Northern Europe",2286644,2286644,0,1693697,2822828,"GBR",2258263
1,307.0,"United States of America",3092681,2841730,250951,2319513,3865855,"USA",3092684
1,307.0,"Central Asia",1679609,1679609,0,1281025,2135042,"UZB",1708034
1,307.0,"India",8155269,7902617,252652,5739038,9565063,"IND",7652051
1,308.0,"Western Europe",4285995,4147881,138114,3219997,5366662,"NLD",4293330
1,308.0,"Western Africa",690404,0,690404,517837,863062,"NGA",690450
1,308.0,"Oceania",703211,690068,13143,526623,877706,"NZL",702165
1,308.0,"South America",2430301,2197946,232355,1768392,2947321,"BRA",2357857
1,308.0,"Northern Africa",2775756,0,2775756,2081997,3469995,"EGY",2775996
1,308.0,"Southern Asia",741470,0,741470,556167,926945,"IRN",741556
1,308.0,"Eastern Europe",2865496,2865496,0,2153070,3588450,"POL",2870760
1,308.0,"Middle Africa",175401,0,175401,131555,219258,"AGO",175407
1,308.0,"Central America",558355,0,558355,418850,698083,"MEX",558467
1,308.0,"Southern Africa",147910,0,147910,110946,184910,"ZAF",147928
1,308.0,"South-Eastern Asia",1472082,0,1472082,1104151,1840252,"IDN",1472202
1,308.0,"China",11501629,11025129,476500,8760971,14601618,"CPR",11681295
1,308.0,"Pakistan",2210186,2022857,187329,1593169,2655282,"PAK",2124226
1,308.0,"Eastern Asia",983469,0,983469,737760,1229600,"JPN",983680
1,308.0,"Russian Federation",3683464,3683464,0,2766478,4610797,"RUS",3688638
1,308.0,"Western Asia",1162651,0,1162651,872015,1453358,"IRQ",1162687
1,308.0,"Southern Europe",343567,0,343567,257773,429622,"ITA",343698
1,308.0,"Eastern Africa",552869,0,552869,414669,691116,"ETH",552893
1,308.0,"Northern America",1085783,1070521,15262,815799,1359666,"CAN",1087733
1,308.0,"Northern Europe",1925793,1925793,0,1693697,2822828,"GBR",2258263
1,308.0,"United States of America",3128242,2868013,260229,2319513,3865855,"USA",3092684
1,308.0,"Central Asia",1715410,1710222,5188,1281025,2135042,"UZB",1708034
1,308.0,"India",7911661,7694037,217624,5739038,9565063,"IND",7652051
1,309.0,"Western Europe",2730578,2605182,125396,3219997,5366662,"NLD",4293330
1,309.0,"Western Africa",672442,0,672442,517837,863062,"NGA",690450
1,309.0,"Oceania",703141,687907,15234,526623,877706,"NZL",702165
1,309.0,"South America",2322518,2139437,183081,1768392,2947321,"BRA",2357857
1,309.0,"Northern Africa",2685053,0,2685053,2081997,3469995,"EGY",2775996
1,309.0,"Southern Asia",708429,0,708429,556167,926945,"IRN",741556
1,309.0,"Eastern Europe",2862377,2862377,0,2153070,3588450,"POL",2870760
1,309.0,"Middle Africa",171429,0,171429,131555,219258,"AGO",175407
1,309.0,"Central America",538513,0,538513,418850,698083,"MEX",558467
1,309.0,"Southern Africa",138721,0,138721,110946,184910,"ZAF",147928
1,309.0,"South-Eastern Asia",1426141,0,1426141,1104151,1840252,"IDN",1472202
1,309.0,"China",11304673,10846197,458476,8760971,14601618,"CPR",11681295
1,309.0,"Pakistan",2196268,2027715,168553,1593169,2655282,"PAK",2124226
1,309.0,"Eastern Asia",920607,0,920607,737760,1229600,"JPN",983680
1,309.0,"Russian Federation",3679671,3679671,0,2766478,4610797,"RUS",3688638
1,309.0,"Western Asia",1146389,0,1146389,872015,1453358,"IRQ",1162687
1,309.0,"Southern Europe",314039,0,314039,257773,429622,"ITA",343698
1,309.0,"Eastern Africa",542550,0,542550,414669,691116,"ETH",552893
1,309.0,"Northern America",1085781,1073766,12015,815799,1359666,"CAN",1087733
1,309.0,"Northern Europe",1974447,1966929,7518,1693697,2822828,"GBR",2258263
1,309.0,"United States of America",3448284,3189819,258465,2319513,3865855,"USA",3092684
1,309.0,"Central Asia",1733180,1722899,10281,1281025,2135042,"UZB",1708034
1,309.0,"India",7645019,7453456,191563,5739038,9565063,"IND",7652051
1,310.0,"Western Europe",3090083,2913815,176268,3219997,5366662,"NLD",4293330
1,310.0,"Western Africa",670402,0,670402,517837,863062,"NGA",690450
1,310.0,"Oceania",683658,668438,15220,526623,877706,"NZL",702165
1,310.0,"South America",2305435,2150910,154525,1768392,2947321,"BRA",2357857
1,310.0,"Northern Africa",2674419,0,2674419,2081997,3469995,"EGY",2775996
1,310.0,"Southern Asia",704555,0,704555,556167,926945,"IRN",741556
1,310.0,"Eastern Europe",2805451,2805451,0,2153070,3588450,"POL",2870760
1,310.0,"Middle Africa",170961,0,170961,131555,219258,"AGO",175407
1,310.0,"Central America",560649,0,560649,418850,698083,"MEX",558467
1,310.0,"Southern Africa",137643,0,137643,110946,184910,"ZAF",147928
1,310.0,"South-Eastern Asia",1434698,0,1434698,1104151,1840252,"IDN",1472202
1,310.0,"China",11384390,10881634,502756,8760971,14601618,"CPR",11681295
1,310.0,"Pakistan",2196804,2026260,170544,1593169,2655282,"PAK",2124226
1,310.0,"Eastern Asia",984621,0,984621,737760,1229600,"JPN",983680
1,310.0,"Russian Federation",3618844,3618844,0,2766478,4610797,"RUS",3688638
1,310.0,"Western Asia",1144483,0,1144483,872015,1453358,"IRQ",1162687
1,310.0,"Southern Europe",312079,0,312079,257773,429622,"ITA",343698
1,310.0,"Eastern Africa",541339,0,541339,414669,691116,"ETH",552893
1,310.0,"Northern America",1072122,1063359,8763,815799,1359666,"CAN",1087733
1,310.0,"Northern Europe",1990663,1982511,8152,1693697,2822828,"GBR",2258263
1,310.0,"United States of America",3234926,2994118,240808,2319513,3865855,"USA",3092684
1,310.0,"Central Asia",1706089,1700986,5103,1281025,2135042,"UZB",1708034
1,310.0,"India",7559860,7386221,173639,5739038,9565063,"IND",7652051
1,311.0,"Western Europe",3295515,3074978,220537,3219997,5366662,"NLD",4293330
1,311.0,"Western Africa",673188,0,673188,517837,863062,"NGA",690450
1,311.0,"Oceania",681706,664047,17659,526623,877706,"NZL",702165
1,311.0,"South America",2377022,2222869,154153,1768392,2947321,"BRA",2357857
1,311.0,"Northern Africa",2684570,0,2684570,2081997,3469995,"EGY",2775996
1,311.0,"Southern Asia",708324,0,708324,556167,926945,"IRN",741556
1,311.0,"Eastern Europe",2932247,2932247,0,2153070,3588450,"POL",2870760
1,311.0,"Middle Africa",171406,0,171406,131555,219258,"AGO",175407
1,311.0,"Central America",560735,0,560735,418850,698083,"MEX",558467
1,311.0,"Southern Africa",138788,0,138788,110946,184910,"ZAF",147928
1,311.0,"South-Eastern Asia",1469849,0,1469849,1104151,1840252,"IDN",1472202
1,311.0,"China",11438099,10883706,554393,8760971,14601618,"CPR",11681295
1,311.0,"Pakistan",2191641,2021127,170514,1593169,2655282,"PAK",2124226
1,311.0,"Eastern Asia",986420,0,986420,737760,1229600,"JPN",983680
1,311.0,"Russian Federation",3753719,3753719,0,2766478,4610797,"RUS",3688638
1,311.0,"Western Asia",1146301,0,1146301,872015,1453358,"IRQ",1162687
1,311.0,"Southern Europe",315544,0,315544,257773,429622,"ITA",343698
1,311.0,"Eastern Africa",542497,0,542497,414669,691116,"ETH",552893
1,311.0,"Northern America",1103342,1097784,5558,815799,1359666,"CAN",1087733
1,311.0,"Northern Europe",2019046,2003889,15157,1693697,2822828,"GBR",2258263
1,311.0,"United States of America",3121133,2891554,229579,2319513,3865855,"USA",3092684
1,311.0,"Central Asia",1730107,1730107,0,1281025,2135042,"UZB",1708034
1,311.0,"India",7749427,7595891,153536,5739038,9565063,"IND",7652051
1,312.0,"Western Europe",3471601,3210634,260967,3219997,5366662,"NLD",4293330
1,312.0,"Western Africa",672472,0,672472,517837,863062,"NGA",690450
1,312.0,"Oceania",691447,671270,20177,526623,877706,"NZL",702165
1,312.0,"South America",2311291,2170952,140339,1768392,2947321,"BRA",2357857
1,312.0,"Northern Africa",2683667,0,2683667,2081997,3469995,"EGY",2775996
1,312.0,"Southern Asia",708732,0,708732,556167,926945,"IRN",741556
1,312.0,"Eastern Europe",2752310,2752310,0,2153070,3588450,"POL",2870760
1,312.0,"Middle Africa",171367,0,171367,131555,219258,"AGO",175407
1,312.0,"Central America",553822,0,553822,418850,698083,"MEX",558467
1,312.0,"Southern Africa",139170,0,139170,110946,184910,"ZAF",147928
1,312.0,"South-Eastern Asia",1464643,0,1464643,1104151,1840252,"IDN",1472202
1,312.0,"China",11495185,10903900,591285,8760971,14601618,"CPR",11681295
1,312.0,"Pakistan",2185792,2017700,168092,1593169,2655282,"PAK",2124226
1,312.0,"Eastern Asia",971409,0,971409,737760,1229600,"JPN",983680
1,312.0,"Russian Federation",3562675,3562675,0,2766478,4610797,"RUS",3688638
1,312.0,"Western Asia",1146354,0,1146354,872015,1453358,"IRQ",1162687
1,312.0,"Southern Europe",314332,0,314332,257773,429622,"ITA",343698
1,312.0,"Eastern Africa",542393,0,542393,414669,691116,"ETH",552893
1,312.0,"Northern America",1058465,1056194,2271,815799,1359666,"CAN",1087733
1,312.0,"Northern Europe",2047427,2024154,23273,1693697,2822828,"GBR",2258263
1,312.0,"United States of America",3078463,2853402,225061,2319513,3865855,"USA",3092684
1,312.0,"Central Asia",1667248,1667248,0,1281025,2135042,"UZB",1708034
1,312.0,"India",7471313,7341979,129334,5739038,9565063,"IND",7652051
1,313.0,"Western Europe",3611000,3313346,297654,3219997,5366662,"NLD",4293330
1,313.0,"Western Africa",675441,0,675441,517837,863062,"NGA",690450
1,313.0,"Oceania",595984,573463,22521,526623,877706,"NZL",702165
1,313.0,"South America",1703616,1569781,133835,1768392,2947321,"BRA",2357857
1,313.0,"Northern Africa",2669497,0,2669497,2081997,3469995,"EGY",2775996
1,313.0,"Southern Asia",703489,0,703489,556167,926945,"IRN",741556
1,313.0,"Eastern Europe",2848398,2848398,0,2153070,3588450,"POL",2870760
1,313.0,"Middle Africa",170690,0,170690,131555,219258,"AGO",175407
1,313.0,"Central America",553750,0,553750,418850,698083,"MEX",558467
1,313.0,"Southern Africa",141659,0,141659,110946,184910,"ZAF",147928
1,313.0,"South-Eastern Asia",1450349,0,1450349,1104151,1840252,"IDN",1472202
1,313.0,"China",11565836,10934103,631733,8760971,14601618,"CPR",11681295
1,313.0,"Pakistan",2180325,2012765,167560,1593169,2655282,"PAK",2124226
1,313.0,"Eastern Asia",945261,0,945261,737760,1229600,"JPN",983680
1,313.0,"Russian Federation",3663787,3663787,0,2766478,4610797,"RUS",3688638
1,313.0,"Western Asia",1144049,0,1144049,872015,1453358,"IRQ",1162687
1,313.0,"Southern Europe",319209,0,319209,257773,429622,"ITA",343698
1,313.0,"Eastern Africa",540783,0,540783,414669,691116,"ETH",552893
1,313.0,"Northern America",1083831,1083831,0,815799,1359666,"CAN",1087733
1,313.0,"Northern Europe",2063646,2032072,31574,1693697,2822828,"GBR",2258263
1,313.0,"United States of America",3042897,2824090,218807,2319513,3865855,"USA",3092684
1,313.0,"Central Asia",1701168,1701168,0,1281025,2135042,"UZB",1708034
1,313.0,"India",7625632,7517350,108282,5739038,9565063,"IND",7652051
