"run","tick","Name","RealizedConsumption","DomesticConsumption","ImportedQuantity","MinimumConsumption","MaximumConsumption","Iso3Code","AverageConsumption"
1,1.0,"Northern America",712202,712202,0,585372,975620,"CAN",780496
1,1.0,"Southern Asia",371236,0,371236,298897,498162,"IRN",398530
1,1.0,"South America",1671368,1307196,364172,1271164,2118607,"BRA",1694886
1,1.0,"Central Asia",1256856,1106855,150001,950910,1584851,"UZB",1267881
1,1.0,"South-Eastern Asia",517428,0,517428,416601,694336,"IDN",555469
1,1.0,"Pakistan",1549041,1262012,287029,1177605,1962676,"PAK",1570141
1,1.0,"Southern Africa",103145,0,103145,83046,138410,"ZAF",110728
1,1.0,"Northern Europe",1605589,1605589,0,1216355,2027258,"GBR",1621807
1,1.0,"Oceania",355557,355557,0,292238,487063,"NZL",389651
1,1.0,"Central America",354147,0,354147,285138,475230,"MEX",380184
1,1.0,"Eastern Africa",115871,0,115871,93290,155483,"ETH",124387
1,1.0,"China",9717609,8767947,949662,7340573,12234288,"CPR",9787431
1,1.0,"Eastern Europe",3799187,3243728,555459,2880021,4800036,"POL",3840029
1,1.0,"India",5085457,4862968,222489,3817265,6362108,"IND",5089687
1,1.0,"Middle Africa",44554,0,44554,35870,59783,"AGO",47827
1,1.0,"Western Asia",182617,0,182617,147031,245052,"IRQ",196042
1,1.0,"United States of America",2652761,2652761,0,2133588,3555980,"USA",2844784
1,1.0,"Western Europe",2788009,2788009,0,2201059,3668432,"NLD",2934746
1,1.0,"Russian Federation",4141193,3471510,669683,3136330,5227217,"RUS",4181774
1,1.0,"Northern Africa",1019162,0,1019162,820571,1367618,"EGY",1094095
1,1.0,"Eastern Asia",897551,0,897551,722660,1204433,"JPN",963547
1,1.0,"Western Africa",201786,0,201786,162462,270771,"NGA",216617
1,1.0,"Southern Europe",331260,0,331260,266713,444522,"ITA",355618
1,2.0,"Northern America",714153,713107,1046,585372,975620,"CAN",780496
1,2.0,"Southern Asia",374821,0,374821,298897,498162,"IRN",398530
1,2.0,"South America",1668364,1305761,362603,1271164,2118607,"BRA",1694886
1,2.0,"Central Asia",1255536,1107890,147646,950910,1584851,"UZB",1267881
1,2.0,"South-Eastern Asia",522426,0,522426,416601,694336,"IDN",555469
1,2.0,"Pakistan",1548656,1263566,285090,1177605,1962676,"PAK",1570141
1,2.0,"Southern Africa",104142,0,104142,83046,138410,"ZAF",110728
1,2.0,"Northern Europe",1601535,1601535,0,1216355,2027258,"GBR",1621807
1,2.0,"Oceania",369195,368414,781,292238,487063,"NZL",389651
1,2.0,"Central America",357567,0,357567,285138,475230,"MEX",380184
1,2.0,"Eastern Africa",116991,0,116991,93290,155483,"ETH",124387
1,2.0,"China",9704861,8775389,929472,7340573,12234288,"CPR",9787431
1,2.0,"Eastern Europe",3788334,3239029,549305,2880021,4800036,"POL",3840029
1,2.0,"India",5063350,4853982,209368,3817265,6362108,"IND",5089687
1,2.0,"Middle Africa",44985,0,44985,35870,59783,"AGO",47827
1,2.0,"Western Asia",184380,0,184380,147031,245052,"IRQ",196042
1,2.0,"United States of America",2681208,2681208,0,2133588,3555980,"USA",2844784
1,2.0,"Western Europe",2795346,2788234,7112,2201059,3668432,"NLD",2934746
1,2.0,"Russian Federation",4130346,3466740,663606,3136330,5227217,"RUS",4181774
1,2.0,"Northern Africa",1029005,0,1029005,820571,1367618,"EGY",1094095
1,2.0,"Eastern Asia",906221,0,906221,722660,1204433,"JPN",963547
1,2.0,"Western Africa",203734,0,203734,162462,270771,"NGA",216617
1,2.0,"Southern Europe",334460,0,334460,266713,444522,"ITA",355618
1,3.0,"Northern America",727812,727458,354,585372,975620,"CAN",780496
1,3.0,"Southern Asia",377913,0,377913,298897,498162,"IRN",398530
1,3.0,"South America",1664877,1304325,360552,1271164,2118607,"BRA",1694886
1,3.0,"Central Asia",1254018,1108926,145092,950910,1584851,"UZB",1267881
1,3.0,"South-Eastern Asia",526735,0,526735,416601,694336,"IDN",555469
1,3.0,"Pakistan",1544737,1261966,282771,1177605,1962676,"PAK",1570141
1,3.0,"Southern Africa",105001,0,105001,83046,138410,"ZAF",110728
1,3.0,"Northern Europe",1597480,1597480,0,1216355,2027258,"GBR",1621807
1,3.0,"Oceania",379910,379910,0,292238,487063,"NZL",389651
1,3.0,"Central America",360517,0,360517,285138,475230,"MEX",380184
1,3.0,"Eastern Africa",117955,0,117955,93290,155483,"ETH",124387
1,3.0,"China",9668930,8760911,908019,7340573,12234288,"CPR",9787431
1,3.0,"Eastern Europe",3768631,3226221,542410,2880021,4800036,"POL",3840029
1,3.0,"India",5053077,4857124,195953,3817265,6362108,"IND",5089687
1,3.0,"Middle Africa",45356,0,45356,35870,59783,"AGO",47827
1,3.0,"Western Asia",185902,0,185902,147031,245052,"IRQ",196042
1,3.0,"United States of America",2688320,2688320,0,2133588,3555980,"USA",2844784
1,3.0,"Western Europe",2795346,2782649,12697,2201059,3668432,"NLD",2934746
1,3.0,"Russian Federation",4127266,3470628,656638,3136330,5227217,"RUS",4181774
1,3.0,"Northern Africa",1037493,0,1037493,820571,1367618,"EGY",1094095
1,3.0,"Eastern Asia",913697,0,913697,722660,1204433,"JPN",963547
1,3.0,"Western Africa",205414,0,205414,162462,270771,"NGA",216617
1,3.0,"Southern Europe",337219,0,337219,266713,444522,"ITA",355618
1,4.0,"Northern America",727812,727812,0,585372,975620,"CAN",780496
1,4.0,"Southern Asia",380843,0,380843,298897,498162,"IRN",398530
1,4.0,"South America",1664490,1306149,358341,1271164,2118607,"BRA",1694886
1,4.0,"Central Asia",1249668,1107195,142473,950910,1584851,"UZB",1267881
1,4.0,"South-Eastern Asia",530817,0,530817,416601,694336,"IDN",555469
1,4.0,"Pakistan",1540691,1260366,280325,1177605,1962676,"PAK",1570141
1,4.0,"Southern Africa",105814,0,105814,83046,138410,"ZAF",110728
1,4.0,"Northern Europe",1597480,1597480,0,1216355,2027258,"GBR",1621807
1,4.0,"Oceania",385755,385755,0,292238,487063,"NZL",389651
1,4.0,"Central America",363311,0,363311,285138,475230,"MEX",380184
1,4.0,"Eastern Africa",118869,0,118869,93290,155483,"ETH",124387
1,4.0,"China",9654502,8768353,886149,7340573,12234288,"CPR",9787431
1,4.0,"Eastern Europe",3756794,3221522,535272,2880021,4800036,"POL",3840029
1,4.0,"India",5030578,4848139,182439,3817265,6362108,"IND",5089687
1,4.0,"Middle Africa",45707,0,45707,35870,59783,"AGO",47827
1,4.0,"Western Asia",187344,0,187344,147031,245052,"IRQ",196042
1,4.0,"United States of America",2723880,2723880,0,2133588,3555980,"USA",2844784
1,4.0,"Western Europe",2802683,2785431,17252,2201059,3668432,"NLD",2934746
1,4.0,"Russian Federation",4115235,3465859,649376,3136330,5227217,"RUS",4181774
1,4.0,"Northern Africa",1045534,0,1045534,820571,1367618,"EGY",1094095
1,4.0,"Eastern Asia",920778,0,920778,722660,1204433,"JPN",963547
1,4.0,"Western Africa",207006,0,207006,162462,270771,"NGA",216617
1,4.0,"Southern Europe",339832,0,339832,266713,444522,"ITA",355618
1,5.0,"Northern America",729763,729763,0,585372,975620,"CAN",780496
1,5.0,"Southern Asia",383207,0,383207,298897,498162,"IRN",398530
1,5.0,"South America",1660290,1304713,355577,1271164,2118607,"BRA",1694886
1,5.0,"Central Asia",1247855,1108231,139624,950910,1584851,"UZB",1267881
1,5.0,"South-Eastern Asia",534112,0,534112,416601,694336,"IDN",555469
1,5.0,"Pakistan",1536209,1258766,277443,1177605,1962676,"PAK",1570141
1,5.0,"Southern Africa",106471,0,106471,83046,138410,"ZAF",110728
1,5.0,"Northern Europe",1593426,1593426,0,1216355,2027258,"GBR",1621807
1,5.0,"Oceania",390626,390626,0,292238,487063,"NZL",389651
1,5.0,"Central America",365566,0,365566,285138,475230,"MEX",380184
1,5.0,"Eastern Africa",119606,0,119606,93290,155483,"ETH",124387
1,5.0,"China",9638630,8775795,862835,7340573,12234288,"CPR",9787431
1,5.0,"Eastern Europe",3744114,3216824,527290,2880021,4800036,"POL",3840029
1,5.0,"India",5019868,4851281,168587,3817265,6362108,"IND",5089687
1,5.0,"Middle Africa",45991,0,45991,35870,59783,"AGO",47827
1,5.0,"Western Asia",188506,0,188506,147031,245052,"IRQ",196042
1,5.0,"United States of America",2752328,2752328,0,2133588,3555980,"USA",2844784
1,5.0,"Western Europe",2802683,2782021,20662,2201059,3668432,"NLD",2934746
1,5.0,"Russian Federation",4110843,3469747,641096,3136330,5227217,"RUS",4181774
1,5.0,"Northern Africa",1052025,0,1052025,820571,1367618,"EGY",1094095
1,5.0,"Eastern Asia",926494,0,926494,722660,1204433,"JPN",963547
1,5.0,"Western Africa",208291,0,208291,162462,270771,"NGA",216617
1,5.0,"Southern Europe",341941,0,341941,266713,444522,"ITA",355618
1,6.0,"Northern America",753178,752049,1129,585372,975620,"CAN",780496
1,6.0,"Southern Asia",386430,0,386430,298897,498162,"IRN",398530
1,6.0,"South America",1660191,1306538,353653,1271164,2118607,"BRA",1694886
1,6.0,"Central Asia",1243625,1106500,137125,950910,1584851,"UZB",1267881
1,6.0,"South-Eastern Asia",538602,0,538602,416601,694336,"IDN",555469
1,6.0,"Pakistan",1532390,1257166,275224,1177605,1962676,"PAK",1570141
1,6.0,"Southern Africa",107366,0,107366,83046,138410,"ZAF",110728
1,6.0,"Northern Europe",1589371,1589371,0,1216355,2027258,"GBR",1621807
1,6.0,"Oceania",396470,396470,0,292238,487063,"NZL",389651
1,6.0,"Central America",368641,0,368641,285138,475230,"MEX",380184
1,6.0,"Eastern Africa",120613,0,120613,93290,155483,"ETH",124387
1,6.0,"China",9603033,8761317,841716,7340573,12234288,"CPR",9787431
1,6.0,"Eastern Europe",3732716,3212125,520591,2880021,4800036,"POL",3840029
1,6.0,"India",5009671,4854423,155248,3817265,6362108,"IND",5089687
1,6.0,"Middle Africa",46378,0,46378,35870,59783,"AGO",47827
1,6.0,"Western Asia",190091,0,190091,147031,245052,"IRQ",196042
1,6.0,"United States of America",2752328,2752328,0,2133588,3555980,"USA",2844784
1,6.0,"Western Europe",2802683,2779433,23250,2201059,3668432,"NLD",2934746
1,6.0,"Russian Federation",4099342,3464978,634364,3136330,5227217,"RUS",4181774
1,6.0,"Northern Africa",1060870,0,1060870,820571,1367618,"EGY",1094095
1,6.0,"Eastern Asia",934284,0,934284,722660,1204433,"JPN",963547
1,6.0,"Western Africa",210043,0,210043,162462,270771,"NGA",216617
1,6.0,"Southern Europe",344816,0,344816,266713,444522,"ITA",355618
1,7.0,"Northern America",753178,753178,0,585372,975620,"CAN",780496
1,7.0,"Southern Asia",389140,0,389140,298897,498162,"IRN",398530
1,7.0,"South America",1656332,1305102,351230,1271164,2118607,"BRA",1694886
1,7.0,"Central Asia",1239185,1104768,134417,950910,1584851,"UZB",1267881
1,7.0,"South-Eastern Asia",542382,0,542382,416601,694336,"IDN",555469
1,7.0,"Pakistan",1528177,1255566,272611,1177605,1962676,"PAK",1570141
1,7.0,"Southern Africa",108119,0,108119,83046,138410,"ZAF",110728
1,7.0,"Northern Europe",1589371,1589371,0,1216355,2027258,"GBR",1621807
1,7.0,"Oceania",400367,400367,0,292238,487063,"NZL",389651
1,7.0,"Central America",371228,0,371228,285138,475230,"MEX",380184
1,7.0,"Eastern Africa",121459,0,121459,93290,155483,"ETH",124387
1,7.0,"China",9588050,8768760,819290,7340573,12234288,"CPR",9787431
1,7.0,"Eastern Europe",3720554,3207426,513128,2880021,4800036,"POL",3840029
1,7.0,"India",4999170,4857565,141605,3817265,6362108,"IND",5089687
1,7.0,"Middle Africa",46703,0,46703,35870,59783,"AGO",47827
1,7.0,"Western Asia",191423,0,191423,147031,245052,"IRQ",196042
1,7.0,"United States of America",2787888,2787888,0,2133588,3555980,"USA",2844784
1,7.0,"Western Europe",2810020,2786770,23250,2201059,3668432,"NLD",2934746
1,7.0,"Russian Federation",4095575,3468865,626710,3136330,5227217,"RUS",4181774
1,7.0,"Northern Africa",1068313,0,1068313,820571,1367618,"EGY",1094095
1,7.0,"Eastern Asia",940839,0,940839,722660,1204433,"JPN",963547
1,7.0,"Western Africa",211517,0,211517,162462,270771,"NGA",216617
1,7.0,"Southern Europe",347236,0,347236,266713,444522,"ITA",355618
1,8.0,"Northern America",755129,755129,0,585372,975620,"CAN",780496
1,8.0,"Southern Asia",391342,0,391342,298897,498162,"IRN",398530
1,8.0,"South America",1655232,1306926,348306,1271164,2118607,"BRA",1694886
1,8.0,"Central Asia",1237308,1105804,131504,950910,1584851,"UZB",1267881
1,8.0,"South-Eastern Asia",545451,0,545451,416601,694336,"IDN",555469
1,8.0,"Pakistan",1523568,1253966,269602,1177605,1962676,"PAK",1570141
1,8.0,"Southern Africa",108731,0,108731,83046,138410,"ZAF",110728
1,8.0,"Northern Europe",1585317,1585317,0,1216355,2027258,"GBR",1621807
1,8.0,"Oceania",402315,402315,0,292238,487063,"NZL",389651
1,8.0,"Central America",373328,0,373328,285138,475230,"MEX",380184
1,8.0,"Eastern Africa",122146,0,122146,93290,155483,"ETH",124387
1,8.0,"China",9549842,8754282,795560,7340573,12234288,"CPR",9787431
1,8.0,"Eastern Europe",3723848,3218592,505256,2880021,4800036,"POL",3840029
1,8.0,"India",4976235,4848580,127655,3817265,6362108,"IND",5089687
1,8.0,"Middle Africa",46967,0,46967,35870,59783,"AGO",47827
1,8.0,"Western Asia",192507,0,192507,147031,245052,"IRQ",196042
1,8.0,"United States of America",2823448,2823448,0,2133588,3555980,"USA",2844784
1,8.0,"Western Europe",2802683,2786648,16035,2201059,3668432,"NLD",2934746
1,8.0,"Russian Federation",4082233,3464096,618137,3136330,5227217,"RUS",4181774
1,8.0,"Northern Africa",1074358,0,1074358,820571,1367618,"EGY",1094095
1,8.0,"Eastern Asia",946163,0,946163,722660,1204433,"JPN",963547
1,8.0,"Western Africa",212712,0,212712,162462,270771,"NGA",216617
1,8.0,"Southern Europe",349201,0,349201,266713,444522,"ITA",355618
1,9.0,"Northern America",762934,762934,0,585372,975620,"CAN",780496
1,9.0,"Southern Asia",393892,0,393892,298897,498162,"IRN",398530
1,9.0,"South America",1651213,1305490,345723,1271164,2118607,"BRA",1694886
1,9.0,"Central Asia",1232803,1104073,128730,950910,1584851,"UZB",1267881
1,9.0,"South-Eastern Asia",549004,0,549004,416601,694336,"IDN",555469
1,9.0,"Pakistan",1519230,1252366,266864,1177605,1962676,"PAK",1570141
1,9.0,"Southern Africa",109440,0,109440,83046,138410,"ZAF",110728
1,9.0,"Northern Europe",1581262,1581262,0,1216355,2027258,"GBR",1621807
1,9.0,"Oceania",402315,402315,0,292238,487063,"NZL",389651
1,9.0,"Central America",375760,0,375760,285138,475230,"MEX",380184
1,9.0,"Eastern Africa",122942,0,122942,93290,155483,"ETH",124387
1,9.0,"China",9534443,8761724,772719,7340573,12234288,"CPR",9787431
1,9.0,"Eastern Europe",3711446,3213717,497729,2880021,4800036,"POL",3840029
1,9.0,"India",4965637,4851722,113915,3817265,6362108,"IND",5089687
1,9.0,"Middle Africa",47273,0,47273,35870,59783,"AGO",47827
1,9.0,"Western Asia",193761,0,193761,147031,245052,"IRQ",196042
1,9.0,"United States of America",2844784,2844784,0,2133588,3555980,"USA",2844784
1,9.0,"Western Europe",2817357,2800800,16557,2201059,3668432,"NLD",2934746
1,9.0,"Russian Federation",4078175,3467984,610191,3136330,5227217,"RUS",4181774
1,9.0,"Northern Africa",1081357,0,1081357,820571,1367618,"EGY",1094095
1,9.0,"Eastern Asia",952327,0,952327,722660,1204433,"JPN",963547
1,9.0,"Western Africa",214099,0,214099,162462,270771,"NGA",216617
1,9.0,"Southern Europe",351477,0,351477,266713,444522,"ITA",355618
1,10.0,"Northern America",772691,772691,0,585372,975620,"CAN",780496
1,10.0,"Southern Asia",396414,0,396414,298897,498162,"IRN",398530
1,10.0,"South America",1647167,1304055,343112,1271164,2118607,"BRA",1694886
1,10.0,"Central Asia",1228287,1102342,125945,950910,1584851,"UZB",1267881
1,10.0,"South-Eastern Asia",552518,0,552518,416601,694336,"IDN",555469
1,10.0,"Pakistan",1518025,1253921,264104,1177605,1962676,"PAK",1570141
1,10.0,"Southern Africa",110139,0,110139,83046,138410,"ZAF",110728
1,10.0,"Northern Europe",1577208,1577208,0,1216355,2027258,"GBR",1621807
1,10.0,"Oceania",402315,402315,0,292238,487063,"NZL",389651
1,10.0,"Central America",378165,0,378165,285138,475230,"MEX",380184
1,10.0,"Eastern Africa",123728,0,123728,93290,155483,"ETH",124387
1,10.0,"China",9497054,8747246,749808,7340573,12234288,"CPR",9787431
1,10.0,"Eastern Europe",3699000,3208664,490336,2880021,4800036,"POL",3840029
1,10.0,"India",4955020,4854863,100157,3817265,6362108,"IND",5089687
1,10.0,"Middle Africa",47576,0,47576,35870,59783,"AGO",47827
1,10.0,"Western Asia",195003,0,195003,147031,245052,"IRQ",196042
1,10.0,"United States of America",2866119,2866119,0,2133588,3555980,"USA",2844784
1,10.0,"Western Europe",2824694,2807076,17618,2201059,3668432,"NLD",2934746
1,10.0,"Russian Federation",4065409,3463215,602194,3136330,5227217,"RUS",4181774
1,10.0,"Northern Africa",1088280,0,1088280,820571,1367618,"EGY",1094095
1,10.0,"Eastern Asia",958423,0,958423,722660,1204433,"JPN",963547
1,10.0,"Western Africa",215469,0,215469,162462,270771,"NGA",216617
1,10.0,"Southern Europe",353726,0,353726,266713,444522,"ITA",355618
1,11.0,"Northern America",776593,776593,0,585372,975620,"CAN",780496
1,11.0,"Southern Asia",398360,0,398360,298897,498162,"IRN",398530
1,11.0,"South America",1645924,1305879,340045,1271164,2118607,"BRA",1694886
1,11.0,"Central Asia",1223539,1100610,122929,950910,1584851,"UZB",1267881
1,11.0,"South-Eastern Asia",555231,0,555231,416601,694336,"IDN",555469
1,11.0,"Pakistan",1513220,1252321,260899,1177605,1962676,"PAK",1570141
1,11.0,"Southern Africa",110680,0,110680,83046,138410,"ZAF",110728
1,11.0,"Northern Europe",1577208,1577208,0,1216355,2027258,"GBR",1621807
1,11.0,"Oceania",401341,401341,0,292238,487063,"NZL",389651
1,11.0,"Central America",380022,0,380022,285138,475230,"MEX",380184
1,11.0,"Eastern Africa",124336,0,124336,93290,155483,"ETH",124387
1,11.0,"China",9480114,8754688,725426,7340573,12234288,"CPR",9787431
1,11.0,"Eastern Europe",3685858,3203435,482423,2880021,4800036,"POL",3840029
1,11.0,"India",4931932,4845878,86054,3817265,6362108,"IND",5089687
1,11.0,"Middle Africa",47810,0,47810,35870,59783,"AGO",47827
1,11.0,"Western Asia",195960,0,195960,147031,245052,"IRQ",196042
1,11.0,"United States of America",2873231,2873231,0,2133588,3555980,"USA",2844784
1,11.0,"Western Europe",2861378,2843053,18325,2201059,3668432,"NLD",2934746
1,11.0,"Russian Federation",4060264,3467103,593161,3136330,5227217,"RUS",4181774
1,11.0,"Northern Africa",1093625,0,1093625,820571,1367618,"EGY",1094095
1,11.0,"Eastern Asia",963130,0,963130,722660,1204433,"JPN",963547
1,11.0,"Western Africa",216528,0,216528,162462,270771,"NGA",216617
1,11.0,"Southern Europe",355463,0,355463,266713,444522,"ITA",355618
1,12.0,"Northern America",776593,776593,0,585372,975620,"CAN",780496
1,12.0,"Southern Asia",400371,0,400371,298897,498162,"IRN",398530
1,12.0,"South America",1641484,1304443,337041,1271164,2118607,"BRA",1694886
1,12.0,"Central Asia",1221584,1101646,119938,950910,1584851,"UZB",1267881
1,12.0,"South-Eastern Asia",558035,0,558035,416601,694336,"IDN",555469
1,12.0,"Pakistan",1508465,1250721,257744,1177605,1962676,"PAK",1570141
1,12.0,"Southern Africa",111238,0,111238,83046,138410,"ZAF",110728
1,12.0,"Northern Europe",1593426,1593426,0,1216355,2027258,"GBR",1621807
1,12.0,"Oceania",400367,400367,0,292238,487063,"NZL",389651
1,12.0,"Central America",381940,0,381940,285138,475230,"MEX",380184
1,12.0,"Eastern Africa",124964,0,124964,93290,155483,"ETH",124387
1,12.0,"China",9463340,8762131,701209,7340573,12234288,"CPR",9787431
1,12.0,"Eastern Europe",3689029,3210848,478181,2880021,4800036,"POL",3840029
1,12.0,"India",4920961,4849020,71941,3817265,6362108,"IND",5089687
1,12.0,"Middle Africa",48051,0,48051,35870,59783,"AGO",47827
1,12.0,"Western Asia",196948,0,196948,147031,245052,"IRQ",196042
1,12.0,"United States of America",2908791,2908791,0,2133588,3555980,"USA",2844784
1,12.0,"Western Europe",2861378,2851857,9521,2201059,3668432,"NLD",2934746
1,12.0,"Russian Federation",4055235,3470991,584244,3136330,5227217,"RUS",4181774
1,12.0,"Northern Africa",1099146,0,1099146,820571,1367618,"EGY",1094095
1,12.0,"Eastern Asia",967993,0,967993,722660,1204433,"JPN",963547
1,12.0,"Western Africa",217621,0,217621,162462,270771,"NGA",216617
1,12.0,"Southern Europe",357258,0,357258,266713,444522,"ITA",355618
1,13.0,"Northern America",784398,784398,0,585372,975620,"CAN",780496
1,13.0,"Southern Asia",402508,0,402508,298897,498162,"IRN",398530
1,13.0,"South America",1640106,1304573,335533,1271164,2118607,"BRA",1694886
1,13.0,"Central Asia",1216914,1099915,116999,950910,1584851,"UZB",1267881
1,13.0,"South-Eastern Asia",561015,0,561015,416601,694336,"IDN",555469
1,13.0,"Pakistan",1503806,1249121,254685,1177605,1962676,"PAK",1570141
1,13.0,"Southern Africa",111833,0,111833,83046,138410,"ZAF",110728
1,13.0,"Northern Europe",1593426,1593426,0,1216355,2027258,"GBR",1621807
1,13.0,"Oceania",405237,405237,0,292238,487063,"NZL",389651
1,13.0,"Central America",383980,0,383980,285138,475230,"MEX",380184
1,13.0,"Eastern Africa",125631,0,125631,93290,155483,"ETH",124387
1,13.0,"China",9424968,8747653,677315,7340573,12234288,"CPR",9787431
1,13.0,"Eastern Europe",3683790,3209446,474344,2880021,4800036,"POL",3840029
1,13.0,"India",4910113,4852162,57951,3817265,6362108,"IND",5089687
1,13.0,"Middle Africa",48306,0,48306,35870,59783,"AGO",47827
1,13.0,"Western Asia",198000,0,198000,147031,245052,"IRQ",196042
1,13.0,"United States of America",2908791,2908791,0,2133588,3555980,"USA",2844784
1,13.0,"Western Europe",2883388,2873336,10052,2201059,3668432,"NLD",2934746
1,13.0,"Russian Federation",4041776,3466221,575555,3136330,5227217,"RUS",4181774
1,13.0,"Northern Africa",1105013,0,1105013,820571,1367618,"EGY",1094095
1,13.0,"Eastern Asia",973161,0,973161,722660,1204433,"JPN",963547
1,13.0,"Western Africa",218782,0,218782,162462,270771,"NGA",216617
1,13.0,"Southern Europe",359165,0,359165,266713,444522,"ITA",355618
1,14.0,"Northern America",784398,784398,0,585372,975620,"CAN",780496
1,14.0,"Southern Asia",404323,0,404323,298897,498162,"IRN",398530
1,14.0,"South America",1638629,1304140,334489,1271164,2118607,"BRA",1694886
1,14.0,"Central Asia",1212114,1098184,113930,950910,1584851,"UZB",1267881
1,14.0,"South-Eastern Asia",563545,0,563545,416601,694336,"IDN",555469
1,14.0,"Pakistan",1502056,1250676,251380,1177605,1962676,"PAK",1570141
1,14.0,"Southern Africa",112338,0,112338,83046,138410,"ZAF",110728
1,14.0,"Northern Europe",1593426,1593426,0,1216355,2027258,"GBR",1621807
1,14.0,"Oceania",406212,406212,0,292238,487063,"NZL",389651
1,14.0,"Central America",385712,0,385712,285138,475230,"MEX",380184
1,14.0,"Eastern Africa",126198,0,126198,93290,155483,"ETH",124387
1,14.0,"China",9407693,8755095,652598,7340573,12234288,"CPR",9787431
1,14.0,"Eastern Europe",3678399,3206040,472359,2880021,4800036,"POL",3840029
1,14.0,"India",4886947,4843177,43770,3817265,6362108,"IND",5089687
1,14.0,"Middle Africa",48524,0,48524,35870,59783,"AGO",47827
1,14.0,"Western Asia",198893,0,198893,147031,245052,"IRQ",196042
1,14.0,"United States of America",2930127,2930127,0,2133588,3555980,"USA",2844784
1,14.0,"Western Europe",2898062,2888010,10052,2201059,3668432,"NLD",2934746
1,14.0,"Russian Federation",4036394,3470109,566285,3136330,5227217,"RUS",4181774
1,14.0,"Northern Africa",1109998,0,1109998,820571,1367618,"EGY",1094095
1,14.0,"Eastern Asia",977550,0,977550,722660,1204433,"JPN",963547
1,14.0,"Western Africa",219768,0,219768,162462,270771,"NGA",216617
1,14.0,"Southern Europe",360784,0,360784,266713,444522,"ITA",355618
1,15.0,"Northern America",788300,788300,0,585372,975620,"CAN",780496
1,15.0,"Southern Asia",405748,0,405748,298897,498162,"IRN",398530
1,15.0,"South America",1640026,1304715,335311,1271164,2118607,"BRA",1694886
1,15.0,"Central Asia",1209924,1099220,110704,950910,1584851,"UZB",1267881
1,15.0,"South-Eastern Asia",565531,0,565531,416601,694336,"IDN",555469
1,15.0,"Pakistan",1496847,1249076,247771,1177605,1962676,"PAK",1570141
1,15.0,"Southern Africa",112733,0,112733,83046,138410,"ZAF",110728
1,15.0,"Northern Europe",1621808,1621808,0,1216355,2027258,"GBR",1621807
1,15.0,"Oceania",410108,410108,0,292238,487063,"NZL",389651
1,15.0,"Central America",387072,0,387072,285138,475230,"MEX",380184
1,15.0,"Eastern Africa",126643,0,126643,93290,155483,"ETH",124387
1,15.0,"China",9389417,8762537,626880,7340573,12234288,"CPR",9787431
1,15.0,"Eastern Europe",3680530,3209205,471325,2880021,4800036,"POL",3840029
1,15.0,"India",4875725,4846319,29406,3817265,6362108,"IND",5089687
1,15.0,"Middle Africa",48696,0,48696,35870,59783,"AGO",47827
1,15.0,"Western Asia",199594,0,199594,147031,245052,"IRQ",196042
1,15.0,"United States of America",2937239,2937239,0,2133588,3555980,"USA",2844784
1,15.0,"Western Europe",2898062,2896814,1248,2201059,3668432,"NLD",2934746
1,15.0,"Russian Federation",4021650,3465340,556310,3136330,5227217,"RUS",4181774
1,15.0,"Northern Africa",1113909,0,1113909,820571,1367618,"EGY",1094095
1,15.0,"Eastern Asia",980993,0,980993,722660,1204433,"JPN",963547
1,15.0,"Western Africa",220543,0,220543,162462,270771,"NGA",216617
1,15.0,"Southern Europe",362056,0,362056,266713,444522,"ITA",355618
1,16.0,"Northern America",792203,792203,0,585372,975620,"CAN",780496
1,16.0,"Southern Asia",407522,0,407522,298897,498162,"IRN",398530
1,16.0,"South America",1641684,1304729,336955,1271164,2118607,"BRA",1694886
1,16.0,"Central Asia",1207873,1100079,107794,950910,1584851,"UZB",1267881
1,16.0,"South-Eastern Asia",568005,0,568005,416601,694336,"IDN",555469
1,16.0,"Pakistan",1495063,1250631,244432,1177605,1962676,"PAK",1570141
1,16.0,"Southern Africa",113227,0,113227,83046,138410,"ZAF",110728
1,16.0,"Northern Europe",1609644,1609644,0,1216355,2027258,"GBR",1621807
1,16.0,"Oceania",414005,414005,0,292238,487063,"NZL",389651
1,16.0,"Central America",388764,0,388764,285138,475230,"MEX",380184
1,16.0,"Eastern Africa",127197,0,127197,93290,155483,"ETH",124387
1,16.0,"China",9350118,8747946,602172,7340573,12234288,"CPR",9787431
1,16.0,"Eastern Europe",3683185,3211157,472028,2880021,4800036,"POL",3840029
1,16.0,"India",4864702,4849461,15241,3817265,6362108,"IND",5089687
1,16.0,"Middle Africa",48908,0,48908,35870,59783,"AGO",47827
1,16.0,"Western Asia",200468,0,200468,147031,245052,"IRQ",196042
1,16.0,"United States of America",2937239,2937239,0,2133588,3555980,"USA",2844784
1,16.0,"Western Europe",2927410,2925278,2132,2201059,3668432,"NLD",2934746
1,16.0,"Russian Federation",4016195,3469228,546967,3136330,5227217,"RUS",4181774
1,16.0,"Northern Africa",1118781,0,1118781,820571,1367618,"EGY",1094095
1,16.0,"Eastern Asia",985286,0,985286,722660,1204433,"JPN",963547
1,16.0,"Western Africa",221508,0,221508,162462,270771,"NGA",216617
1,16.0,"Southern Europe",363640,0,363640,266713,444522,"ITA",355618
1,17.0,"Northern America",792203,792203,0,585372,975620,"CAN",780496
1,17.0,"Southern Asia",408819,0,408819,298897,498162,"IRN",398530
1,17.0,"South America",1643147,1304743,338404,1271164,2118607,"BRA",1694886
1,17.0,"Central Asia",1205629,1100653,104976,950910,1584851,"UZB",1267881
1,17.0,"South-Eastern Asia",569811,0,569811,416601,694336,"IDN",555469
1,17.0,"Pakistan",1492911,1251845,241066,1177605,1962676,"PAK",1570141
1,17.0,"Southern Africa",113587,0,113587,83046,138410,"ZAF",110728
1,17.0,"Northern Europe",1613698,1613698,0,1216355,2027258,"GBR",1621807
1,17.0,"Oceania",413030,413030,0,292238,487063,"NZL",389651
1,17.0,"Central America",390001,0,390001,285138,475230,"MEX",380184
1,17.0,"Eastern Africa",127601,0,127601,93290,155483,"ETH",124387
1,17.0,"China",9331515,8754594,576921,7340573,12234288,"CPR",9787431
1,17.0,"Eastern Europe",3677180,3203718,473462,2880021,4800036,"POL",3840029
1,17.0,"India",4865611,4849961,15650,3817265,6362108,"IND",5089687
1,17.0,"Middle Africa",49063,0,49063,35870,59783,"AGO",47827
1,17.0,"Western Asia",201104,0,201104,147031,245052,"IRQ",196042
1,17.0,"United States of America",2965687,2965687,0,2133588,3555980,"USA",2844784
1,17.0,"Western Europe",2920073,2920073,0,2201059,3668432,"NLD",2934746
1,17.0,"Russian Federation",4001220,3464459,536761,3136330,5227217,"RUS",4181774
1,17.0,"Northern Africa",1122340,0,1122340,820571,1367618,"EGY",1094095
1,17.0,"Eastern Asia",988420,0,988420,722660,1204433,"JPN",963547
1,17.0,"Western Africa",222212,0,222212,162462,270771,"NGA",216617
1,17.0,"Southern Europe",364797,0,364797,266713,444522,"ITA",355618
1,18.0,"Northern America",801959,801959,0,585372,975620,"CAN",780496
1,18.0,"Southern Asia",410499,0,410499,298897,498162,"IRN",398530
1,18.0,"South America",1644923,1304743,340180,1271164,2118607,"BRA",1694886
1,18.0,"Central Asia",1200773,1098284,102489,950910,1584851,"UZB",1267881
1,18.0,"South-Eastern Asia",572153,0,572153,416601,694336,"IDN",555469
1,18.0,"Pakistan",1487900,1249419,238481,1177605,1962676,"PAK",1570141
1,18.0,"Southern Africa",114054,0,114054,83046,138410,"ZAF",110728
1,18.0,"Northern Europe",1609644,1609644,0,1216355,2027258,"GBR",1621807
1,18.0,"Oceania",412056,412056,0,292238,487063,"NZL",389651
1,18.0,"Central America",391604,0,391604,285138,475230,"MEX",380184
1,18.0,"Eastern Africa",128124,0,128124,93290,155483,"ETH",124387
1,18.0,"China",9313892,8761241,552651,7340573,12234288,"CPR",9787431
1,18.0,"Eastern Europe",3679855,3203718,476137,2880021,4800036,"POL",3840029
1,18.0,"India",4866484,4850708,15776,3817265,6362108,"IND",5089687
1,18.0,"Middle Africa",49266,0,49266,35870,59783,"AGO",47827
1,18.0,"Western Asia",201931,0,201931,147031,245052,"IRQ",196042
1,18.0,"United States of America",2965687,2965687,0,2133588,3555980,"USA",2844784
1,18.0,"Western Europe",2942083,2942083,0,2201059,3668432,"NLD",2934746
1,18.0,"Russian Federation",3995593,3468346,527247,3136330,5227217,"RUS",4181774
1,18.0,"Northern Africa",1126952,0,1126952,820571,1367618,"EGY",1094095
1,18.0,"Eastern Asia",992482,0,992482,722660,1204433,"JPN",963547
1,18.0,"Western Africa",223125,0,223125,162462,270771,"NGA",216617
1,18.0,"Southern Europe",366297,0,366297,266713,444522,"ITA",355618
1,19.0,"Northern America",801959,801959,0,585372,975620,"CAN",780496
1,19.0,"Southern Asia",411156,0,411156,298897,498162,"IRN",398530
1,19.0,"South America",1645483,1304743,340740,1271164,2118607,"BRA",1694886
1,19.0,"Central Asia",1201039,1098969,102070,950910,1584851,"UZB",1267881
1,19.0,"South-Eastern Asia",573069,0,573069,416601,694336,"IDN",555469
1,19.0,"Pakistan",1485253,1249065,236188,1177605,1962676,"PAK",1570141
1,19.0,"Southern Africa",114237,0,114237,83046,138410,"ZAF",110728
1,19.0,"Northern Europe",1625862,1625862,0,1216355,2027258,"GBR",1621807
1,19.0,"Oceania",412056,412056,0,292238,487063,"NZL",389651
1,19.0,"Central America",392230,0,392230,285138,475230,"MEX",380184
1,19.0,"Eastern Africa",128330,0,128330,93290,155483,"ETH",124387
1,19.0,"China",9293652,8767888,525764,7340573,12234288,"CPR",9787431
1,19.0,"Eastern Europe",3697056,3208416,488640,2880021,4800036,"POL",3840029
1,19.0,"India",4866972,4851533,15439,3817265,6362108,"IND",5089687
1,19.0,"Middle Africa",49345,0,49345,35870,59783,"AGO",47827
1,19.0,"Western Asia",202254,0,202254,147031,245052,"IRQ",196042
1,19.0,"United States of America",2979911,2979911,0,2133588,3555980,"USA",2844784
1,19.0,"Western Europe",2934747,2934747,0,2201059,3668432,"NLD",2934746
1,19.0,"Russian Federation",3979463,3463351,516112,3136330,5227217,"RUS",4181774
1,19.0,"Northern Africa",1128755,0,1128755,820571,1367618,"EGY",1094095
1,19.0,"Eastern Asia",994070,0,994070,722660,1204433,"JPN",963547
1,19.0,"Western Africa",223482,0,223482,162462,270771,"NGA",216617
1,19.0,"Southern Europe",366883,0,366883,266713,444522,"ITA",355618
1,20.0,"Northern America",801959,801959,0,585372,975620,"CAN",780496
1,20.0,"Southern Asia",411865,0,411865,298897,498162,"IRN",398530
1,20.0,"South America",1646199,1304743,341456,1271164,2118607,"BRA",1694886
1,20.0,"Central Asia",1201325,1099407,101918,950910,1584851,"UZB",1267881
1,20.0,"South-Eastern Asia",574056,0,574056,416601,694336,"IDN",555469
1,20.0,"Pakistan",1485801,1251268,234533,1177605,1962676,"PAK",1570141
1,20.0,"Southern Africa",114433,0,114433,83046,138410,"ZAF",110728
1,20.0,"Northern Europe",1621808,1621808,0,1216355,2027258,"GBR",1621807
1,20.0,"Oceania",412056,412056,0,292238,487063,"NZL",389651
1,20.0,"Central America",392906,0,392906,285138,475230,"MEX",380184
1,20.0,"Eastern Africa",128551,0,128551,93290,155483,"ETH",124387
1,20.0,"China",9251624,8752502,499122,7340573,12234288,"CPR",9787431
1,20.0,"Eastern Europe",3706226,3205006,501220,2880021,4800036,"POL",3840029
1,20.0,"India",4855138,4839781,15357,3817265,6362108,"IND",5089687
1,20.0,"Middle Africa",49430,0,49430,35870,59783,"AGO",47827
1,20.0,"Western Asia",202603,0,202603,147031,245052,"IRQ",196042
1,20.0,"United States of America",2979911,2979911,0,2133588,3555980,"USA",2844784
1,20.0,"Western Europe",2956757,2956580,177,2201059,3668432,"NLD",2934746
1,20.0,"Russian Federation",3972084,3466559,505525,3136330,5227217,"RUS",4181774
1,20.0,"Northern Africa",1130700,0,1130700,820571,1367618,"EGY",1094095
1,20.0,"Eastern Asia",995783,0,995783,722660,1204433,"JPN",963547
1,20.0,"Western Africa",223867,0,223867,162462,270771,"NGA",216617
1,20.0,"Southern Europe",367515,0,367515,266713,444522,"ITA",355618
1,21.0,"Northern America",803910,803910,0,585372,975620,"CAN",780496
1,21.0,"Southern Asia",412842,0,412842,298897,498162,"IRN",398530
1,21.0,"South America",1646943,1304743,342200,1271164,2118607,"BRA",1694886
1,21.0,"Central Asia",1201721,1099407,102314,950910,1584851,"UZB",1267881
1,21.0,"South-Eastern Asia",575418,0,575418,416601,694336,"IDN",555469
1,21.0,"Pakistan",1483402,1249879,233523,1177605,1962676,"PAK",1570141
1,21.0,"Southern Africa",114704,0,114704,83046,138410,"ZAF",110728
1,21.0,"Northern Europe",1621808,1621808,0,1216355,2027258,"GBR",1621807
1,21.0,"Oceania",415953,415953,0,292238,487063,"NZL",389651
1,21.0,"Central America",393839,0,393839,285138,475230,"MEX",380184
1,21.0,"Eastern Africa",128856,0,128856,93290,155483,"ETH",124387
1,21.0,"China",9232204,8758810,473394,7340573,12234288,"CPR",9787431
1,21.0,"Eastern Europe",3707363,3205006,502357,2880021,4800036,"POL",3840029
1,21.0,"India",4856014,4839847,16167,3817265,6362108,"IND",5089687
1,21.0,"Middle Africa",49547,0,49547,35870,59783,"AGO",47827
1,21.0,"Western Asia",203083,0,203083,147031,245052,"IRQ",196042
1,21.0,"United States of America",2994135,2994135,0,2133588,3555980,"USA",2844784
1,21.0,"Western Europe",2942083,2942083,0,2201059,3668432,"NLD",2934746
1,21.0,"Russian Federation",3965190,3468976,496214,3136330,5227217,"RUS",4181774
1,21.0,"Northern Africa",1133383,0,1133383,820571,1367618,"EGY",1094095
1,21.0,"Eastern Asia",998145,0,998145,722660,1204433,"JPN",963547
1,21.0,"Western Africa",224400,0,224400,162462,270771,"NGA",216617
1,21.0,"Southern Europe",368386,0,368386,266713,444522,"ITA",355618
1,22.0,"Northern America",803910,803910,0,585372,975620,"CAN",780496
1,22.0,"Southern Asia",413441,0,413441,298897,498162,"IRN",398530
1,22.0,"South America",1647660,1304743,342917,1271164,2118607,"BRA",1694886
1,22.0,"Central Asia",1201963,1099407,102556,950910,1584851,"UZB",1267881
1,22.0,"South-Eastern Asia",576283,0,576283,416601,694336,"IDN",555469
1,22.0,"Pakistan",1483865,1251055,232810,1177605,1962676,"PAK",1570141
1,22.0,"Southern Africa",114871,0,114871,83046,138410,"ZAF",110728
1,22.0,"Northern Europe",1617753,1617753,0,1216355,2027258,"GBR",1621807
1,22.0,"Oceania",414979,414979,0,292238,487063,"NZL",389651
1,22.0,"Central America",394410,0,394410,285138,475230,"MEX",380184
1,22.0,"Eastern Africa",129043,0,129043,93290,155483,"ETH",124387
1,22.0,"China",9211874,8764557,447317,7340573,12234288,"CPR",9787431
1,22.0,"Eastern Europe",3724641,3210029,514612,2880021,4800036,"POL",3840029
1,22.0,"India",4856097,4839783,16314,3817265,6362108,"IND",5089687
1,22.0,"Middle Africa",49618,0,49618,35870,59783,"AGO",47827
1,22.0,"Western Asia",203378,0,203378,147031,245052,"IRQ",196042
1,22.0,"United States of America",2994135,2994135,0,2133588,3555980,"USA",2844784
1,22.0,"Western Europe",2964094,2964094,0,2201059,3668432,"NLD",2934746
1,22.0,"Russian Federation",3957615,3469019,488596,3136330,5227217,"RUS",4181774
1,22.0,"Northern Africa",1135029,0,1135029,820571,1367618,"EGY",1094095
1,22.0,"Eastern Asia",999595,0,999595,722660,1204433,"JPN",963547
1,22.0,"Western Africa",224726,0,224726,162462,270771,"NGA",216617
1,22.0,"Southern Europe",368920,0,368920,266713,444522,"ITA",355618
1,23.0,"Northern America",807813,807813,0,585372,975620,"CAN",780496
1,23.0,"Southern Asia",414356,0,414356,298897,498162,"IRN",398530
1,23.0,"South America",1648644,1304743,343901,1271164,2118607,"BRA",1694886
1,23.0,"Central Asia",1202332,1099407,102925,950910,1584851,"UZB",1267881
1,23.0,"South-Eastern Asia",577529,0,577529,416601,694336,"IDN",555469
1,23.0,"Pakistan",1484573,1251055,233518,1177605,1962676,"PAK",1570141
1,23.0,"Southern Africa",115125,0,115125,83046,138410,"ZAF",110728
1,23.0,"Northern Europe",1621808,1621808,0,1216355,2027258,"GBR",1621807
1,23.0,"Oceania",414005,414005,0,292238,487063,"NZL",389651
1,23.0,"Central America",395283,0,395283,285138,475230,"MEX",380184
1,23.0,"Eastern Africa",129329,0,129329,93290,155483,"ETH",124387
1,23.0,"China",9170320,8748385,421935,7340573,12234288,"CPR",9787431
1,23.0,"Eastern Europe",3726173,3210601,515572,2880021,4800036,"POL",3840029
1,23.0,"India",4856778,4839362,17416,3817265,6362108,"IND",5089687
1,23.0,"Middle Africa",49728,0,49728,35870,59783,"AGO",47827
1,23.0,"Western Asia",203830,0,203830,147031,245052,"IRQ",196042
1,23.0,"United States of America",3008359,3008359,0,2133588,3555980,"USA",2844784
1,23.0,"Western Europe",2956757,2956757,0,2201059,3668432,"NLD",2934746
1,23.0,"Russian Federation",3959226,3466482,492744,3136330,5227217,"RUS",4181774
1,23.0,"Northern Africa",1137542,0,1137542,820571,1367618,"EGY",1094095
1,23.0,"Eastern Asia",1001807,0,1001807,722660,1204433,"JPN",963547
1,23.0,"Western Africa",225223,0,225223,162462,270771,"NGA",216617
1,23.0,"Southern Europe",369738,0,369738,266713,444522,"ITA",355618
1,24.0,"Northern America",790252,790252,0,585372,975620,"CAN",780496
1,24.0,"Southern Asia",406829,0,406829,298897,498162,"IRN",398530
1,24.0,"South America",1666891,1305600,361291,1271164,2118607,"BRA",1694886
1,24.0,"Central Asia",1213121,1100743,112378,950910,1584851,"UZB",1267881
1,24.0,"South-Eastern Asia",567224,0,567224,416601,694336,"IDN",555469
1,24.0,"Pakistan",1507140,1254072,253068,1177605,1962676,"PAK",1570141
1,24.0,"Southern Africa",113037,0,113037,83046,138410,"ZAF",110728
1,24.0,"Northern Europe",1617752,1617752,0,1216355,2027258,"GBR",1621807
1,24.0,"Oceania",398418,398418,0,292238,487063,"NZL",389651
1,24.0,"Central America",388101,0,388101,285138,475230,"MEX",380184
1,24.0,"Eastern Africa",126980,0,126980,93290,155483,"ETH",124387
1,24.0,"China",9216813,8764912,451901,7340573,12234288,"CPR",9787431
1,24.0,"Eastern Europe",3762912,3207897,555015,2880021,4800036,"POL",3840029
1,24.0,"India",4864030,4838274,25756,3817265,6362108,"IND",5089687
1,24.0,"Middle Africa",48826,0,48826,35870,59783,"AGO",47827
1,24.0,"Western Asia",200123,0,200123,147031,245052,"IRQ",196042
1,24.0,"United States of America",2937239,2937239,0,2133588,3555980,"USA",2844784
1,24.0,"Western Europe",2964094,2964094,0,2201059,3668432,"NLD",2934746
1,24.0,"Russian Federation",4014977,3471032,543945,3136330,5227217,"RUS",4181774
1,24.0,"Northern Africa",1116875,0,1116875,820571,1367618,"EGY",1094095
1,24.0,"Eastern Asia",983608,0,983608,722660,1204433,"JPN",963547
1,24.0,"Western Africa",221129,0,221129,162462,270771,"NGA",216617
1,24.0,"Southern Europe",363023,0,363023,266713,444522,"ITA",355618
1,25.0,"Northern America",782448,780126,2322,585372,975620,"CAN",780496
1,25.0,"Southern Asia",400161,0,400161,298897,498162,"IRN",398530
1,25.0,"South America",1677039,1304223,372816,1271164,2118607,"BRA",1694886
1,25.0,"Central Asia",1224260,1102222,122038,950910,1584851,"UZB",1267881
1,25.0,"South-Eastern Asia",557824,0,557824,416601,694336,"IDN",555469
1,25.0,"Pakistan",1524068,1254888,269180,1177605,1962676,"PAK",1570141
1,25.0,"Southern Africa",111181,0,111181,83046,138410,"ZAF",110728
1,25.0,"Northern Europe",1621805,1619856,1949,1216355,2027258,"GBR",1621807
1,25.0,"Oceania",387702,387702,0,292238,487063,"NZL",389651
1,25.0,"Central America",381738,0,381738,285138,475230,"MEX",380184
1,25.0,"Eastern Africa",124899,0,124899,93290,155483,"ETH",124387
1,25.0,"China",9287430,8767349,520081,7340573,12234288,"CPR",9787431
1,25.0,"Eastern Europe",3793774,3215674,578100,2880021,4800036,"POL",3840029
1,25.0,"India",4884564,4841842,42722,3817265,6362108,"IND",5089687
1,25.0,"Middle Africa",48027,0,48027,35870,59783,"AGO",47827
1,25.0,"Western Asia",196848,0,196848,147031,245052,"IRQ",196042
1,25.0,"United States of America",2873232,2873232,0,2133588,3555980,"USA",2844784
1,25.0,"Western Europe",2934746,2934746,0,2201059,3668432,"NLD",2934746
1,25.0,"Russian Federation",4046190,3464365,581825,3136330,5227217,"RUS",4181774
1,25.0,"Northern Africa",1098560,0,1098560,820571,1367618,"EGY",1094095
1,25.0,"Eastern Asia",967481,0,967481,722660,1204433,"JPN",963547
1,25.0,"Western Africa",217505,0,217505,162462,270771,"NGA",216617
1,25.0,"Southern Europe",357073,0,357073,266713,444522,"ITA",355618
1,26.0,"Northern America",776595,771940,4655,585372,975620,"CAN",780496
1,26.0,"Southern Asia",394815,0,394815,298897,498162,"IRN",398530
1,26.0,"South America",1685767,1306728,379039,1271164,2118607,"BRA",1694886
1,26.0,"Central Asia",1230404,1101841,128563,950910,1584851,"UZB",1267881
1,26.0,"South-Eastern Asia",550275,0,550275,416601,694336,"IDN",555469
1,26.0,"Pakistan",1535712,1257192,278520,1177605,1962676,"PAK",1570141
1,26.0,"Southern Africa",109699,0,109699,83046,138410,"ZAF",110728
1,26.0,"Northern Europe",1625861,1619708,6153,1216355,2027258,"GBR",1621807
1,26.0,"Oceania",378936,378936,0,292238,487063,"NZL",389651
1,26.0,"Central America",376638,0,376638,285138,475230,"MEX",380184
1,26.0,"Eastern Africa",123229,0,123229,93290,155483,"ETH",124387
1,26.0,"China",9339518,8768293,571225,7340573,12234288,"CPR",9787431
1,26.0,"Eastern Europe",3811710,3219479,592231,2880021,4800036,"POL",3840029
1,26.0,"India",4905548,4845683,59865,3817265,6362108,"IND",5089687
1,26.0,"Middle Africa",47383,0,47383,35870,59783,"AGO",47827
1,26.0,"Western Asia",194215,0,194215,147031,245052,"IRQ",196042
1,26.0,"United States of America",2816336,2816336,0,2133588,3555980,"USA",2844784
1,26.0,"Western Europe",2920072,2920072,0,2201059,3668432,"NLD",2934746
1,26.0,"Russian Federation",4071177,3465051,606126,3136330,5227217,"RUS",4181774
1,26.0,"Northern Africa",1083890,0,1083890,820571,1367618,"EGY",1094095
1,26.0,"Eastern Asia",954558,0,954558,722660,1204433,"JPN",963547
1,26.0,"Western Africa",214600,0,214600,162462,270771,"NGA",216617
1,26.0,"Southern Europe",352303,0,352303,266713,444522,"ITA",355618
1,27.0,"Northern America",772690,765670,7020,585372,975620,"CAN",780496
1,27.0,"Southern Asia",391450,0,391450,298897,498162,"IRN",398530
1,27.0,"South America",1686111,1305575,380536,1271164,2118607,"BRA",1694886
1,27.0,"Central Asia",1237347,1104142,133205,950910,1584851,"UZB",1267881
1,27.0,"South-Eastern Asia",545534,0,545534,416601,694336,"IDN",555469
1,27.0,"Pakistan",1536271,1257615,278656,1177605,1962676,"PAK",1570141
1,27.0,"Southern Africa",108759,0,108759,83046,138410,"ZAF",110728
1,27.0,"Northern Europe",1625863,1619719,6144,1216355,2027258,"GBR",1621807
1,27.0,"Oceania",376013,376013,0,292238,487063,"NZL",389651
1,27.0,"Central America",373430,0,373430,285138,475230,"MEX",380184
1,27.0,"Eastern Africa",122176,0,122176,93290,155483,"ETH",124387
1,27.0,"China",9374768,8763445,611323,7340573,12234288,"CPR",9787431
1,27.0,"Eastern Europe",3823474,3224073,599401,2880021,4800036,"POL",3840029
1,27.0,"India",4915662,4840749,74913,3817265,6362108,"IND",5089687
1,27.0,"Middle Africa",46975,0,46975,35870,59783,"AGO",47827
1,27.0,"Western Asia",192557,0,192557,147031,245052,"IRQ",196042
1,27.0,"United States of America",2787888,2787888,0,2133588,3555980,"USA",2844784
1,27.0,"Western Europe",2890725,2890725,0,2201059,3668432,"NLD",2934746
1,27.0,"Russian Federation",4091090,3469921,621169,3136330,5227217,"RUS",4181774
1,27.0,"Northern Africa",1074662,0,1074662,820571,1367618,"EGY",1094095
1,27.0,"Eastern Asia",946433,0,946433,722660,1204433,"JPN",963547
1,27.0,"Western Africa",212767,0,212767,162462,270771,"NGA",216617
1,27.0,"Southern Europe",349299,0,349299,266713,444522,"ITA",355618
1,28.0,"Northern America",768787,760014,8773,585372,975620,"CAN",780496
1,28.0,"Southern Asia",390114,0,390114,298897,498162,"IRN",398530
1,28.0,"South America",1684387,1304134,380253,1271164,2118607,"BRA",1694886
1,28.0,"Central Asia",1242343,1105665,136678,950910,1584851,"UZB",1267881
1,28.0,"South-Eastern Asia",543882,0,543882,416601,694336,"IDN",555469
1,28.0,"Pakistan",1535238,1257570,277668,1177605,1962676,"PAK",1570141
1,28.0,"Southern Africa",108388,0,108388,83046,138410,"ZAF",110728
1,28.0,"Northern Europe",1593426,1592149,1277,1216355,2027258,"GBR",1621807
1,28.0,"Oceania",378936,378936,0,292238,487063,"NZL",389651
1,28.0,"Central America",372156,0,372156,285138,475230,"MEX",380184
1,28.0,"Eastern Africa",121760,0,121760,93290,155483,"ETH",124387
1,28.0,"China",9415188,8768736,646452,7340573,12234288,"CPR",9787431
1,28.0,"Eastern Europe",3821041,3218571,602470,2880021,4800036,"POL",3840029
1,28.0,"India",4939118,4849863,89255,3817265,6362108,"IND",5089687
1,28.0,"Middle Africa",46816,0,46816,35870,59783,"AGO",47827
1,28.0,"Western Asia",191898,0,191898,147031,245052,"IRQ",196042
1,28.0,"United States of America",2773665,2773665,0,2133588,3555980,"USA",2844784
1,28.0,"Western Europe",2883387,2883030,357,2201059,3668432,"NLD",2934746
1,28.0,"Russian Federation",4097339,3466119,631220,3136330,5227217,"RUS",4181774
1,28.0,"Northern Africa",1070996,0,1070996,820571,1367618,"EGY",1094095
1,28.0,"Eastern Asia",943203,0,943203,722660,1204433,"JPN",963547
1,28.0,"Western Africa",212041,0,212041,162462,270771,"NGA",216617
1,28.0,"Southern Europe",348108,0,348108,266713,444522,"ITA",355618
1,29.0,"Northern America",757081,750584,6497,585372,975620,"CAN",780496
1,29.0,"Southern Asia",388446,0,388446,298897,498162,"IRN",398530
1,29.0,"South America",1683091,1304029,379062,1271164,2118607,"BRA",1694886
1,29.0,"Central Asia",1244433,1105416,139017,950910,1584851,"UZB",1267881
1,29.0,"South-Eastern Asia",541722,0,541722,416601,694336,"IDN",555469
1,29.0,"Pakistan",1533949,1256329,277620,1177605,1962676,"PAK",1570141
1,29.0,"Southern Africa",107923,0,107923,83046,138410,"ZAF",110728
1,29.0,"Northern Europe",1569099,1569099,0,1216355,2027258,"GBR",1621807
1,29.0,"Oceania",378936,378936,0,292238,487063,"NZL",389651
1,29.0,"Central America",370564,0,370564,285138,475230,"MEX",380184
1,29.0,"Eastern Africa",121237,0,121237,93290,155483,"ETH",124387
1,29.0,"China",9454758,8779486,675272,7340573,12234288,"CPR",9787431
1,29.0,"Eastern Europe",3826644,3223220,603424,2880021,4800036,"POL",3840029
1,29.0,"India",4962370,4860064,102306,3817265,6362108,"IND",5089687
1,29.0,"Middle Africa",46615,0,46615,35870,59783,"AGO",47827
1,29.0,"Western Asia",191080,0,191080,147031,245052,"IRQ",196042
1,29.0,"United States of America",2773664,2773664,0,2133588,3555980,"USA",2844784
1,29.0,"Western Europe",2876050,2875331,719,2201059,3668432,"NLD",2934746
1,29.0,"Russian Federation",4102984,3465448,637536,3136330,5227217,"RUS",4181774
1,29.0,"Northern Africa",1066416,0,1066416,820571,1367618,"EGY",1094095
1,29.0,"Eastern Asia",939168,0,939168,722660,1204433,"JPN",963547
1,29.0,"Western Africa",211135,0,211135,162462,270771,"NGA",216617
1,29.0,"Southern Europe",346621,0,346621,266713,444522,"ITA",355618
1,30.0,"Northern America",760982,753778,7204,585372,975620,"CAN",780496
1,30.0,"Southern Asia",387551,0,387551,298897,498162,"IRN",398530
1,30.0,"South America",1678731,1306765,371966,1271164,2118607,"BRA",1694886
1,30.0,"Central Asia",1246842,1106018,140824,950910,1584851,"UZB",1267881
1,30.0,"South-Eastern Asia",540462,0,540462,416601,694336,"IDN",555469
1,30.0,"Pakistan",1536414,1256580,279834,1177605,1962676,"PAK",1570141
1,30.0,"Southern Africa",107677,0,107677,83046,138410,"ZAF",110728
1,30.0,"Northern Europe",1569098,1569098,0,1216355,2027258,"GBR",1621807
1,30.0,"Oceania",380884,380884,0,292238,487063,"NZL",389651
1,30.0,"Central America",369711,0,369711,285138,475230,"MEX",380184
1,30.0,"Eastern Africa",120960,0,120960,93290,155483,"ETH",124387
1,30.0,"China",9474393,8774715,699678,7340573,12234288,"CPR",9787431
1,30.0,"Eastern Europe",3825003,3223072,601931,2880021,4800036,"POL",3840029
1,30.0,"India",4973964,4859511,114453,3817265,6362108,"IND",5089687
1,30.0,"Middle Africa",46508,0,46508,35870,59783,"AGO",47827
1,30.0,"Western Asia",190639,0,190639,147031,245052,"IRQ",196042
1,30.0,"United States of America",2759441,2759441,0,2133588,3555980,"USA",2844784
1,30.0,"Western Europe",2854040,2854040,0,2201059,3668432,"NLD",2934746
1,30.0,"Russian Federation",4110028,3468449,641579,3136330,5227217,"RUS",4181774
1,30.0,"Northern Africa",1063960,0,1063960,820571,1367618,"EGY",1094095
1,30.0,"Eastern Asia",937006,0,937006,722660,1204433,"JPN",963547
1,30.0,"Western Africa",210648,0,210648,162462,270771,"NGA",216617
1,30.0,"Southern Europe",345820,0,345820,266713,444522,"ITA",355618
1,31.0,"Northern America",757080,752137,4943,585372,975620,"CAN",780496
1,31.0,"Southern Asia",386983,0,386983,298897,498162,"IRN",398530
1,31.0,"South America",1671512,1306403,365109,1271164,2118607,"BRA",1694886
1,31.0,"Central Asia",1249376,1107191,142185,950910,1584851,"UZB",1267881
1,31.0,"South-Eastern Asia",539661,0,539661,416601,694336,"IDN",555469
1,31.0,"Pakistan",1539128,1257870,281258,1177605,1962676,"PAK",1570141
1,31.0,"Southern Africa",107519,0,107519,83046,138410,"ZAF",110728
1,31.0,"Northern Europe",1569099,1569099,0,1216355,2027258,"GBR",1621807
1,31.0,"Oceania",381858,381858,0,292238,487063,"NZL",389651
1,31.0,"Central America",369169,0,369169,285138,475230,"MEX",380184
1,31.0,"Eastern Africa",120782,0,120782,93290,155483,"ETH",124387
1,31.0,"China",9494863,8773082,721781,7340573,12234288,"CPR",9787431
1,31.0,"Eastern Europe",3799661,3217742,581919,2880021,4800036,"POL",3840029
1,31.0,"India",4986208,4859608,126600,3817265,6362108,"IND",5089687
1,31.0,"Middle Africa",46440,0,46440,35870,59783,"AGO",47827
1,31.0,"Western Asia",190361,0,190361,147031,245052,"IRQ",196042
1,31.0,"United States of America",2759440,2759440,0,2133588,3555980,"USA",2844784
1,31.0,"Western Europe",2846704,2846704,0,2201059,3668432,"NLD",2934746
1,31.0,"Russian Federation",4109319,3465292,644027,3136330,5227217,"RUS",4181774
1,31.0,"Northern Africa",1062404,0,1062404,820571,1367618,"EGY",1094095
1,31.0,"Eastern Asia",935636,0,935636,722660,1204433,"JPN",963547
1,31.0,"Western Africa",210340,0,210340,162462,270771,"NGA",216617
1,31.0,"Southern Europe",345316,0,345316,266713,444522,"ITA",355618
1,32.0,"Northern America",759032,756380,2652,585372,975620,"CAN",780496
1,32.0,"Southern Asia",387680,0,387680,298897,498162,"IRN",398530
1,32.0,"South America",1666019,1305767,360252,1271164,2118607,"BRA",1694886
1,32.0,"Central Asia",1249660,1106066,143594,950910,1584851,"UZB",1267881
1,32.0,"South-Eastern Asia",540597,0,540597,416601,694336,"IDN",555469
1,32.0,"Pakistan",1542821,1260001,282820,1177605,1962676,"PAK",1570141
1,32.0,"Southern Africa",107712,0,107712,83046,138410,"ZAF",110728
1,32.0,"Northern Europe",1573151,1572681,470,1216355,2027258,"GBR",1621807
1,32.0,"Oceania",377961,377961,0,292238,487063,"NZL",389651
1,32.0,"Central America",369834,0,369834,285138,475230,"MEX",380184
1,32.0,"Eastern Africa",120997,0,120997,93290,155483,"ETH",124387
1,32.0,"China",9518814,8773883,744931,7340573,12234288,"CPR",9787431
1,32.0,"Eastern Europe",3728251,3165903,562348,2880021,4800036,"POL",3840029
1,32.0,"India",4999386,4859766,139620,3817265,6362108,"IND",5089687
1,32.0,"Middle Africa",46522,0,46522,35870,59783,"AGO",47827
1,32.0,"Western Asia",190705,0,190705,147031,245052,"IRQ",196042
1,32.0,"United States of America",2766553,2766553,0,2133588,3555980,"USA",2844784
1,32.0,"Western Europe",2861377,2861377,0,2201059,3668432,"NLD",2934746
1,32.0,"Russian Federation",4119297,3471271,648026,3136330,5227217,"RUS",4181774
1,32.0,"Northern Africa",1064316,0,1064316,820571,1367618,"EGY",1094095
1,32.0,"Eastern Asia",937322,0,937322,722660,1204433,"JPN",963547
1,32.0,"Western Africa",210720,0,210720,162462,270771,"NGA",216617
1,32.0,"Southern Europe",345936,0,345936,266713,444522,"ITA",355618
1,33.0,"Northern America",760982,760666,316,585372,975620,"CAN",780496
1,33.0,"Southern Asia",388433,0,388433,298897,498162,"IRN",398530
1,33.0,"South America",1660064,1305774,354290,1271164,2118607,"BRA",1694886
1,33.0,"Central Asia",1252733,1107425,145308,950910,1584851,"UZB",1267881
1,33.0,"South-Eastern Asia",541623,0,541623,416601,694336,"IDN",555469
1,33.0,"Pakistan",1546558,1262172,284386,1177605,1962676,"PAK",1570141
1,33.0,"Southern Africa",107922,0,107922,83046,138410,"ZAF",110728
1,33.0,"Northern Europe",1577207,1575320,1887,1216355,2027258,"GBR",1621807
1,33.0,"Oceania",378936,378936,0,292238,487063,"NZL",389651
1,33.0,"Central America",370553,0,370553,285138,475230,"MEX",380184
1,33.0,"Eastern Africa",121236,0,121236,93290,155483,"ETH",124387
1,33.0,"China",9542817,8773971,768846,7340573,12234288,"CPR",9787431
1,33.0,"Eastern Europe",3673959,3117437,556522,2880021,4800036,"POL",3840029
1,33.0,"India",5011880,4859126,152754,3817265,6362108,"IND",5089687
1,33.0,"Middle Africa",46614,0,46614,35870,59783,"AGO",47827
1,33.0,"Western Asia",191074,0,191074,147031,245052,"IRQ",196042
1,33.0,"United States of America",2773664,2773664,0,2133588,3555980,"USA",2844784
1,33.0,"Western Europe",2861378,2861378,0,2201059,3668432,"NLD",2934746
1,33.0,"Russian Federation",4120627,3468631,651996,3136330,5227217,"RUS",4181774
1,33.0,"Northern Africa",1066381,0,1066381,820571,1367618,"EGY",1094095
1,33.0,"Eastern Asia",939142,0,939142,722660,1204433,"JPN",963547
1,33.0,"Western Africa",211129,0,211129,162462,270771,"NGA",216617
1,33.0,"Southern Europe",346609,0,346609,266713,444522,"ITA",355618
1,34.0,"Northern America",753179,753179,0,585372,975620,"CAN",780496
1,34.0,"Southern Asia",387159,0,387159,298897,498162,"IRN",398530
1,34.0,"South America",1654649,1305131,349518,1271164,2118607,"BRA",1694886
1,34.0,"Central Asia",1252653,1106020,146633,950910,1584851,"UZB",1267881
1,34.0,"South-Eastern Asia",539823,0,539823,416601,694336,"IDN",555469
1,34.0,"Pakistan",1545574,1261204,284370,1177605,1962676,"PAK",1570141
1,34.0,"Southern Africa",107566,0,107566,83046,138410,"ZAF",110728
1,34.0,"Northern Europe",1581261,1577468,3793,1216355,2027258,"GBR",1621807
1,34.0,"Oceania",377961,377961,0,292238,487063,"NZL",389651
1,34.0,"Central America",369336,0,369336,285138,475230,"MEX",380184
1,34.0,"Eastern Africa",120837,0,120837,93290,155483,"ETH",124387
1,34.0,"China",9561437,8773378,788059,7340573,12234288,"CPR",9787431
1,34.0,"Eastern Europe",3672579,3111016,561563,2880021,4800036,"POL",3840029
1,34.0,"India",5023798,4858392,165406,3817265,6362108,"IND",5089687
1,34.0,"Middle Africa",46458,0,46458,35870,59783,"AGO",47827
1,34.0,"Western Asia",190448,0,190448,147031,245052,"IRQ",196042
1,34.0,"United States of America",2780776,2780776,0,2133588,3555980,"USA",2844784
1,34.0,"Western Europe",2839367,2839367,0,2201059,3668432,"NLD",2934746
1,34.0,"Russian Federation",4118292,3464755,653537,3136330,5227217,"RUS",4181774
1,34.0,"Northern Africa",1062883,0,1062883,820571,1367618,"EGY",1094095
1,34.0,"Eastern Asia",936058,0,936058,722660,1204433,"JPN",963547
1,34.0,"Western Africa",210434,0,210434,162462,270771,"NGA",216617
1,34.0,"Southern Europe",346242,0,346242,266713,444522,"ITA",355618
1,35.0,"Northern America",762934,760628,2306,585372,975621,"CAN",780497
1,35.0,"Southern Asia",386343,0,386343,298901,498168,"IRN",398535
1,35.0,"South America",1650685,1304987,345698,1271166,2118611,"BRA",1694889
1,35.0,"Central Asia",1256519,1107428,149091,950912,1584853,"UZB",1267883
1,35.0,"South-Eastern Asia",538673,0,538673,416605,694342,"IDN",555474
1,35.0,"Pakistan",1548099,1264164,283935,1177614,1962690,"PAK",1570152
1,35.0,"Southern Africa",107341,0,107341,83051,138418,"ZAF",110735
1,35.0,"Northern Europe",1581261,1576944,4317,1216362,2027271,"GBR",1621817
1,35.0,"Oceania",379910,379910,0,292239,487065,"NZL",389652
1,35.0,"Central America",368560,0,368560,285144,475241,"MEX",380193
1,35.0,"Eastern Africa",120582,0,120582,93297,155496,"ETH",124397
1,35.0,"China",9581284,8777150,804134,7340574,12234290,"CPR",9787432
1,35.0,"Eastern Europe",3693719,3112624,581095,2880024,4800041,"POL",3840033
1,35.0,"India",5034829,4858164,176665,3817269,6362115,"IND",5089692
1,35.0,"Middle Africa",46364,0,46364,35875,59792,"AGO",47834
1,35.0,"Western Asia",190046,0,190046,147036,245060,"IRQ",196048
1,35.0,"United States of America",2752329,2752329,0,2133591,3555986,"USA",2844789
1,35.0,"Western Europe",2824693,2824693,0,2201065,3668442,"NLD",2934754
1,35.0,"Russian Federation",4125471,3471412,654059,3136332,5227221,"RUS",4181777
1,35.0,"Northern Africa",1060643,0,1060643,820573,1367622,"EGY",1094098
1,35.0,"Eastern Asia",934088,0,934088,722662,1204437,"JPN",963550
1,35.0,"Western Africa",209991,0,209991,162468,270780,"NGA",216624
1,35.0,"Southern Europe",345304,0,345304,266718,444530,"ITA",355624
1,36.0,"Northern America",760982,758073,2909,469140,781900,"CAN",625520
1,36.0,"Southern Asia",385108,0,385108,238439,397398,"IRN",317919
1,36.0,"South America",1646688,1305920,340768,1217311,2028852,"BRA",1623082
1,36.0,"Central Asia",1259021,1108154,150867,837580,1395967,"UZB",1116774
1,36.0,"South-Eastern Asia",537003,0,537003,460368,767280,"IDN",613824
1,36.0,"Pakistan",1547142,1265002,282140,1143795,1906326,"PAK",1525061
1,36.0,"Southern Africa",106996,0,106996,54255,90425,"ZAF",72340
1,36.0,"Northern Europe",1573153,1573153,0,1214830,2024717,"GBR",1619774
1,36.0,"Oceania",376988,376988,0,241125,401876,"NZL",321501
1,36.0,"Central America",367380,0,367380,262271,437118,"MEX",349695
1,36.0,"Eastern Africa",120198,0,120198,123050,205083,"ETH",164067
1,36.0,"China",9600171,8784218,815953,6843204,11405340,"CPR",9124272
1,36.0,"Eastern Europe",3709264,3112157,597107,2812445,4687408,"POL",3749927
1,36.0,"India",5046380,4859335,187045,3637043,6061738,"IND",4849391
1,36.0,"Middle Africa",46216,0,46216,37414,62357,"AGO",49886
1,36.0,"Western Asia",189437,0,189437,563,938,"IRQ",751
1,36.0,"United States of America",2745216,2745216,0,2125222,3542037,"USA",2833630
1,36.0,"Western Europe",2817356,2817356,0,2237714,3729523,"NLD",2983619
1,36.0,"Russian Federation",4114673,3463231,651442,2215581,3692636,"RUS",2954109
1,36.0,"Northern Africa",1057252,0,1057252,889674,1482791,"EGY",1186233
1,36.0,"Eastern Asia",931060,0,931060,755292,1258820,"JPN",1007056
1,36.0,"Western Africa",209322,0,209322,121468,202447,"NGA",161958
1,36.0,"Southern Europe",344452,0,344452,231532,385887,"ITA",308710
1,37.0,"Northern America",751228,750180,1048,469140,781900,"CAN",625520
1,37.0,"Southern Asia",385051,0,385051,238439,397398,"IRN",317919
1,37.0,"South America",1639389,1303365,336024,1217311,2028852,"BRA",1623082
1,37.0,"Central Asia",1256109,1107700,148409,837580,1395967,"UZB",1116774
1,37.0,"South-Eastern Asia",537004,0,537004,460368,767280,"IDN",613824
1,37.0,"Pakistan",1543952,1263581,280371,1143795,1906326,"PAK",1525061
1,37.0,"Southern Africa",106988,0,106988,54255,90425,"ZAF",72340
1,37.0,"Northern Europe",1560999,1560999,0,1214830,2024717,"GBR",1619774
1,37.0,"Oceania",380885,380885,0,241125,401876,"NZL",321501
1,37.0,"Central America",367330,0,367330,262271,437118,"MEX",349695
1,37.0,"Eastern Africa",120185,0,120185,123050,205083,"ETH",164067
1,37.0,"China",9600196,8775618,824578,6843204,11405340,"CPR",9124272
1,37.0,"Eastern Europe",3726464,3114727,611737,2812445,4687408,"POL",3749927
1,37.0,"India",5056438,4862169,194269,3637043,6061738,"IND",4849391
1,37.0,"Middle Africa",46215,0,46215,37414,62357,"AGO",49886
1,37.0,"Western Asia",189415,0,189415,563,938,"IRQ",751
1,37.0,"United States of America",2752334,2752334,0,2125222,3542037,"USA",2833630
1,37.0,"Western Europe",2824700,2824157,543,2237714,3729523,"NLD",2983619
1,37.0,"Russian Federation",4106254,3468078,638176,2215581,3692636,"RUS",2954109
1,37.0,"Northern Africa",1057090,0,1057090,889674,1482791,"EGY",1186233
1,37.0,"Eastern Asia",931427,0,931427,755292,1258820,"JPN",1007056
1,37.0,"Western Africa",209293,0,209293,121468,202447,"NGA",161958
1,37.0,"Southern Europe",343978,0,343978,231532,385887,"ITA",308710
1,38.0,"Northern America",689911,689911,0,469140,781900,"CAN",625520
1,38.0,"Southern Asia",326243,0,326243,238439,397398,"IRN",317919
1,38.0,"South America",1641159,1305058,336101,1217311,2028852,"BRA",1623082
1,38.0,"Central Asia",1241268,1106427,134841,837580,1395967,"UZB",1116774
1,38.0,"South-Eastern Asia",625255,0,625255,460368,767280,"IDN",613824
1,38.0,"Pakistan",1544119,1263745,280374,1143795,1906326,"PAK",1525061
1,38.0,"Southern Africa",74653,0,74653,54255,90425,"ZAF",72340
1,38.0,"Northern Europe",1567065,1567065,0,1214830,2024717,"GBR",1619774
1,38.0,"Oceania",344880,344880,0,241125,401876,"NZL",321501
1,38.0,"Central America",357634,0,357634,262271,437118,"MEX",349695
1,38.0,"Eastern Africa",166661,0,166661,123050,205083,"ETH",164067
1,38.0,"China",9606952,8771550,835402,6843204,11405340,"CPR",9124272
1,38.0,"Eastern Europe",3756915,3131488,625427,2812445,4687408,"POL",3749927
1,38.0,"India",5032734,4857723,175011,3637043,6061738,"IND",4849391
1,38.0,"Middle Africa",50878,0,50878,37414,62357,"AGO",49886
1,38.0,"Western Asia",6020,0,6020,563,938,"IRQ",751
1,38.0,"United States of America",2847854,2847854,0,2125222,3542037,"USA",2833630
1,38.0,"Western Europe",2924923,2923816,1107,2237714,3729523,"NLD",2983619
1,38.0,"Russian Federation",3953476,3471264,482212,2215581,3692636,"RUS",2954109
1,38.0,"Northern Africa",1209073,0,1209073,889674,1482791,"EGY",1186233
1,38.0,"Eastern Asia",1027113,0,1027113,755292,1258820,"JPN",1007056
1,38.0,"Western Africa",166482,0,166482,121468,202447,"NGA",161958
1,38.0,"Southern Europe",315349,0,315349,231532,385887,"ITA",308710
1,39.0,"Northern America",670398,670398,0,469140,781900,"CAN",625520
1,39.0,"Southern Asia",329367,0,329367,238439,397398,"IRN",317919
1,39.0,"South America",1645947,1303737,342210,1217311,2028852,"BRA",1623082
1,39.0,"Central Asia",1232486,1106669,125817,837580,1395967,"UZB",1116774
1,39.0,"South-Eastern Asia",629982,0,629982,460368,767280,"IDN",613824
1,39.0,"Pakistan",1549687,1263822,285865,1143795,1906326,"PAK",1525061
1,39.0,"Southern Africa",75524,0,75524,54255,90425,"ZAF",72340
1,39.0,"Northern Europe",1603555,1598608,4947,1214830,2024717,"GBR",1619774
1,39.0,"Oceania",338061,338061,0,241125,401876,"NZL",321501
1,39.0,"Central America",360616,0,360616,262271,437118,"MEX",349695
1,39.0,"Eastern Africa",167643,0,167643,123050,205083,"ETH",164067
1,39.0,"China",9636375,8783886,852489,6843204,11405340,"CPR",9124272
1,39.0,"Eastern Europe",3788651,3138652,649999,2812445,4687408,"POL",3749927
1,39.0,"India",5024305,4850999,173306,3637043,6061738,"IND",4849391
1,39.0,"Middle Africa",51265,0,51265,37414,62357,"AGO",49886
1,39.0,"Western Asia",5797,0,5797,563,938,"IRQ",751
1,39.0,"United States of America",2911862,2906403,5459,2125222,3542037,"USA",2833630
1,39.0,"Western Europe",2990955,2981907,9048,2237714,3729523,"NLD",2983619
1,39.0,"Russian Federation",3738293,3377499,360794,2215581,3692636,"RUS",2954109
1,39.0,"Northern Africa",1217655,0,1217655,889674,1482791,"EGY",1186233
1,39.0,"Eastern Asia",1035133,0,1035133,755292,1258820,"JPN",1007056
1,39.0,"Western Africa",168100,0,168100,121468,202447,"NGA",161958
1,39.0,"Southern Europe",317567,0,317567,231532,385887,"ITA",308710
1,40.0,"Northern America",664546,662744,1802,469140,781900,"CAN",625520
1,40.0,"Southern Asia",332155,0,332155,238439,397398,"IRN",317919
1,40.0,"South America",1656836,1303560,353276,1217311,2028852,"BRA",1623082
1,40.0,"Central Asia",1224499,1106401,118098,837580,1395967,"UZB",1116774
1,40.0,"South-Eastern Asia",633603,0,633603,460368,767280,"IDN",613824
1,40.0,"Pakistan",1555003,1262467,292536,1143795,1906326,"PAK",1525061
1,40.0,"Southern Africa",76297,0,76297,54255,90425,"ZAF",72340
1,40.0,"Northern Europe",1644100,1634241,9859,1214830,2024717,"GBR",1619774
1,40.0,"Oceania",337087,336150,937,241125,401876,"NZL",321501
1,40.0,"Central America",363277,0,363277,262271,437118,"MEX",349695
1,40.0,"Eastern Africa",168513,0,168513,123050,205083,"ETH",164067
1,40.0,"China",9642983,8769996,872987,6843204,11405340,"CPR",9124272
1,40.0,"Eastern Europe",3801243,3138308,662935,2812445,4687408,"POL",3749927
1,40.0,"India",5173237,4997915,175322,3637043,6061738,"IND",4849391
1,40.0,"Middle Africa",51595,0,51595,37414,62357,"AGO",49886
1,40.0,"Western Asia",7109,0,7109,563,938,"IRQ",751
1,40.0,"United States of America",2940312,2926577,13735,2125222,3542037,"USA",2833630
1,40.0,"Western Europe",3042315,3024341,17974,2237714,3729523,"NLD",2983619
1,40.0,"Russian Federation",3119687,2841553,278134,2215581,3692636,"RUS",2954109
1,40.0,"Northern Africa",1225316,0,1225316,889674,1482791,"EGY",1186233
1,40.0,"Eastern Asia",1041437,0,1041437,755292,1258820,"JPN",1007056
1,40.0,"Western Africa",169699,0,169699,121468,202447,"NGA",161958
1,40.0,"Southern Europe",321036,0,321036,231532,385887,"ITA",308710
1,41.0,"Northern America",656741,653194,3547,469140,781900,"CAN",625520
1,41.0,"Southern Asia",332551,0,332551,238439,397398,"IRN",317919
1,41.0,"South America",1666104,1304587,361517,1217311,2028852,"BRA",1623082
1,41.0,"Central Asia",1218981,1107683,111298,837580,1395967,"UZB",1116774
1,41.0,"South-Eastern Asia",633932,0,633932,460368,767280,"IDN",613824
1,41.0,"Pakistan",1561615,1263043,298572,1143795,1906326,"PAK",1525061
1,41.0,"Southern Africa",76406,0,76406,54255,90425,"ZAF",72340
1,41.0,"Northern Europe",1676538,1661940,14598,1214830,2024717,"GBR",1619774
1,41.0,"Oceania",338063,336213,1850,241125,401876,"NZL",321501
1,41.0,"Central America",363651,0,363651,262271,437118,"MEX",349695
1,41.0,"Eastern Africa",168637,0,168637,123050,205083,"ETH",164067
1,41.0,"China",9665463,8772758,892705,6843204,11405340,"CPR",9124272
1,41.0,"Eastern Europe",3817943,3143523,674420,2812445,4687408,"POL",3749927
1,41.0,"India",5161310,4989327,171983,3637043,6061738,"IND",4849391
1,41.0,"Middle Africa",51644,0,51644,37414,62357,"AGO",49886
1,41.0,"Western Asia",8098,0,8098,563,938,"IRQ",751
1,41.0,"United States of America",2940310,2918571,21739,2125222,3542037,"USA",2833630
1,41.0,"Western Europe",3071662,3045032,26630,2237714,3729523,"NLD",2983619
1,41.0,"Russian Federation",2959437,2692163,267274,2215581,3692636,"RUS",2954109
1,41.0,"Northern Africa",1226392,0,1226392,889674,1482791,"EGY",1186233
1,41.0,"Eastern Asia",1042022,0,1042022,755292,1258820,"JPN",1007056
1,41.0,"Western Africa",169913,0,169913,121468,202447,"NGA",161958
1,41.0,"Southern Europe",321765,0,321765,231532,385887,"ITA",308710
1,42.0,"Northern America",652838,647575,5263,469140,781900,"CAN",625520
1,42.0,"Southern Asia",332633,0,332633,238439,397398,"IRN",317919
1,42.0,"South America",1672091,1304877,367214,1217311,2028852,"BRA",1623082
1,42.0,"Central Asia",1213547,1108328,105219,837580,1395967,"UZB",1116774
1,42.0,"South-Eastern Asia",633937,0,633937,460368,767280,"IDN",613824
1,42.0,"Pakistan",1713120,1409614,303506,1143795,1906326,"PAK",1525061
1,42.0,"Southern Africa",76433,0,76433,54255,90425,"ZAF",72340
1,42.0,"Northern Europe",1692757,1673675,19082,1214830,2024717,"GBR",1619774
1,42.0,"Oceania",339036,336305,2731,241125,401876,"NZL",321501
1,42.0,"Central America",363733,0,363733,262271,437118,"MEX",349695
1,42.0,"Eastern Africa",168661,0,168661,123050,205083,"ETH",164067
1,42.0,"China",9665480,8782347,883133,6843204,11405340,"CPR",9124272
1,42.0,"Eastern Europe",3882860,3188339,694521,2812445,4687408,"POL",3749927
1,42.0,"India",5161414,4992223,169191,3637043,6061738,"IND",4849391
1,42.0,"Middle Africa",51654,0,51654,37414,62357,"AGO",49886
1,42.0,"Western Asia",8251,0,8251,563,938,"IRQ",751
1,42.0,"United States of America",2933199,2903650,29549,2125222,3542037,"USA",2833630
1,42.0,"Western Europe",3093673,3058683,34990,2237714,3729523,"NLD",2983619
1,42.0,"Russian Federation",2952695,2679166,273529,2215581,3692636,"RUS",2954109
1,42.0,"Northern Africa",1226629,0,1226629,889674,1482791,"EGY",1186233
1,42.0,"Eastern Asia",1042293,0,1042293,755292,1258820,"JPN",1007056
1,42.0,"Western Africa",169959,0,169959,121468,202447,"NGA",161958
1,42.0,"Southern Europe",321841,0,321841,231532,385887,"ITA",308710
1,43.0,"Northern America",652839,645890,6949,469140,781900,"CAN",625520
1,43.0,"Southern Asia",334169,0,334169,238439,397398,"IRN",317919
1,43.0,"South America",1675935,1303787,372148,1217311,2028852,"BRA",1623082
1,43.0,"Central Asia",1147469,1050541,96928,837580,1395967,"UZB",1116774
1,43.0,"South-Eastern Asia",636010,0,636010,460368,767280,"IDN",613824
1,43.0,"Pakistan",1692222,1409301,282921,1143795,1906326,"PAK",1525061
1,43.0,"Southern Africa",76857,0,76857,54255,90425,"ZAF",72340
1,43.0,"Northern Europe",1700865,1677529,23336,1214830,2024717,"GBR",1619774
1,43.0,"Oceania",340010,336434,3576,241125,401876,"NZL",321501
1,43.0,"Central America",365196,0,365196,262271,437118,"MEX",349695
1,43.0,"Eastern Africa",169140,0,169140,123050,205083,"ETH",164067
1,43.0,"China",9647369,8770002,877367,6843204,11405340,"CPR",9124272
1,43.0,"Eastern Europe",3917727,3210967,706760,2812445,4687408,"POL",3749927
1,43.0,"India",5162308,4995018,167290,3637043,6061738,"IND",4849391
1,43.0,"Middle Africa",51839,0,51839,37414,62357,"AGO",49886
1,43.0,"Western Asia",8571,0,8571,563,938,"IRQ",751
1,43.0,"United States of America",2940311,2903091,37220,2125222,3542037,"USA",2833630
1,43.0,"Western Europe",3123020,3080006,43014,2237714,3729523,"NLD",2983619
1,43.0,"Russian Federation",2961864,2680580,281284,2215581,3692636,"RUS",2954109
1,43.0,"Northern Africa",1230835,0,1230835,889674,1482791,"EGY",1186233
1,43.0,"Eastern Asia",1046336,0,1046336,755292,1258820,"JPN",1007056
1,43.0,"Western Africa",170792,0,170792,121468,202447,"NGA",161958
1,43.0,"Southern Europe",323208,0,323208,231532,385887,"ITA",308710
1,44.0,"Northern America",654789,646349,8440,469140,781900,"CAN",625520
1,44.0,"Southern Asia",336148,0,336148,238439,397398,"IRN",317919
1,44.0,"South America",1681033,1303024,378009,1217311,2028852,"BRA",1623082
1,44.0,"Central Asia",1127617,1032070,95547,837580,1395967,"UZB",1116774
1,44.0,"South-Eastern Asia",637911,0,637911,460368,767280,"IDN",613824
1,44.0,"Pakistan",1677974,1410428,267546,1143795,1906326,"PAK",1525061
1,44.0,"Southern Africa",77406,0,77406,54255,90425,"ZAF",72340
1,44.0,"Northern Europe",1818447,1791064,27383,1214830,2024717,"GBR",1619774
1,44.0,"Oceania",340010,335630,4380,241125,401876,"NZL",321501
1,44.0,"Central America",367082,0,367082,262271,437118,"MEX",349695
1,44.0,"Eastern Africa",169758,0,169758,123050,205083,"ETH",164067
1,44.0,"China",9672735,8775705,897030,6843204,11405340,"CPR",9124272
1,44.0,"Eastern Europe",4660768,3942429,718339,2812445,4687408,"POL",3749927
1,44.0,"India",5163496,4996953,166543,3637043,6061738,"IND",4849391
1,44.0,"Middle Africa",52077,0,52077,37414,62357,"AGO",49886
1,44.0,"Western Asia",9537,0,9537,563,938,"IRQ",751
1,44.0,"United States of America",2947423,2902795,44628,2125222,3542037,"USA",2833630
1,44.0,"Western Europe",3145031,3094484,50547,2237714,3729523,"NLD",2983619
1,44.0,"Russian Federation",2990653,2700110,290543,2215581,3692636,"RUS",2954109
1,44.0,"Northern Africa",1236271,0,1236271,889674,1482791,"EGY",1186233
1,44.0,"Eastern Asia",1051122,0,1051122,755292,1258820,"JPN",1007056
1,44.0,"Western Africa",171870,0,171870,121468,202447,"NGA",161958
1,44.0,"Southern Europe",324977,0,324977,231532,385887,"ITA",308710
1,45.0,"Northern America",678205,671839,6366,469140,781900,"CAN",625520
1,45.0,"Southern Asia",330343,0,330343,238439,397398,"IRN",317919
1,45.0,"South America",1687158,1305708,381450,1217311,2028852,"BRA",1623082
1,45.0,"Central Asia",1113853,1017433,96420,837580,1395967,"UZB",1116774
1,45.0,"South-Eastern Asia",630975,0,630975,460368,767280,"IDN",613824
1,45.0,"Pakistan",1660871,1410671,250200,1143795,1906326,"PAK",1525061
1,45.0,"Southern Africa",75795,0,75795,54255,90425,"ZAF",72340
1,45.0,"Northern Europe",1814392,1784494,29898,1214830,2024717,"GBR",1619774
1,45.0,"Oceania",340011,336720,3291,241125,401876,"NZL",321501
1,45.0,"Central America",361547,0,361547,262271,437118,"MEX",349695
1,45.0,"Eastern Africa",167948,0,167948,123050,205083,"ETH",164067
1,45.0,"China",9594113,8695244,898869,6843204,11405340,"CPR",9124272
1,45.0,"Eastern Europe",4141544,3548982,592562,2812445,4687408,"POL",3749927
1,45.0,"India",5160015,4997744,162271,3637043,6061738,"IND",4849391
1,45.0,"Middle Africa",51380,0,51380,37414,62357,"AGO",49886
1,45.0,"Western Asia",9075,0,9075,563,938,"IRQ",751
1,45.0,"United States of America",2826520,2774779,51741,2125222,3542037,"USA",2833630
1,45.0,"Western Europe",3101010,3043444,57566,2237714,3729523,"NLD",2983619
1,45.0,"Russian Federation",2660370,2365922,294448,2215581,3692636,"RUS",2954109
1,45.0,"Northern Africa",1220336,0,1220336,889674,1482791,"EGY",1186233
1,45.0,"Eastern Asia",1037091,0,1037091,755292,1258820,"JPN",1007056
1,45.0,"Western Africa",168714,0,168714,121468,202447,"NGA",161958
1,45.0,"Southern Europe",319796,0,319796,231532,385887,"ITA",308710
1,46.0,"Northern America",625521,621283,4238,469140,781900,"CAN",625520
1,46.0,"Southern Asia",328436,0,328436,238439,397398,"IRN",317919
1,46.0,"South America",1685559,1305332,380227,1217311,2028852,"BRA",1623082
1,46.0,"Central Asia",950691,854603,96088,837580,1395967,"UZB",1116774
1,46.0,"South-Eastern Asia",628482,0,628482,460368,767280,"IDN",613824
1,46.0,"Pakistan",1545812,1315719,230093,1143795,1906326,"PAK",1525061
1,46.0,"Southern Africa",75264,0,75264,54255,90425,"ZAF",72340
1,46.0,"Northern Europe",1798176,1770574,27602,1214830,2024717,"GBR",1619774
1,46.0,"Oceania",335139,332900,2239,241125,401876,"NZL",321501
1,46.0,"Central America",359727,0,359727,262271,437118,"MEX",349695
1,46.0,"Eastern Africa",167351,0,167351,123050,205083,"ETH",164067
1,46.0,"China",9567649,8683511,884138,6843204,11405340,"CPR",9124272
1,46.0,"Eastern Europe",3765661,3229884,535777,2812445,4687408,"POL",3749927
1,46.0,"India",5146748,4993713,153035,3637043,6061738,"IND",4849391
1,46.0,"Middle Africa",51152,0,51152,37414,62357,"AGO",49886
1,46.0,"Western Asia",7499,0,7499,563,938,"IRQ",751
1,46.0,"United States of America",2897636,2845810,51826,2125222,3542037,"USA",2833630
1,46.0,"Western Europe",3115685,3050791,64894,2237714,3729523,"NLD",2983619
1,46.0,"Russian Federation",2755445,2401830,353615,2215581,3692636,"RUS",2954109
1,46.0,"Northern Africa",1215098,0,1215098,889674,1482791,"EGY",1186233
1,46.0,"Eastern Asia",1032477,0,1032477,755292,1258820,"JPN",1007056
1,46.0,"Western Africa",167746,0,167746,121468,202447,"NGA",161958
1,46.0,"Southern Europe",318094,0,318094,231532,385887,"ITA",308710
1,47.0,"Northern America",621618,619256,2362,469145,781908,"CAN",625527
1,47.0,"Southern Asia",325681,0,325681,238444,397407,"IRN",317926
1,47.0,"South America",1679595,1305284,374311,1217319,2028865,"BRA",1623092
1,47.0,"Central Asia",969791,856665,113126,837586,1395977,"UZB",1116782
1,47.0,"South-Eastern Asia",624641,0,624641,460374,767291,"IDN",613833
1,47.0,"Pakistan",1524754,1296804,227950,1143799,1906332,"PAK",1525066
1,47.0,"Southern Africa",74501,0,74501,54260,90433,"ZAF",72347
1,47.0,"Northern Europe",1611667,1590658,21009,1214838,2024730,"GBR",1619784
1,47.0,"Oceania",322476,321238,1238,241133,401888,"NZL",321511
1,47.0,"Central America",357100,0,357100,262277,437128,"MEX",349703
1,47.0,"Eastern Africa",166493,0,166493,123055,205092,"ETH",164074
1,47.0,"China",9560602,8695896,864706,6843211,11405352,"CPR",9124282
1,47.0,"Eastern Europe",3745320,3211608,533712,2812449,4687415,"POL",3749932
1,47.0,"India",4999571,4865800,133771,3637047,6061746,"IND",4849397
1,47.0,"Middle Africa",50819,0,50819,37418,62363,"AGO",49891
1,47.0,"Western Asia",5053,0,5053,563,938,"IRQ",751
1,47.0,"United States of America",2911864,2860817,51047,2125227,3542045,"USA",2833636
1,47.0,"Western Europe",3093675,3030605,63070,2237722,3729537,"NLD",2983630
1,47.0,"Russian Federation",2846900,2451292,395608,2215590,3692650,"RUS",2954120
1,47.0,"Northern Africa",1207534,0,1207534,889679,1482798,"EGY",1186239
1,47.0,"Eastern Asia",1025816,0,1025816,755300,1258833,"JPN",1007067
1,47.0,"Western Africa",166181,0,166181,121476,202460,"NGA",161968
1,47.0,"Southern Europe",315635,0,315635,231537,385896,"ITA",308717
1,48.0,"Northern America",631373,630885,488,526854,878090,"CAN",702472
1,48.0,"Southern Asia",325301,0,325301,382002,636670,"IRN",509336
1,48.0,"South America",1672697,1303390,369307,1434723,2391206,"BRA",1912965
1,48.0,"Central Asia",1058872,923771,135101,903292,1505487,"UZB",1204390
1,48.0,"South-Eastern Asia",624108,0,624108,567500,945833,"IDN",756667
1,48.0,"Pakistan",1540224,1311098,229126,1249488,2082480,"PAK",1665984
1,48.0,"Southern Africa",74395,0,74395,70608,117681,"ZAF",94145
1,48.0,"Northern Europe",1631935,1615726,16209,1367225,2278708,"GBR",1822967
1,48.0,"Oceania",324425,324151,274,327156,545261,"NZL",436209
1,48.0,"Central America",356735,0,356735,224650,374417,"MEX",299534
1,48.0,"Eastern Africa",166372,0,166372,98163,163605,"ETH",130884
1,48.0,"China",9537704,8692785,844919,7715378,12858963,"CPR",10287171
1,48.0,"Eastern Europe",3785288,3251091,534197,2964260,4940433,"POL",3952347
1,48.0,"India",4890197,4771454,118743,4310892,7184821,"IND",5747857
1,48.0,"Middle Africa",50777,0,50777,35996,59993,"AGO",47995
1,48.0,"Western Asia",4121,0,4121,98724,164541,"IRQ",131633
1,48.0,"United States of America",2897639,2847545,50094,2212836,3688060,"USA",2950448
1,48.0,"Western Europe",3064326,3002776,61550,2709344,4515573,"NLD",3612459
1,48.0,"Russian Federation",2898154,2474133,424021,2348455,3914092,"RUS",3131274
1,48.0,"Northern Africa",1206488,0,1206488,1000237,1667062,"EGY",1333650
1,48.0,"Eastern Asia",1024894,0,1024894,564993,941656,"JPN",753325
1,48.0,"Western Africa",165971,0,165971,137121,228535,"NGA",182828
1,48.0,"Southern Europe",315294,0,315294,410381,683968,"ITA",547175
1,49.0,"Northern America",621624,621624,0,526854,878090,"CAN",702472
1,49.0,"Southern Asia",322926,0,322926,382002,636670,"IRN",509336
1,49.0,"South America",1438926,1075459,363467,1434723,2391206,"BRA",1912965
1,49.0,"Central Asia",1099425,952420,147005,903292,1505487,"UZB",1204390
1,49.0,"South-Eastern Asia",620799,0,620799,567500,945833,"IDN",756667
1,49.0,"Pakistan",1522622,1297166,225456,1249488,2082480,"PAK",1665984
1,49.0,"Southern Africa",73669,0,73669,70608,117681,"ZAF",94145
1,49.0,"Northern Europe",1611677,1600995,10682,1367225,2278708,"GBR",1822967
1,49.0,"Oceania",319562,319562,0,327156,545261,"NZL",436209
1,49.0,"Central America",354470,0,354470,224650,374417,"MEX",299534
1,49.0,"Eastern Africa",165636,0,165636,98163,163605,"ETH",130884
1,49.0,"China",9509700,8688631,821069,7715378,12858963,"CPR",10287171
1,49.0,"Eastern Europe",3741192,3216667,524525,2964260,4940433,"POL",3952347
1,49.0,"India",4828142,4724869,103273,4310892,7184821,"IND",5747857
1,49.0,"Middle Africa",50492,0,50492,35996,59993,"AGO",47995
1,49.0,"Western Asia",2967,0,2967,98724,164541,"IRQ",131633
1,49.0,"United States of America",2890534,2843234,47300,2212836,3688060,"USA",2950448
1,49.0,"Western Europe",3057001,2996565,60436,2709344,4515573,"NLD",3612459
1,49.0,"Russian Federation",2997755,2556839,440916,2348455,3914092,"RUS",3131274
1,49.0,"Northern Africa",1199955,0,1199955,1000237,1667062,"EGY",1333650
1,49.0,"Eastern Asia",1019148,0,1019148,564993,941656,"JPN",753325
1,49.0,"Western Africa",164686,0,164686,137121,228535,"NGA",182828
1,49.0,"Southern Europe",313179,0,313179,410381,683968,"ITA",547175
1,50.0,"Northern America",698570,698570,0,526854,878090,"CAN",702472
1,50.0,"Southern Asia",482385,0,482385,382002,636670,"IRN",509336
1,50.0,"South America",1514907,1075202,439705,1434723,2391206,"BRA",1912965
1,50.0,"Central Asia",1107717,956417,151300,903292,1505487,"UZB",1204390
1,50.0,"South-Eastern Asia",719103,0,719103,567500,945833,"IDN",756667
1,50.0,"Pakistan",1537875,1314593,223282,1249488,2082480,"PAK",1665984
1,50.0,"Southern Africa",86641,0,86641,70608,117681,"ZAF",94145
1,50.0,"Northern Europe",1713493,1707769,5724,1367225,2278708,"GBR",1822967
1,50.0,"Oceania",435235,435235,0,327156,545261,"NZL",436209
1,50.0,"Central America",273832,0,273832,224650,374417,"MEX",299534
1,50.0,"Eastern Africa",122413,0,122413,98163,163605,"ETH",130884
1,50.0,"China",9523509,8682608,840901,7715378,12858963,"CPR",10287171
1,50.0,"Eastern Europe",3903913,3400451,503462,2964260,4940433,"POL",3952347
1,50.0,"India",5007484,4908993,98491,4310892,7184821,"IND",5747857
1,50.0,"Middle Africa",44768,0,44768,35996,59993,"AGO",47995
1,50.0,"Western Asia",114589,0,114589,98724,164541,"IRQ",131633
1,50.0,"United States of America",2779760,2736576,43184,2212836,3688060,"USA",2950448
1,50.0,"Western Europe",3128224,3060108,68116,2709344,4515573,"NLD",3612459
1,50.0,"Russian Federation",3087558,2653244,434314,2348455,3914092,"RUS",3131274
1,50.0,"Northern Africa",1259666,0,1259666,1000237,1667062,"EGY",1333650
1,50.0,"Eastern Asia",688177,0,688177,564993,941656,"JPN",753325
1,50.0,"Western Africa",168179,0,168179,137121,228535,"NGA",182828
1,50.0,"Southern Europe",523123,0,523123,410381,683968,"ITA",547175
1,51.0,"Northern America",657593,657593,0,526854,878090,"CAN",702472
1,51.0,"Southern Asia",483336,0,483336,382002,636670,"IRN",509336
1,51.0,"South America",1582006,1074080,507926,1434723,2391206,"BRA",1912965
1,51.0,"Central Asia",1110867,955633,155234,903292,1505487,"UZB",1204390
1,51.0,"South-Eastern Asia",720430,0,720430,567500,945833,"IDN",756667
1,51.0,"Pakistan",1529145,1304823,224322,1249488,2082480,"PAK",1665984
1,51.0,"Southern Africa",86912,0,86912,70608,117681,"ZAF",94145
1,51.0,"Northern Europe",1717549,1707077,10472,1367225,2278708,"GBR",1822967
1,51.0,"Oceania",436209,436209,0,327156,545261,"NZL",436209
1,51.0,"Central America",274733,0,274733,224650,374417,"MEX",299534
1,51.0,"Eastern Africa",122761,0,122761,98163,163605,"ETH",130884
1,51.0,"China",9565151,8699550,865601,7715378,12858963,"CPR",10287171
1,51.0,"Eastern Europe",3913447,3453713,459734,2964260,4940433,"POL",3952347
1,51.0,"India",5009213,4901448,107765,4310892,7184821,"IND",5747857
1,51.0,"Middle Africa",44870,0,44870,35996,59993,"AGO",47995
1,51.0,"Western Asia",118840,0,118840,98724,164541,"IRQ",131633
1,51.0,"United States of America",2801096,2747556,53540,2212836,3688060,"USA",2950448
1,51.0,"Western Europe",3252951,3166238,86713,2709344,4515573,"NLD",3612459
1,51.0,"Russian Federation",3071002,2656089,414913,2348455,3914092,"RUS",3131274
1,51.0,"Northern Africa",1262279,0,1262279,1000237,1667062,"EGY",1333650
1,51.0,"Eastern Asia",690469,0,690469,564993,941656,"JPN",753325
1,51.0,"Western Africa",168695,0,168695,137121,228535,"NGA",182828
1,51.0,"Southern Europe",523975,0,523975,410381,683968,"ITA",547175
1,52.0,"Northern America",651740,651740,0,526854,878090,"CAN",702472
1,52.0,"Southern Asia",484028,0,484028,382002,636670,"IRN",509336
1,52.0,"South America",1638928,1075361,563567,1434723,2391206,"BRA",1912965
1,52.0,"Central Asia",1113916,954661,159255,903292,1505487,"UZB",1204390
1,52.0,"South-Eastern Asia",721396,0,721396,567500,945833,"IDN",756667
1,52.0,"Pakistan",1529682,1302343,227339,1249488,2082480,"PAK",1665984
1,52.0,"Southern Africa",87104,0,87104,70608,117681,"ZAF",94145
1,52.0,"Northern Europe",1721603,1704985,16618,1367225,2278708,"GBR",1822967
1,52.0,"Oceania",425494,425494,0,327156,545261,"NZL",436209
1,52.0,"Central America",275393,0,275393,224650,374417,"MEX",299534
1,52.0,"Eastern Africa",122982,0,122982,98163,163605,"ETH",130884
1,52.0,"China",9581725,8700435,881290,7715378,12858963,"CPR",10287171
1,52.0,"Eastern Europe",3890155,3474583,415572,2964260,4940433,"POL",3952347
1,52.0,"India",5468968,5334256,134712,4310892,7184821,"IND",5747857
1,52.0,"Middle Africa",44954,0,44954,35996,59993,"AGO",47995
1,52.0,"Western Asia",119179,0,119179,98724,164541,"IRQ",131633
1,52.0,"United States of America",2793983,2729413,64570,2212836,3688060,"USA",2950448
1,52.0,"Western Europe",3340993,3236962,104031,2709344,4515573,"NLD",3612459
1,52.0,"Russian Federation",3032432,2638498,393934,2348455,3914092,"RUS",3131274
1,52.0,"Northern Africa",1264179,0,1264179,1000237,1667062,"EGY",1333650
1,52.0,"Eastern Asia",692145,0,692145,564993,941656,"JPN",753325
1,52.0,"Western Africa",169073,0,169073,137121,228535,"NGA",182828
1,52.0,"Southern Europe",524590,0,524590,410381,683968,"ITA",547175
1,53.0,"Northern America",655641,653429,2212,526854,878090,"CAN",702472
1,53.0,"Southern Asia",485642,0,485642,382002,636670,"IRN",509336
1,53.0,"South America",1685450,1077464,607986,1434723,2391206,"BRA",1912965
1,53.0,"Central Asia",1120006,956375,163631,903292,1505487,"UZB",1204390
1,53.0,"South-Eastern Asia",723644,0,723644,567500,945833,"IDN",756667
1,53.0,"Pakistan",1530927,1299414,231513,1249488,2082480,"PAK",1665984
1,53.0,"Southern Africa",87553,0,87553,70608,117681,"ZAF",94145
1,53.0,"Northern Europe",1725658,1702705,22953,1367225,2278708,"GBR",1822967
1,53.0,"Oceania",414777,414777,0,327156,545261,"NZL",436209
1,53.0,"Central America",276930,0,276930,224650,374417,"MEX",299534
1,53.0,"Eastern Africa",123481,0,123481,98163,163605,"ETH",130884
1,53.0,"China",9581012,8686205,894807,7715378,12858963,"CPR",10287171
1,53.0,"Eastern Europe",3919302,3539882,379420,2964260,4940433,"POL",3952347
1,53.0,"India",5521817,5368847,152970,4310892,7184821,"IND",5747857
1,53.0,"Middle Africa",45151,0,45151,35996,59993,"AGO",47995
1,53.0,"Western Asia",119975,0,119975,98724,164541,"IRQ",131633
1,53.0,"United States of America",2801096,2725078,76018,2212836,3688060,"USA",2950448
1,53.0,"Western Europe",3399688,3279417,120271,2709344,4515573,"NLD",3612459
1,53.0,"Russian Federation",3013737,2636656,377081,2348455,3914092,"RUS",3131274
1,53.0,"Northern Africa",1268607,0,1268607,1000237,1667062,"EGY",1333650
1,53.0,"Eastern Asia",696041,0,696041,564993,941656,"JPN",753325
1,53.0,"Western Africa",169948,0,169948,137121,228535,"NGA",182828
1,53.0,"Southern Europe",526033,0,526033,410381,683968,"ITA",547175
1,54.0,"Northern America",655642,651133,4509,526854,878090,"CAN",702472
1,54.0,"Southern Asia",488369,0,488369,382002,636670,"IRN",509336
1,54.0,"South America",1720039,1075632,644407,1434723,2391206,"BRA",1912965
1,54.0,"Central Asia",1125435,955338,170097,903292,1505487,"UZB",1204390
1,54.0,"South-Eastern Asia",727445,0,727445,567500,945833,"IDN",756667
1,54.0,"Pakistan",1444697,1207105,237592,1249488,2082480,"PAK",1665984
1,54.0,"Southern Africa",88314,0,88314,70608,117681,"ZAF",94145
1,54.0,"Northern Europe",1729712,1700261,29451,1367225,2278708,"GBR",1822967
1,54.0,"Oceania",412829,412829,0,327156,545261,"NZL",436209
1,54.0,"Central America",279535,0,279535,224650,374417,"MEX",299534
1,54.0,"Eastern Africa",124334,0,124334,98163,163605,"ETH",130884
1,54.0,"China",9605565,8694545,911020,7715378,12858963,"CPR",10287171
1,54.0,"Eastern Europe",3761447,3409911,351536,2964260,4940433,"POL",3952347
1,54.0,"India",5534372,5363954,170418,4310892,7184821,"IND",5747857
1,54.0,"Middle Africa",45478,0,45478,35996,59993,"AGO",47995
1,54.0,"Western Asia",121317,0,121317,98724,164541,"IRQ",131633
1,54.0,"United States of America",2822430,2734794,87636,2212836,3688060,"USA",2950448
1,54.0,"Western Europe",3451047,3315322,135725,2709344,4515573,"NLD",3612459
1,54.0,"Russian Federation",2989215,2624868,364347,2348455,3914092,"RUS",3131274
1,54.0,"Northern Africa",1276096,0,1276096,1000237,1667062,"EGY",1333650
1,54.0,"Eastern Asia",703006,0,703006,564993,941656,"JPN",753325
1,54.0,"Western Africa",171431,0,171431,137121,228535,"NGA",182828
1,54.0,"Southern Europe",528463,0,528463,410381,683968,"ITA",547175
1,55.0,"Northern America",655641,648746,6895,526854,878090,"CAN",702472
1,55.0,"Southern Asia",488955,0,488955,382002,636670,"IRN",509336
1,55.0,"South America",1749738,1076007,673731,1434723,2391206,"BRA",1912965
1,55.0,"Central Asia",1131464,954921,176543,903292,1505487,"UZB",1204390
1,55.0,"South-Eastern Asia",728454,0,728454,567500,945833,"IDN",756667
1,55.0,"Pakistan",1514562,1256206,258356,1249488,2082480,"PAK",1665984
1,55.0,"Southern Africa",88578,0,88578,70608,117681,"ZAF",94145
1,55.0,"Northern Europe",1733767,1697677,36090,1367225,2278708,"GBR",1822967
1,55.0,"Oceania",412831,412831,0,327156,545261,"NZL",436209
1,55.0,"Central America",280092,0,280092,224650,374417,"MEX",299534
1,55.0,"Eastern Africa",124520,0,124520,98163,163605,"ETH",130884
1,55.0,"China",9627348,8702412,924936,7715378,12858963,"CPR",10287171
1,55.0,"Eastern Europe",3613987,3270381,343606,2964260,4940433,"POL",3952347
1,55.0,"India",5546647,5368317,178330,4310892,7184821,"IND",5747857
1,55.0,"Middle Africa",45549,0,45549,35996,59993,"AGO",47995
1,55.0,"Western Asia",121606,0,121606,98724,164541,"IRQ",131633
1,55.0,"United States of America",2815319,2716221,99098,2212836,3688060,"USA",2950448
1,55.0,"Western Europe",3480394,3330051,150343,2709344,4515573,"NLD",3612459
1,55.0,"Russian Federation",2970700,2616787,353913,2348455,3914092,"RUS",3131274
1,55.0,"Northern Africa",1277712,0,1277712,1000237,1667062,"EGY",1333650
1,55.0,"Eastern Asia",704730,0,704730,564993,941656,"JPN",753325
1,55.0,"Western Africa",171750,0,171750,137121,228535,"NGA",182828
1,55.0,"Southern Europe",528991,0,528991,410381,683968,"ITA",547175
1,56.0,"Northern America",659544,650178,9366,526854,878090,"CAN",702472
1,56.0,"Southern Asia",489919,0,489919,382002,636670,"IRN",509336
1,56.0,"South America",1773656,1075961,697695,1434723,2391206,"BRA",1912965
1,56.0,"Central Asia",1140265,957386,182879,903292,1505487,"UZB",1204390
1,56.0,"South-Eastern Asia",730004,0,730004,567500,945833,"IDN",756667
1,56.0,"Pakistan",1540545,1272212,268333,1249488,2082480,"PAK",1665984
1,56.0,"Southern Africa",88747,0,88747,70608,117681,"ZAF",94145
1,56.0,"Northern Europe",1741876,1699028,42848,1367225,2278708,"GBR",1822967
1,56.0,"Oceania",412830,412830,0,327156,545261,"NZL",436209
1,56.0,"Central America",280997,0,280997,224650,374417,"MEX",299534
1,56.0,"Eastern Africa",124819,0,124819,98163,163605,"ETH",130884
1,56.0,"China",9650577,8688070,962507,7715378,12858963,"CPR",10287171
1,56.0,"Eastern Europe",3660911,3307576,353335,2964260,4940433,"POL",3952347
1,56.0,"India",5561078,5363150,197928,4310892,7184821,"IND",5747857
1,56.0,"Middle Africa",45661,0,45661,35996,59993,"AGO",47995
1,56.0,"Western Asia",122080,0,122080,98724,164541,"IRQ",131633
1,56.0,"United States of America",2815319,2704368,110951,2212836,3688060,"USA",2950448
1,56.0,"Western Europe",3495067,3330570,164497,2709344,4515573,"NLD",3612459
1,56.0,"Russian Federation",2955799,2607263,348536,2348455,3914092,"RUS",3131274
1,56.0,"Northern Africa",1280352,0,1280352,1000237,1667062,"EGY",1333650
1,56.0,"Eastern Asia",706966,0,706966,564993,941656,"JPN",753325
1,56.0,"Western Africa",172273,0,172273,137121,228535,"NGA",182828
1,56.0,"Southern Europe",529849,0,529849,410381,683968,"ITA",547175
1,57.0,"Northern America",536615,524733,11882,526854,878090,"CAN",702472
1,57.0,"Southern Asia",486344,0,486344,382002,636670,"IRN",509336
1,57.0,"South America",1784522,1076785,707737,1434723,2391206,"BRA",1912965
1,57.0,"Central Asia",1141082,954780,186302,903292,1505487,"UZB",1204390
1,57.0,"South-Eastern Asia",725005,0,725005,567500,945833,"IDN",756667
1,57.0,"Pakistan",1547246,1275988,271258,1249488,2082480,"PAK",1665984
1,57.0,"Southern Africa",87754,0,87754,70608,117681,"ZAF",94145
1,57.0,"Northern Europe",1745930,1696292,49638,1367225,2278708,"GBR",1822967
1,57.0,"Oceania",413804,413804,0,327156,545261,"NZL",436209
1,57.0,"Central America",277797,0,277797,224650,374417,"MEX",299534
1,57.0,"Eastern Africa",123703,0,123703,98163,163605,"ETH",130884
1,57.0,"China",9423147,8446799,976348,7715378,12858963,"CPR",10287171
1,57.0,"Eastern Europe",3538707,3166864,371843,2964260,4940433,"POL",3952347
1,57.0,"India",5585867,5367999,217868,4310892,7184821,"IND",5747857
1,57.0,"Middle Africa",45235,0,45235,35996,59993,"AGO",47995
1,57.0,"Western Asia",120320,0,120320,98724,164541,"IRQ",131633
1,57.0,"United States of America",2843766,2720722,123044,2212836,3688060,"USA",2950448
1,57.0,"Western Europe",3744520,3566044,178476,2709344,4515573,"NLD",3612459
1,57.0,"Russian Federation",2718843,2394085,324758,2348455,3914092,"RUS",3131274
1,57.0,"Northern Africa",1270538,0,1270538,1000237,1667062,"EGY",1333650
1,57.0,"Eastern Asia",698290,0,698290,564993,941656,"JPN",753325
1,57.0,"Western Africa",170330,0,170330,137121,228535,"NGA",182828
1,57.0,"Southern Europe",526660,0,526660,410381,683968,"ITA",547175
1,58.0,"Northern America",618568,602719,15849,526854,878090,"CAN",702472
1,58.0,"Southern Asia",489532,0,489532,382002,636670,"IRN",509336
1,58.0,"South America",1799002,1075576,723426,1434723,2391206,"BRA",1912965
1,58.0,"Central Asia",1328606,1136767,191839,903292,1505487,"UZB",1204390
1,58.0,"South-Eastern Asia",729379,0,729379,567500,945833,"IDN",756667
1,58.0,"Pakistan",1562333,1281610,280723,1249488,2082480,"PAK",1665984
1,58.0,"Southern Africa",88638,0,88638,70608,117681,"ZAF",94145
1,58.0,"Northern Europe",1749985,1693485,56500,1367225,2278708,"GBR",1822967
1,58.0,"Oceania",403089,403089,0,327156,545261,"NZL",436209
1,58.0,"Central America",281459,0,281459,224650,374417,"MEX",299534
1,58.0,"Eastern Africa",124698,0,124698,98163,163605,"ETH",130884
1,58.0,"China",9479809,8454743,1025066,7715378,12858963,"CPR",10287171
1,58.0,"Eastern Europe",3456614,3059995,396619,2964260,4940433,"POL",3952347
1,58.0,"India",5597803,5361176,236627,4310892,7184821,"IND",5747857
1,58.0,"Middle Africa",45614,0,45614,35996,59993,"AGO",47995
1,58.0,"Western Asia",121889,0,121889,98724,164541,"IRQ",131633
1,58.0,"United States of America",2808207,2691639,116568,2212836,3688060,"USA",2950448
1,58.0,"Western Europe",3663819,3478256,185563,2709344,4515573,"NLD",3612459
1,58.0,"Russian Federation",2724166,2384323,339843,2348455,3914092,"RUS",3131274
1,58.0,"Northern Africa",1279287,0,1279287,1000237,1667062,"EGY",1333650
1,58.0,"Eastern Asia",705862,0,705862,564993,941656,"JPN",753325
1,58.0,"Western Africa",172064,0,172064,137121,228535,"NGA",182828
1,58.0,"Southern Europe",529502,0,529502,410381,683968,"ITA",547175
1,59.0,"Northern America",665397,646375,19022,526859,878098,"CAN",702479
1,59.0,"Southern Asia",490977,0,490977,382005,636675,"IRN",509340
1,59.0,"South America",1813459,1076099,737360,1434729,2391216,"BRA",1912973
1,59.0,"Central Asia",1313480,1138468,175012,903299,1505498,"UZB",1204399
1,59.0,"South-Eastern Asia",731578,0,731578,567506,945843,"IDN",756675
1,59.0,"Pakistan",1576068,1287123,288945,1249491,2082485,"PAK",1665988
1,59.0,"Southern Africa",89042,0,89042,70614,117690,"ZAF",94152
1,59.0,"Northern Europe",1729712,1677487,52225,1367229,2278716,"GBR",1822973
1,59.0,"Oceania",395296,395296,0,327159,545265,"NZL",436212
1,59.0,"Central America",285785,0,285785,224652,374420,"MEX",299536
1,59.0,"Eastern Africa",125151,0,125151,98168,163613,"ETH",130891
1,59.0,"China",9489295,8442129,1047166,7715379,12858966,"CPR",10287173
1,59.0,"Eastern Europe",3434699,3009178,425521,2964262,4940437,"POL",3952350
1,59.0,"India",5585326,5360847,224479,4310895,7184825,"IND",5747860
1,59.0,"Middle Africa",45790,0,45790,36001,60002,"AGO",48002
1,59.0,"Western Asia",122599,0,122599,98727,164545,"IRQ",131636
1,59.0,"United States of America",2793984,2683340,110644,2212839,3688066,"USA",2950453
1,59.0,"Western Europe",3605125,3410267,194858,2709348,4515581,"NLD",3612465
1,59.0,"Russian Federation",2748161,2393405,354756,2348459,3914098,"RUS",3131279
1,59.0,"Northern Africa",1283258,0,1283258,1000238,1667063,"EGY",1333651
1,59.0,"Eastern Asia",709694,0,709694,564996,941660,"JPN",753328
1,59.0,"Western Africa",172848,0,172848,137125,228542,"NGA",182834
1,59.0,"Southern Europe",530795,0,530795,410381,683968,"ITA",547175
1,60.0,"Northern America",669299,649807,19492,493494,822490,"CAN",657992
1,60.0,"Southern Asia",489991,0,489991,366769,611282,"IRN",489026
1,60.0,"South America",1822795,1075151,747644,1250766,2084610,"BRA",1667688
1,60.0,"Central Asia",1296212,1136838,159374,815854,1359757,"UZB",1087806
1,60.0,"South-Eastern Asia",730427,0,730427,483922,806537,"IDN",645230
1,60.0,"Pakistan",1588102,1293701,294401,1115619,1859365,"PAK",1487492
1,60.0,"Southern Africa",88769,0,88769,72313,120522,"ZAF",96418
1,60.0,"Northern Europe",1701331,1653209,48122,1279201,2132002,"GBR",1705602
1,60.0,"Oceania",399192,399192,0,247899,413166,"NZL",330533
1,60.0,"Central America",284828,0,284828,275250,458751,"MEX",367001
1,60.0,"Eastern Africa",124842,0,124842,103026,171710,"ETH",137368
1,60.0,"China",9557359,8454637,1102722,6752096,11253493,"CPR",9002795
1,60.0,"Eastern Europe",3478404,3014371,464033,2378127,3963546,"POL",3170837
1,60.0,"India",5549026,5340669,208357,3674156,6123593,"IND",4898875
1,60.0,"Middle Africa",45670,0,45670,29141,48568,"AGO",38855
1,60.0,"Western Asia",122115,0,122115,224647,374412,"IRQ",299530
1,60.0,"United States of America",2793984,2689229,104755,2076839,3461398,"USA",2769119
1,60.0,"Western Europe",3553764,3363836,189928,2377932,3963221,"NLD",3170577
1,60.0,"Russian Federation",2772694,2406189,366505,2267977,3779962,"RUS",3023970
1,60.0,"Northern Africa",1280545,0,1280545,743211,1238686,"EGY",990949
1,60.0,"Eastern Asia",707706,0,707706,516833,861388,"JPN",689111
1,60.0,"Western Africa",173204,0,173204,128415,214025,"NGA",171220
1,60.0,"Southern Europe",529911,0,529911,364859,608098,"ITA",486479
1,61.0,"Northern America",667355,647443,19912,493494,822490,"CAN",657992
1,61.0,"Southern Asia",473637,0,473637,366769,611282,"IRN",489026
1,61.0,"South America",2349204,1592508,756696,1250766,2084610,"BRA",1667688
1,61.0,"Central Asia",1231195,1095397,135798,815854,1359757,"UZB",1087806
1,61.0,"South-Eastern Asia",707723,0,707723,483922,806537,"IDN",645230
1,61.0,"Pakistan",1585160,1300190,284970,1115619,1859365,"PAK",1487492
1,61.0,"Southern Africa",84151,0,84151,72313,120522,"ZAF",96418
1,61.0,"Northern Europe",1689173,1644576,44597,1279201,2132002,"GBR",1705602
1,61.0,"Oceania",263793,263793,0,247899,413166,"NZL",330533
1,61.0,"Central America",283639,0,283639,275250,458751,"MEX",367001
1,61.0,"Eastern Africa",119833,0,119833,103026,171710,"ETH",137368
1,61.0,"China",9562659,8452273,1110386,6752096,11253493,"CPR",9002795
1,61.0,"Eastern Europe",3528056,3030127,497929,2378127,3963546,"POL",3170837
1,61.0,"India",5503080,5315326,187754,3674156,6123593,"IND",4898875
1,61.0,"Middle Africa",43714,0,43714,29141,48568,"AGO",38855
1,61.0,"Western Asia",114114,0,114114,224647,374412,"IRQ",299530
1,61.0,"United States of America",2793989,2694814,99175,2076839,3461398,"USA",2769119
1,61.0,"Western Europe",3524420,3339062,185358,2377932,3963221,"NLD",3170577
1,61.0,"Russian Federation",2800789,2419796,380993,2267977,3779962,"RUS",3023970
1,61.0,"Northern Africa",1241441,0,1241441,743211,1238686,"EGY",990949
1,61.0,"Eastern Asia",668302,0,668302,516833,861388,"JPN",689111
1,61.0,"Western Africa",173350,0,173350,128415,214025,"NGA",171220
1,61.0,"Southern Europe",529600,0,529600,364859,608098,"ITA",486479
1,62.0,"Northern America",675554,655760,19794,493494,822490,"CAN",657992
1,62.0,"Southern Asia",502711,0,502711,366769,611282,"IRN",489026
1,62.0,"South America",2215126,1592978,622148,1250766,2084610,"BRA",1667688
1,62.0,"Central Asia",1151396,1027808,123588,815854,1359757,"UZB",1087806
1,62.0,"South-Eastern Asia",664763,0,664763,483922,806537,"IDN",645230
1,62.0,"Pakistan",1583438,1304384,279054,1115619,1859365,"PAK",1487492
1,62.0,"Southern Africa",100296,0,100296,72313,120522,"ZAF",96418
1,62.0,"Northern Europe",1705601,1660790,44811,1279201,2132002,"GBR",1705602
1,62.0,"Oceania",326636,325563,1073,247899,413166,"NZL",330533
1,62.0,"Central America",375569,0,375569,275250,458751,"MEX",367001
1,62.0,"Eastern Africa",141635,0,141635,103026,171710,"ETH",137368
1,62.0,"China",9525407,8449877,1075530,6752096,11253493,"CPR",9002795
1,62.0,"Eastern Europe",3584423,3098910,485513,2378127,3963546,"POL",3170837
1,62.0,"India",5465093,5299553,165540,3674156,6123593,"IND",4898875
1,62.0,"Middle Africa",40503,0,40503,29141,48568,"AGO",38855
1,62.0,"Western Asia",306220,0,306220,224647,374412,"IRQ",299530
1,62.0,"United States of America",2833128,2742656,90472,2076839,3461398,"USA",2769119
1,62.0,"Western Europe",3427369,3257034,170335,2377932,3963221,"NLD",3170577
1,62.0,"Russian Federation",2845940,2429661,416279,2267977,3779962,"RUS",3023970
1,62.0,"Northern Africa",1046164,0,1046164,743211,1238686,"EGY",990949
1,62.0,"Eastern Asia",722001,0,722001,516833,861388,"JPN",689111
1,62.0,"Western Africa",179017,0,179017,128415,214025,"NGA",171220
1,62.0,"Southern Europe",500967,0,500967,364859,608098,"ITA",486479
1,63.0,"Northern America",687263,667691,19572,493494,822490,"CAN",657992
1,63.0,"Southern Asia",509862,0,509862,366769,611282,"IRN",489026
1,63.0,"South America",2111345,1593695,517650,1250766,2084610,"BRA",1667688
1,63.0,"Central Asia",1085576,966712,118864,815854,1359757,"UZB",1087806
1,63.0,"South-Eastern Asia",674324,0,674324,483922,806537,"IDN",645230
1,63.0,"Pakistan",1585757,1306852,278905,1115619,1859365,"PAK",1487492
1,63.0,"Southern Africa",102209,0,102209,72313,120522,"ZAF",96418
1,63.0,"Northern Europe",1717765,1672954,44811,1279201,2132002,"GBR",1705602
1,63.0,"Oceania",367548,365475,2073,247899,413166,"NZL",330533
1,63.0,"Central America",383385,0,383385,275250,458751,"MEX",367001
1,63.0,"Eastern Africa",143874,0,143874,103026,171710,"ETH",137368
1,63.0,"China",9524372,8459266,1065106,6752096,11253493,"CPR",9002795
1,63.0,"Eastern Europe",3611642,3152467,459175,2378127,3963546,"POL",3170837
1,63.0,"India",5430902,5286042,144860,3674156,6123593,"IND",4898875
1,63.0,"Middle Africa",41357,0,41357,29141,48568,"AGO",38855
1,63.0,"Western Asia",309783,0,309783,224647,374412,"IRQ",299530
1,63.0,"United States of America",2875800,2793333,82467,2076839,3461398,"USA",2769119
1,63.0,"Western Europe",3390686,3233964,156722,2377932,3963221,"NLD",3170577
1,63.0,"Russian Federation",2914982,2452074,462908,2267977,3779962,"RUS",3023970
1,63.0,"Northern Africa",1040439,0,1040439,743211,1238686,"EGY",990949
1,63.0,"Eastern Asia",739647,0,739647,516833,861388,"JPN",689111
1,63.0,"Western Africa",180731,0,180731,128415,214025,"NGA",171220
1,63.0,"Southern Europe",502023,0,502023,364859,608098,"ITA",486479
1,64.0,"Northern America",695067,675866,19201,493494,822490,"CAN",657992
1,64.0,"Southern Asia",512812,0,512812,366769,611282,"IRN",489026
1,64.0,"South America",2026720,1592500,434220,1250766,2084610,"BRA",1667688
1,64.0,"Central Asia",1082705,959795,122910,815854,1359757,"UZB",1087806
1,64.0,"South-Eastern Asia",678290,0,678290,483922,806537,"IDN",645230
1,64.0,"Pakistan",1587924,1307397,280527,1115619,1859365,"PAK",1487492
1,64.0,"Southern Africa",103027,0,103027,72313,120522,"ZAF",96418
1,64.0,"Northern Europe",1746149,1696398,49751,1279201,2132002,"GBR",1705602
1,64.0,"Oceania",387034,384098,2936,247899,413166,"NZL",330533
1,64.0,"Central America",384437,0,384437,275250,458751,"MEX",367001
1,64.0,"Eastern Africa",144795,0,144795,103026,171710,"ETH",137368
1,64.0,"China",9513330,8447672,1065658,6752096,11253493,"CPR",9002795
1,64.0,"Eastern Europe",3620085,3190439,429646,2378127,3963546,"POL",3170837
1,64.0,"India",5237683,5112875,124808,3674156,6123593,"IND",4898875
1,64.0,"Middle Africa",41713,0,41713,29141,48568,"AGO",38855
1,64.0,"Western Asia",311233,0,311233,224647,374412,"IRQ",299530
1,64.0,"United States of America",2897135,2824387,72748,2076839,3461398,"USA",2769119
1,64.0,"Western Europe",3346664,3204910,141754,2377932,3963221,"NLD",3170577
1,64.0,"Russian Federation",2985015,2475751,509264,2267977,3779962,"RUS",3023970
1,64.0,"Northern Africa",1042193,0,1042193,743211,1238686,"EGY",990949
1,64.0,"Eastern Asia",746578,0,746578,516833,861388,"JPN",689111
1,64.0,"Western Africa",181246,0,181246,128415,214025,"NGA",171220
1,64.0,"Southern Europe",502758,0,502758,364859,608098,"ITA",486479
1,65.0,"Northern America",700921,680265,20656,493494,822490,"CAN",657992
1,65.0,"Southern Asia",512303,0,512303,366769,611282,"IRN",489026
1,65.0,"South America",1955757,1585690,370067,1250766,2084610,"BRA",1667688
1,65.0,"Central Asia",1093831,964297,129534,815854,1359757,"UZB",1087806
1,65.0,"South-Eastern Asia",677370,0,677370,483922,806537,"IDN",645230
1,65.0,"Pakistan",1587399,1306146,281253,1115619,1859365,"PAK",1487492
1,65.0,"Southern Africa",102890,0,102890,72313,120522,"ZAF",96418
1,65.0,"Northern Europe",1778584,1724368,54216,1279201,2132002,"GBR",1705602
1,65.0,"Oceania",374370,370707,3663,247899,413166,"NZL",330533
1,65.0,"Central America",385197,0,385197,275250,458751,"MEX",367001
1,65.0,"Eastern Africa",144638,0,144638,103026,171710,"ETH",137368
1,65.0,"China",9513352,8446068,1067284,6752096,11253493,"CPR",9002795
1,65.0,"Eastern Europe",3612502,3212953,399549,2378127,3963546,"POL",3170837
1,65.0,"India",5173442,5065663,107779,3674156,6123593,"IND",4898875
1,65.0,"Middle Africa",41650,0,41650,29141,48568,"AGO",38855
1,65.0,"Western Asia",310983,0,310983,224647,374412,"IRQ",299530
1,65.0,"United States of America",2911360,2844418,66942,2076839,3461398,"USA",2769119
1,65.0,"Western Europe",3324652,3196482,128170,2377932,3963221,"NLD",3170577
1,65.0,"Russian Federation",3091433,2534630,556803,2267977,3779962,"RUS",3023970
1,65.0,"Northern Africa",1053180,0,1053180,743211,1238686,"EGY",990949
1,65.0,"Eastern Asia",744993,0,744993,516833,861388,"JPN",689111
1,65.0,"Western Africa",181768,0,181768,128415,214025,"NGA",171220
1,65.0,"Southern Europe",503598,0,503598,364859,608098,"ITA",486479
1,66.0,"Northern America",706776,684804,21972,493494,822490,"CAN",657992
1,66.0,"Southern Asia",512479,0,512479,366769,611282,"IRN",489026
1,66.0,"South America",1873668,1551425,322243,1250766,2084610,"BRA",1667688
1,66.0,"Central Asia",1113145,978350,134795,815854,1359757,"UZB",1087806
1,66.0,"South-Eastern Asia",677394,0,677394,483922,806537,"IDN",645230
1,66.0,"Pakistan",1675756,1393670,282086,1115619,1859365,"PAK",1487492
1,66.0,"Southern Africa",102938,0,102938,72313,120522,"ZAF",96418
1,66.0,"Northern Europe",1806968,1748918,58050,1279201,2132002,"GBR",1705602
1,66.0,"Oceania",363656,359262,4394,247899,413166,"NZL",330533
1,66.0,"Central America",386404,0,386404,275250,458751,"MEX",367001
1,66.0,"Eastern Africa",144691,0,144691,103026,171710,"ETH",137368
1,66.0,"China",9514036,8444445,1069591,6752096,11253493,"CPR",9002795
1,66.0,"Eastern Europe",3607844,3241735,366109,2378127,3963546,"POL",3170837
1,66.0,"India",5111171,5019676,91495,3674156,6123593,"IND",4898875
1,66.0,"Middle Africa",41672,0,41672,29141,48568,"AGO",38855
1,66.0,"Western Asia",311069,0,311069,224647,374412,"IRQ",299530
1,66.0,"United States of America",2925585,2860415,65170,2076839,3461398,"USA",2769119
1,66.0,"Western Europe",3317317,3198023,119294,2377932,3963221,"NLD",3170577
1,66.0,"Russian Federation",3172722,2580469,592253,2267977,3779962,"RUS",3023970
1,66.0,"Northern Africa",1055329,0,1055329,743211,1238686,"EGY",990949
1,66.0,"Eastern Asia",745038,0,745038,516833,861388,"JPN",689111
1,66.0,"Western Africa",182540,0,182540,128415,214025,"NGA",171220
1,66.0,"Southern Europe",504859,0,504859,364859,608098,"ITA",486479
1,67.0,"Northern America",708727,687503,21224,493494,822490,"CAN",657992
1,67.0,"Southern Asia",512830,0,512830,366769,611282,"IRN",489026
1,67.0,"South America",1757381,1465895,291486,1250766,2084610,"BRA",1667688
1,67.0,"Central Asia",1127466,989193,138273,815854,1359757,"UZB",1087806
1,67.0,"South-Eastern Asia",677735,0,677735,483922,806537,"IDN",645230
1,67.0,"Pakistan",1663483,1395305,268178,1115619,1859365,"PAK",1487492
1,67.0,"Southern Africa",103033,0,103033,72313,120522,"ZAF",96418
1,67.0,"Northern Europe",1827239,1766012,61227,1279201,2132002,"GBR",1705602
1,67.0,"Oceania",361706,357508,4198,247899,413166,"NZL",330533
1,67.0,"Central America",387124,0,387124,275250,458751,"MEX",367001
1,67.0,"Eastern Africa",144802,0,144802,103026,171710,"ETH",137368
1,67.0,"China",9517505,8442203,1075302,6752096,11253493,"CPR",9002795
1,67.0,"Eastern Europe",3622014,3287213,334801,2378127,3963546,"POL",3170837
1,67.0,"India",5098026,5019554,78472,3674156,6123593,"IND",4898875
1,67.0,"Middle Africa",41716,0,41716,29141,48568,"AGO",38855
1,67.0,"Western Asia",311243,0,311243,224647,374412,"IRQ",299530
1,67.0,"United States of America",2925585,2862366,63219,2076839,3461398,"USA",2769119
1,67.0,"Western Europe",3324654,3208607,116047,2377932,3963221,"NLD",3170577
1,67.0,"Russian Federation",3235028,2617633,617395,2267977,3779962,"RUS",3023970
1,67.0,"Northern Africa",1056287,0,1056287,743211,1238686,"EGY",990949
1,67.0,"Eastern Asia",745622,0,745622,516833,861388,"JPN",689111
1,67.0,"Western Africa",182889,0,182889,128415,214025,"NGA",171220
1,67.0,"Southern Europe",505418,0,505418,364859,608098,"ITA",486479
1,68.0,"Northern America",708727,688280,20447,493494,822490,"CAN",657992
1,68.0,"Southern Asia",513766,0,513766,366769,611282,"IRN",489026
1,68.0,"South America",1682886,1398227,284659,1250766,2084610,"BRA",1667688
1,68.0,"Central Asia",1150234,1009533,140701,815854,1359757,"UZB",1087806
1,68.0,"South-Eastern Asia",677920,0,677920,483922,806537,"IDN",645230
1,68.0,"Pakistan",1651385,1394497,256888,1115619,1859365,"PAK",1487492
1,68.0,"Southern Africa",103294,0,103294,72313,120522,"ZAF",96418
1,68.0,"Northern Europe",1977257,1918357,58900,1279201,2132002,"GBR",1705602
1,68.0,"Oceania",360732,356463,4269,247899,413166,"NZL",330533
1,68.0,"Central America",388354,0,388354,275250,458751,"MEX",367001
1,68.0,"Eastern Africa",145091,0,145091,103026,171710,"ETH",137368
1,68.0,"China",9545596,8458742,1086854,6752096,11253493,"CPR",9002795
1,68.0,"Eastern Europe",2764233,2464618,299615,2378127,3963546,"POL",3170837
1,68.0,"India",5109901,5023579,86322,3674156,6123593,"IND",4898875
1,68.0,"Middle Africa",41740,0,41740,29141,48568,"AGO",38855
1,68.0,"Western Asia",311702,0,311702,224647,374412,"IRQ",299530
1,68.0,"United States of America",2925584,2864316,61268,2076839,3461398,"USA",2769119
1,68.0,"Western Europe",3331990,3219354,112636,2377932,3963221,"NLD",3170577
1,68.0,"Russian Federation",3291737,2653823,637914,2267977,3779962,"RUS",3023970
1,68.0,"Northern Africa",1058856,0,1058856,743211,1238686,"EGY",990949
1,68.0,"Eastern Asia",745955,0,745955,516833,861388,"JPN",689111
1,68.0,"Western Africa",183477,0,183477,128415,214025,"NGA",171220
1,68.0,"Southern Europe",508498,0,508498,364859,608098,"ITA",486479
1,69.0,"Northern America",710677,690394,20283,493494,822490,"CAN",657992
1,69.0,"Southern Asia",509593,0,509593,366769,611282,"IRN",489026
1,69.0,"South America",1667291,1375138,292153,1250766,2084610,"BRA",1667688
1,69.0,"Central Asia",1160186,1020847,139339,815854,1359757,"UZB",1087806
1,69.0,"South-Eastern Asia",673460,0,673460,483922,806537,"IDN",645230
1,69.0,"Pakistan",1639059,1394257,244802,1115619,1859365,"PAK",1487492
1,69.0,"Southern Africa",102135,0,102135,72313,120522,"ZAF",96418
1,69.0,"Northern Europe",1961039,1906322,54717,1279201,2132002,"GBR",1705602
1,69.0,"Oceania",360733,355708,5025,247899,413166,"NZL",330533
1,69.0,"Central America",384997,0,384997,275250,458751,"MEX",367001
1,69.0,"Eastern Africa",143790,0,143790,103026,171710,"ETH",137368
1,69.0,"China",9822594,8729421,1093173,6752096,11253493,"CPR",9002795
1,69.0,"Eastern Europe",2872717,2511723,360994,2378127,3963546,"POL",3170837
1,69.0,"India",5086332,5014454,71878,3674156,6123593,"IND",4898875
1,69.0,"Middle Africa",41332,0,41332,29141,48568,"AGO",38855
1,69.0,"Western Asia",309648,0,309648,224647,374412,"IRQ",299530
1,69.0,"United States of America",2918473,2859155,59318,2076839,3461398,"USA",2769119
1,69.0,"Western Europe",3214600,3108895,105705,2377932,3963221,"NLD",3170577
1,69.0,"Russian Federation",3545869,2901725,644144,2267977,3779962,"RUS",3023970
1,69.0,"Northern Africa",1047403,0,1047403,743211,1238686,"EGY",990949
1,69.0,"Eastern Asia",738300,0,738300,516833,861388,"JPN",689111
1,69.0,"Western Africa",181944,0,181944,128415,214025,"NGA",171220
1,69.0,"Southern Europe",504829,0,504829,364859,608098,"ITA",486479
1,70.0,"Northern America",708727,689277,19450,493494,822490,"CAN",657992
1,70.0,"Southern Asia",509529,0,509529,366769,611282,"IRN",489026
1,70.0,"South America",1640342,1338071,302271,1250766,2084610,"BRA",1667688
1,70.0,"Central Asia",1118994,981872,137122,815854,1359757,"UZB",1087806
1,70.0,"South-Eastern Asia",673802,0,673802,483922,806537,"IDN",645230
1,70.0,"Pakistan",1629544,1394772,234772,1115619,1859365,"PAK",1487492
1,70.0,"Southern Africa",102117,0,102117,72313,120522,"ZAF",96418
1,70.0,"Northern Europe",1928602,1883228,45374,1279201,2132002,"GBR",1705602
1,70.0,"Oceania",360732,354998,5734,247899,413166,"NZL",330533
1,70.0,"Central America",386557,0,386557,275250,458751,"MEX",367001
1,70.0,"Eastern Africa",143768,0,143768,103026,171710,"ETH",137368
1,70.0,"China",9822428,8729315,1093113,6752096,11253493,"CPR",9002795
1,70.0,"Eastern Europe",2996440,2585683,410757,2378127,3963546,"POL",3170837
1,70.0,"India",5049965,4991714,58251,3674156,6123593,"IND",4898875
1,70.0,"Middle Africa",41321,0,41321,29141,48568,"AGO",38855
1,70.0,"Western Asia",309618,0,309618,224647,374412,"IRQ",299530
1,70.0,"United States of America",2911361,2853904,57457,2076839,3461398,"USA",2769119
1,70.0,"Western Europe",3236612,3131850,104762,2377932,3963221,"NLD",3170577
1,70.0,"Russian Federation",3511119,2899405,611714,2267977,3779962,"RUS",3023970
1,70.0,"Northern Africa",1047226,0,1047226,743211,1238686,"EGY",990949
1,70.0,"Eastern Asia",738672,0,738672,516833,861388,"JPN",689111
1,70.0,"Western Africa",182366,0,182366,128415,214025,"NGA",171220
1,70.0,"Southern Europe",504772,0,504772,364859,608098,"ITA",486479
1,71.0,"Northern America",706775,688127,18648,493497,822496,"CAN",657997
1,71.0,"Southern Asia",507537,0,507537,366772,611287,"IRN",489030
1,71.0,"South America",1663179,1344849,318330,1250768,2084613,"BRA",1667691
1,71.0,"Central Asia",1126085,987552,138533,815861,1359768,"UZB",1087815
1,71.0,"South-Eastern Asia",671025,0,671025,483925,806542,"IDN",645234
1,71.0,"Pakistan",1618540,1394301,224239,1115623,1859372,"PAK",1487498
1,71.0,"Southern Africa",101562,0,101562,72316,120527,"ZAF",96422
1,71.0,"Northern Europe",1738042,1701304,36738,1279209,2132016,"GBR",1705613
1,71.0,"Oceania",356835,350441,6394,247905,413175,"NZL",330540
1,71.0,"Central America",384655,0,384655,275253,458755,"MEX",367004
1,71.0,"Eastern Africa",143151,0,143151,103029,171716,"ETH",137373
1,71.0,"China",9795411,8734448,1060963,6752099,11253498,"CPR",9002799
1,71.0,"Eastern Europe",3150627,2695826,454801,2378129,3963548,"POL",3170839
1,71.0,"India",5049309,5002576,46733,3674164,6123607,"IND",4898886
1,71.0,"Middle Africa",41083,0,41083,29145,48575,"AGO",38860
1,71.0,"Western Asia",308637,0,308637,224652,374420,"IRQ",299536
1,71.0,"United States of America",2897137,2841453,55684,2076841,3461402,"USA",2769122
1,71.0,"Western Europe",3251285,3147938,103347,2377939,3963232,"NLD",3170586
1,71.0,"Russian Federation",3481555,2901276,580279,2267984,3779973,"RUS",3023979
1,71.0,"Northern Africa",1041751,0,1041751,743211,1238686,"EGY",990949
1,71.0,"Eastern Asia",733855,0,733855,516837,861396,"JPN",689117
1,71.0,"Western Africa",181282,0,181282,128416,214027,"NGA",171222
1,71.0,"Southern Europe",502995,0,502995,364861,608102,"ITA",486482
1,72.0,"Northern America",704823,686828,17995,445551,742586,"CAN",594069
1,72.0,"Southern Asia",507242,0,507242,491879,819798,"IRN",655839
1,72.0,"South America",1679696,1350119,329577,1241361,2068936,"BRA",1655149
1,72.0,"Central Asia",1129112,989742,139370,815586,1359310,"UZB",1087448
1,72.0,"South-Eastern Asia",670616,0,670616,483602,806003,"IDN",644803
1,72.0,"Pakistan",1564678,1352909,211769,1197997,1996662,"PAK",1597330
1,72.0,"Southern Africa",101483,0,101483,27311,45518,"ZAF",36415
1,72.0,"Northern Europe",1693440,1662258,31182,1354410,2257350,"GBR",1805880
1,72.0,"Oceania",353914,346861,7053,281041,468402,"NZL",374722
1,72.0,"Central America",384376,0,384376,258303,430505,"MEX",344404
1,72.0,"Eastern Africa",143057,0,143057,90013,150022,"ETH",120018
1,72.0,"China",9772740,8742057,1030683,6833422,11389037,"CPR",9111230
1,72.0,"Eastern Europe",3297534,2809328,488206,2457273,4095456,"POL",3276365
1,72.0,"India",5049260,5012843,36417,3944331,6573885,"IND",5259108
1,72.0,"Middle Africa",41046,0,41046,40604,67673,"AGO",54139
1,72.0,"Western Asia",308491,0,308491,421154,701923,"IRQ",561539
1,72.0,"United States of America",2897137,2843049,54088,1994303,3323838,"USA",2659071
1,72.0,"Western Europe",3265959,3164343,101616,2323173,3871956,"NLD",3097565
1,72.0,"Russian Federation",3446397,2902669,543728,2215158,3691931,"RUS",2953545
1,72.0,"Northern Africa",1040947,0,1040947,915027,1525046,"EGY",1220037
1,72.0,"Eastern Asia",733146,0,733146,595878,993130,"JPN",794504
1,72.0,"Western Africa",181121,0,181121,155244,258740,"NGA",206992
1,72.0,"Southern Europe",502736,0,502736,520632,867720,"ITA",694176
1,73.0,"Northern America",698974,681725,17249,445551,742586,"CAN",594069
1,73.0,"Southern Asia",510186,0,510186,491879,819798,"IRN",655839
1,73.0,"South America",613362,273182,340180,1241361,2068936,"BRA",1655149
1,73.0,"Central Asia",1137873,994802,143071,815586,1359310,"UZB",1087448
1,73.0,"South-Eastern Asia",674720,0,674720,483602,806003,"IDN",644803
1,73.0,"Pakistan",1507012,1296518,210494,1197997,1996662,"PAK",1597330
1,73.0,"Southern Africa",102304,0,102304,27311,45518,"ZAF",36415
1,73.0,"Northern Europe",1709666,1683766,25900,1354410,2257350,"GBR",1805880
1,73.0,"Oceania",388988,381762,7226,281041,468402,"NZL",374722
1,73.0,"Central America",387184,0,387184,258303,430505,"MEX",344404
1,73.0,"Eastern Africa",143978,0,143978,90013,150022,"ETH",120018
1,73.0,"China",9758349,8748222,1010127,6833422,11389037,"CPR",9111230
1,73.0,"Eastern Europe",3431959,2924582,507377,2457273,4095456,"POL",3276365
1,73.0,"India",5051663,5023714,27949,3944331,6573885,"IND",5259108
1,73.0,"Middle Africa",41406,0,41406,40604,67673,"AGO",54139
1,73.0,"Western Asia",309949,0,309949,421154,701923,"IRQ",561539
1,73.0,"United States of America",2890026,2841743,48283,1994303,3323838,"USA",2659071
1,73.0,"Western Europe",3265967,3166397,99570,2323173,3871956,"NLD",3097565
1,73.0,"Russian Federation",3425742,2907923,517819,2215158,3691931,"RUS",2953545
1,73.0,"Northern Africa",1049023,0,1049023,915027,1525046,"EGY",1220037
1,73.0,"Eastern Asia",740264,0,740264,595878,993130,"JPN",794504
1,73.0,"Western Africa",182724,0,182724,155244,258740,"NGA",206992
1,73.0,"Southern Europe",505360,0,505360,520632,867720,"ITA",694176
1,74.0,"Northern America",580413,564836,15577,445551,742586,"CAN",594069
1,74.0,"Southern Asia",650243,0,650243,491879,819798,"IRN",655839
1,74.0,"South America",935756,369224,566532,1241361,2068936,"BRA",1655149
1,74.0,"Central Asia",1129529,994573,134956,815586,1359310,"UZB",1087448
1,74.0,"South-Eastern Asia",637017,0,637017,483602,806003,"IDN",644803
1,74.0,"Pakistan",1529902,1313701,216201,1197997,1996662,"PAK",1597330
1,74.0,"Southern Africa",34866,0,34866,27311,45518,"ZAF",36415
1,74.0,"Northern Europe",1696407,1675070,21337,1354410,2257350,"GBR",1805880
1,74.0,"Oceania",380568,374629,5939,281041,468402,"NZL",374722
1,74.0,"Central America",339073,0,339073,258303,430505,"MEX",344404
1,74.0,"Eastern Africa",118279,0,118279,90013,150022,"ETH",120018
1,74.0,"China",9666851,8733780,933071,6833422,11389037,"CPR",9111230
1,74.0,"Eastern Europe",3405863,2927242,478621,2457273,4095456,"POL",3276365
1,74.0,"India",5026459,5011629,14830,3944331,6573885,"IND",5259108
1,74.0,"Middle Africa",53449,0,53449,40604,67673,"AGO",54139
1,74.0,"Western Asia",558761,0,558761,421154,701923,"IRQ",561539
1,74.0,"United States of America",2595064,2556585,38479,1994303,3323838,"USA",2659071
1,74.0,"Western Europe",3082893,2986937,95956,2323173,3871956,"NLD",3097565
1,74.0,"Russian Federation",3341693,2905578,436115,2215158,3691931,"RUS",2953545
1,74.0,"Northern Africa",1204685,0,1204685,915027,1525046,"EGY",1220037
1,74.0,"Eastern Asia",780983,0,780983,595878,993130,"JPN",794504
1,74.0,"Western Africa",203949,0,203949,155244,258740,"NGA",206992
1,74.0,"Southern Europe",689182,0,689182,520632,867720,"ITA",694176
1,75.0,"Northern America",584310,568518,15792,445551,742586,"CAN",594069
1,75.0,"Southern Asia",649361,0,649361,491879,819798,"IRN",655839
1,75.0,"South America",1156560,433714,722846,1241361,2068936,"BRA",1655149
1,75.0,"Central Asia",1126131,996175,129956,815586,1359310,"UZB",1087448
1,75.0,"South-Eastern Asia",635777,0,635777,483602,806003,"IDN",644803
1,75.0,"Pakistan",1516602,1299279,217323,1197997,1996662,"PAK",1597330
1,75.0,"Southern Africa",34544,0,34544,27311,45518,"ZAF",36415
1,75.0,"Northern Europe",1684242,1667598,16644,1354410,2257350,"GBR",1805880
1,75.0,"Oceania",376671,371910,4761,281041,468402,"NZL",374722
1,75.0,"Central America",338228,0,338228,258303,430505,"MEX",344404
1,75.0,"Eastern Africa",117993,0,117993,90013,150022,"ETH",120018
1,75.0,"China",9598835,8748305,850530,6833422,11389037,"CPR",9111230
1,75.0,"Eastern Europe",3420762,2968796,451966,2457273,4095456,"POL",3276365
1,75.0,"India",5026237,5012426,13811,3944331,6573885,"IND",5259108
1,75.0,"Middle Africa",53355,0,53355,40604,67673,"AGO",54139
1,75.0,"Western Asia",558351,0,558351,421154,701923,"IRQ",561539
1,75.0,"United States of America",2580838,2549846,30992,1994303,3323838,"USA",2659071
1,75.0,"Western Europe",3082888,2992396,90492,2323173,3871956,"NLD",3097565
1,75.0,"Russian Federation",3166958,2809577,357381,2215158,3691931,"RUS",2953545
1,75.0,"Northern Africa",1202264,0,1202264,915027,1525046,"EGY",1220037
1,75.0,"Eastern Asia",778852,0,778852,595878,993130,"JPN",794504
1,75.0,"Western Africa",203469,0,203469,155244,258740,"NGA",206992
1,75.0,"Southern Europe",688397,0,688397,520632,867720,"ITA",694176
1,76.0,"Northern America",586261,570316,15945,445551,742586,"CAN",594069
1,76.0,"Southern Asia",649650,0,649650,491879,819798,"IRN",655839
1,76.0,"South America",1310056,478423,831633,1241361,2068936,"BRA",1655149
1,76.0,"Central Asia",1123255,998008,125247,815586,1359310,"UZB",1087448
1,76.0,"South-Eastern Asia",636180,0,636180,483602,806003,"IDN",644803
1,76.0,"Pakistan",1526288,1300676,225612,1197997,1996662,"PAK",1597330
1,76.0,"Southern Africa",34834,0,34834,27311,45518,"ZAF",36415
1,76.0,"Northern Europe",1692352,1674903,17449,1354410,2257350,"GBR",1805880
1,76.0,"Oceania",377645,374021,3624,281041,468402,"NZL",374722
1,76.0,"Central America",338502,0,338502,258303,430505,"MEX",344404
1,76.0,"Eastern Africa",118085,0,118085,90013,150022,"ETH",120018
1,76.0,"China",9518019,8743421,774598,6833422,11389037,"CPR",9111230
1,76.0,"Eastern Europe",3429301,3005513,423788,2457273,4095456,"POL",3276365
1,76.0,"India",5159408,5128766,30642,3944331,6573885,"IND",5259108
1,76.0,"Middle Africa",53432,0,53432,40604,67673,"AGO",54139
1,76.0,"Western Asia",558554,0,558554,421154,701923,"IRQ",561539
1,76.0,"United States of America",2587949,2558368,29581,1994303,3323838,"USA",2659071
1,76.0,"Western Europe",3068216,2978808,89408,2323173,3871956,"NLD",3097565
1,76.0,"Russian Federation",2973368,2662597,310771,2215158,3691931,"RUS",2953545
1,76.0,"Northern Africa",1203054,0,1203054,915027,1525046,"EGY",1220037
1,76.0,"Eastern Asia",779549,0,779549,595878,993130,"JPN",794504
1,76.0,"Western Africa",203628,0,203628,155244,258740,"NGA",206992
1,76.0,"Southern Europe",688653,0,688653,520632,867720,"ITA",694176
1,77.0,"Northern America",586261,570194,16067,445551,742586,"CAN",594069
1,77.0,"Southern Asia",651139,0,651139,491879,819798,"IRN",655839
1,77.0,"South America",1402790,494375,908415,1241361,2068936,"BRA",1655149
1,77.0,"Central Asia",1120221,999613,120608,815586,1359310,"UZB",1087448
1,77.0,"South-Eastern Asia",638256,0,638256,483602,806003,"IDN",644803
1,77.0,"Pakistan",1546372,1312887,233485,1197997,1996662,"PAK",1597330
1,77.0,"Southern Africa",35220,0,35220,27311,45518,"ZAF",36415
1,77.0,"Northern Europe",1712624,1692567,20057,1354410,2257350,"GBR",1805880
1,77.0,"Oceania",371801,369315,2486,281041,468402,"NZL",374722
1,77.0,"Central America",339922,0,339922,258303,430505,"MEX",344404
1,77.0,"Eastern Africa",118546,0,118546,90013,150022,"ETH",120018
1,77.0,"China",9433981,8727934,706047,6833422,11389037,"CPR",9111230
1,77.0,"Eastern Europe",3409729,3010483,399246,2457273,4095456,"POL",3276365
1,77.0,"India",5160550,5121858,38692,3944331,6573885,"IND",5259108
1,77.0,"Middle Africa",53569,0,53569,40604,67673,"AGO",54139
1,77.0,"Western Asia",559224,0,559224,421154,701923,"IRQ",561539
1,77.0,"United States of America",2623509,2593418,30091,1994303,3323838,"USA",2659071
1,77.0,"Western Europe",3068215,2978225,89990,2323173,3871956,"NLD",3097565
1,77.0,"Russian Federation",2921220,2628559,292661,2215158,3691931,"RUS",2953545
1,77.0,"Northern Africa",1207146,0,1207146,915027,1525046,"EGY",1220037
1,77.0,"Eastern Asia",783150,0,783150,595878,993130,"JPN",794504
1,77.0,"Western Africa",204436,0,204436,155244,258740,"NGA",206992
1,77.0,"Southern Europe",689985,0,689985,520632,867720,"ITA",694176
1,78.0,"Northern America",586261,570072,16189,445551,742586,"CAN",594069
1,78.0,"Southern Asia",652587,0,652587,491879,819798,"IRN",655839
1,78.0,"South America",1462889,496558,966331,1241361,2068936,"BRA",1655149
1,78.0,"Central Asia",1115050,998361,116689,815586,1359310,"UZB",1087448
1,78.0,"South-Eastern Asia",640370,0,640370,483602,806003,"IDN",644803
1,78.0,"Pakistan",1610586,1371367,239219,1197997,1996662,"PAK",1597330
1,78.0,"Southern Africa",35523,0,35523,27311,45518,"ZAF",36415
1,78.0,"Northern Europe",1785607,1759269,26338,1354410,2257350,"GBR",1805880
1,78.0,"Oceania",377643,376274,1369,281041,468402,"NZL",374722
1,78.0,"Central America",341300,0,341300,258303,430505,"MEX",344404
1,78.0,"Eastern Africa",119000,0,119000,90013,150022,"ETH",120018
1,78.0,"China",9305353,8659095,646258,6833422,11389037,"CPR",9111230
1,78.0,"Eastern Europe",3396117,3016241,379876,2457273,4095456,"POL",3276365
1,78.0,"India",5185208,5129756,55452,3944331,6573885,"IND",5259108
1,78.0,"Middle Africa",53744,0,53744,40604,67673,"AGO",54139
1,78.0,"Western Asia",559937,0,559937,421154,701923,"IRQ",561539
1,78.0,"United States of America",2630622,2600276,30346,1994303,3323838,"USA",2659071
1,78.0,"Western Europe",3068216,2977644,90572,2323173,3871956,"NLD",3097565
1,78.0,"Russian Federation",2966176,2682399,283777,2215158,3691931,"RUS",2953545
1,78.0,"Northern Africa",1211120,0,1211120,915027,1525046,"EGY",1220037
1,78.0,"Eastern Asia",786795,0,786795,595878,993130,"JPN",794504
1,78.0,"Western Africa",205222,0,205222,155244,258740,"NGA",206992
1,78.0,"Southern Europe",691274,0,691274,520632,867720,"ITA",694176
1,79.0,"Northern America",596018,579706,16312,445551,742586,"CAN",594069
1,79.0,"Southern Asia",654120,0,654120,491879,819798,"IRN",655839
1,79.0,"South America",1510031,497468,1012563,1241361,2068936,"BRA",1655149
1,79.0,"Central Asia",1112647,998905,113742,815586,1359310,"UZB",1087448
1,79.0,"South-Eastern Asia",642312,0,642312,483602,806003,"IDN",644803
1,79.0,"Pakistan",1608553,1372878,235675,1197997,1996662,"PAK",1597330
1,79.0,"Southern Africa",35884,0,35884,27311,45518,"ZAF",36415
1,79.0,"Northern Europe",1830206,1798225,31981,1354410,2257350,"GBR",1805880
1,79.0,"Oceania",373749,373505,244,281041,468402,"NZL",374722
1,79.0,"Central America",342767,0,342767,258303,430505,"MEX",344404
1,79.0,"Eastern Africa",119480,0,119480,90013,150022,"ETH",120018
1,79.0,"China",9095110,8487593,607517,6833422,11389037,"CPR",9111230
1,79.0,"Eastern Europe",3380405,3017608,362797,2457273,4095456,"POL",3276365
1,79.0,"India",5209537,5137636,71901,3944331,6573885,"IND",5259108
1,79.0,"Middle Africa",53927,0,53927,40604,67673,"AGO",54139
1,79.0,"Western Asia",560689,0,560689,421154,701923,"IRQ",561539
1,79.0,"United States of America",2637735,2607046,30689,1994303,3323838,"USA",2659071
1,79.0,"Western Europe",3075552,2984398,91154,2323173,3871956,"NLD",3097565
1,79.0,"Russian Federation",2900058,2628481,271577,2215158,3691931,"RUS",2953545
1,79.0,"Northern Africa",1215330,0,1215330,915027,1525046,"EGY",1220037
1,79.0,"Eastern Asia",790214,0,790214,595878,993130,"JPN",794504
1,79.0,"Western Africa",206054,0,206054,155244,258740,"NGA",206992
1,79.0,"Southern Europe",692643,0,692643,520632,867720,"ITA",694176
1,80.0,"Northern America",599926,583643,16283,445551,742586,"CAN",594069
1,80.0,"Southern Asia",656794,0,656794,491879,819798,"IRN",655839
1,80.0,"South America",1551774,500754,1051020,1241361,2068936,"BRA",1655149
1,80.0,"Central Asia",1110425,998803,111622,815586,1359310,"UZB",1087448
1,80.0,"South-Eastern Asia",646138,0,646138,483602,806003,"IDN",644803
1,80.0,"Pakistan",1604471,1369783,234688,1197997,1996662,"PAK",1597330
1,80.0,"Southern Africa",36525,0,36525,27311,45518,"ZAF",36415
1,80.0,"Northern Europe",1976171,1939090,37081,1354410,2257350,"GBR",1805880
1,80.0,"Oceania",373748,373748,0,281041,468402,"NZL",374722
1,80.0,"Central America",345317,0,345317,258303,430505,"MEX",344404
1,80.0,"Eastern Africa",120312,0,120312,90013,150022,"ETH",120018
1,80.0,"China",9092576,8507731,584845,6833422,11389037,"CPR",9111230
1,80.0,"Eastern Europe",3513310,3162376,350934,2457273,4095456,"POL",3276365
1,80.0,"India",5222273,5133787,88486,3944331,6573885,"IND",5259108
1,80.0,"Middle Africa",54249,0,54249,40604,67673,"AGO",54139
1,80.0,"Western Asia",562009,0,562009,421154,701923,"IRQ",561539
1,80.0,"United States of America",2659070,2620210,38860,1994303,3323838,"USA",2659071
1,80.0,"Western Europe",3082890,2991300,91590,2323173,3871956,"NLD",3097565
1,80.0,"Russian Federation",2859965,2588099,271866,2215158,3691931,"RUS",2953545
1,80.0,"Northern Africa",1222667,0,1222667,915027,1525046,"EGY",1220037
1,80.0,"Eastern Asia",796818,0,796818,595878,993130,"JPN",794504
1,80.0,"Western Africa",207510,0,207510,155244,258740,"NGA",206992
1,80.0,"Southern Europe",695029,0,695029,520632,867720,"ITA",694176
1,81.0,"Northern America",644802,628612,16190,445551,742586,"CAN",594069
1,81.0,"Southern Asia",643131,0,643131,491879,819798,"IRN",655839
1,81.0,"South America",1564436,497648,1066788,1241361,2068936,"BRA",1655149
1,81.0,"Central Asia",1106884,998343,108541,815586,1359310,"UZB",1087448
1,81.0,"South-Eastern Asia",627084,0,627084,483602,806003,"IDN",644803
1,81.0,"Pakistan",1607543,1370109,237434,1197997,1996662,"PAK",1597330
1,81.0,"Southern Africa",32886,0,32886,27311,45518,"ZAF",36415
1,81.0,"Northern Europe",1968063,1933207,34856,1354410,2257350,"GBR",1805880
1,81.0,"Oceania",374722,374722,0,281041,468402,"NZL",374722
1,81.0,"Central America",332281,0,332281,258303,430505,"MEX",344404
1,81.0,"Eastern Africa",116055,0,116055,90013,150022,"ETH",120018
1,81.0,"China",9127306,8552145,575161,6833422,11389037,"CPR",9111230
1,81.0,"Eastern Europe",3325374,3038840,286534,2457273,4095456,"POL",3276365
1,81.0,"India",5238126,5129868,108258,3944331,6573885,"IND",5259108
1,81.0,"Middle Africa",52620,0,52620,40604,67673,"AGO",54139
1,81.0,"Western Asia",555289,0,555289,421154,701923,"IRQ",561539
1,81.0,"United States of America",2331919,2285082,46837,1994303,3323838,"USA",2659071
1,81.0,"Western Europe",3082889,2991009,91880,2323173,3871956,"NLD",3097565
1,81.0,"Russian Federation",2791297,2538196,253101,2215158,3691931,"RUS",2953545
1,81.0,"Northern Africa",1185137,0,1185137,915027,1525046,"EGY",1220037
1,81.0,"Eastern Asia",763770,0,763770,595878,993130,"JPN",794504
1,81.0,"Western Africa",200085,0,200085,155244,258740,"NGA",206992
1,81.0,"Southern Europe",682835,0,682835,520632,867720,"ITA",694176
1,82.0,"Northern America",601876,586493,15383,445551,742586,"CAN",594069
1,82.0,"Southern Asia",644926,0,644926,491879,819798,"IRN",655839
1,82.0,"South America",1582508,500951,1081557,1241361,2068936,"BRA",1655149
1,82.0,"Central Asia",1087991,984372,103619,815586,1359310,"UZB",1087448
1,82.0,"South-Eastern Asia",629595,0,629595,483602,806003,"IDN",644803
1,82.0,"Pakistan",1607472,1371016,236456,1197997,1996662,"PAK",1597330
1,82.0,"Southern Africa",33320,0,33320,27311,45518,"ZAF",36415
1,82.0,"Northern Europe",1931571,1898835,32736,1354410,2257350,"GBR",1805880
1,82.0,"Oceania",371800,371800,0,281041,468402,"NZL",374722
1,82.0,"Central America",333994,0,333994,258303,430505,"MEX",344404
1,82.0,"Eastern Africa",116608,0,116608,90013,150022,"ETH",120018
1,82.0,"China",9048996,8498963,550033,6833422,11389037,"CPR",9111230
1,82.0,"Eastern Europe",3254496,2981560,272936,2457273,4095456,"POL",3276365
1,82.0,"India",5283880,5162214,121666,3944331,6573885,"IND",5259108
1,82.0,"Middle Africa",52823,0,52823,40604,67673,"AGO",54139
1,82.0,"Western Asia",556167,0,556167,421154,701923,"IRQ",561539
1,82.0,"United States of America",2459935,2400926,59009,1994303,3323838,"USA",2659071
1,82.0,"Western Europe",3075552,2974060,101492,2323173,3871956,"NLD",3097565
1,82.0,"Russian Federation",2785104,2530809,254295,2215158,3691931,"RUS",2953545
1,82.0,"Northern Africa",1190084,0,1190084,915027,1525046,"EGY",1220037
1,82.0,"Eastern Asia",768122,0,768122,595878,993130,"JPN",794504
1,82.0,"Western Africa",201056,0,201056,155244,258740,"NGA",206992
1,82.0,"Southern Europe",684437,0,684437,520632,867720,"ITA",694176
1,83.0,"Northern America",584315,569055,15260,445557,742596,"CAN",594077
1,83.0,"Southern Asia",646556,0,646556,491884,819807,"IRN",655846
1,83.0,"South America",1593887,499986,1093901,1241367,2068946,"BRA",1655157
1,83.0,"Central Asia",1092370,992686,99684,815594,1359323,"UZB",1087459
1,83.0,"South-Eastern Asia",631870,0,631870,483606,806010,"IDN",644808
1,83.0,"Pakistan",1602749,1368827,233922,1198003,1996672,"PAK",1597338
1,83.0,"Southern Africa",33831,0,33831,27316,45527,"ZAF",36422
1,83.0,"Northern Europe",1813990,1788042,25948,1354413,2257356,"GBR",1805885
1,83.0,"Oceania",376670,376670,0,281043,468405,"NZL",374724
1,83.0,"Central America",335549,0,335549,258303,430505,"MEX",344404
1,83.0,"Eastern Africa",117118,0,117118,90015,150026,"ETH",120021
1,83.0,"China",9151305,8627392,523913,6833424,11389041,"CPR",9111233
1,83.0,"Eastern Europe",3290416,3026742,263674,2457279,4095465,"POL",3276372
1,83.0,"India",5332344,5195769,136575,3944336,6573893,"IND",5259115
1,83.0,"Middle Africa",53019,0,53019,40605,67675,"AGO",54140
1,83.0,"Western Asia",556971,0,556971,421155,701925,"IRQ",561540
1,83.0,"United States of America",2523941,2454057,69884,1994303,3323838,"USA",2659071
1,83.0,"Western Europe",3075553,2964245,111308,2323180,3871967,"NLD",3097574
1,83.0,"Russian Federation",2802814,2537414,265400,2215167,3691945,"RUS",2953556
1,83.0,"Northern Africa",1194563,0,1194563,915033,1525055,"EGY",1220044
1,83.0,"Eastern Asia",772070,0,772070,595883,993138,"JPN",794511
1,83.0,"Western Africa",201945,0,201945,155250,258751,"NGA",207001
1,83.0,"Southern Europe",685894,0,685894,520638,867730,"ITA",694184
1,84.0,"Northern America",580409,564994,15415,433824,723040,"CAN",578432
1,84.0,"Southern Asia",648825,0,648825,293304,488841,"IRN",391073
1,84.0,"South America",1605894,499951,1105943,1124795,1874658,"BRA",1499727
1,84.0,"Central Asia",1097914,1002633,95281,660966,1101611,"UZB",881289
1,84.0,"South-Eastern Asia",635031,0,635031,399810,666350,"IDN",533080
1,84.0,"Pakistan",1605630,1373751,231879,1092838,1821397,"PAK",1457118
1,84.0,"Southern Africa",34462,0,34462,34012,56687,"ZAF",45350
1,84.0,"Northern Europe",1822100,1801638,20462,1205406,2009010,"GBR",1607208
1,84.0,"Oceania",378618,378618,0,261248,435413,"NZL",348331
1,84.0,"Central America",337714,0,337714,296888,494813,"MEX",395851
1,84.0,"Eastern Africa",117825,0,117825,109601,182668,"ETH",146135
1,84.0,"China",9197453,8705449,492004,6053438,10089063,"CPR",8071251
1,84.0,"Eastern Europe",3300463,3048576,251887,2201805,3669675,"POL",2935740
1,84.0,"India",5369492,5233924,135568,3620392,6033987,"IND",4827190
1,84.0,"Middle Africa",53290,0,53290,40744,67907,"AGO",54326
1,84.0,"Western Asia",558085,0,558085,346746,577910,"IRQ",462328
1,84.0,"United States of America",2566613,2486562,80051,1978305,3297175,"USA",2637740
1,84.0,"Western Europe",3075552,2963720,111832,2255854,3759757,"NLD",3007806
1,84.0,"Russian Federation",2855576,2580704,274872,1979139,3298565,"RUS",2638852
1,84.0,"Northern Africa",1200794,0,1200794,727215,1212026,"EGY",969621
1,84.0,"Eastern Asia",777553,0,777553,570050,950083,"JPN",760067
1,84.0,"Western Africa",203176,0,203176,193263,322106,"NGA",257685
1,84.0,"Southern Europe",687918,0,687918,480413,800688,"ITA",640551
1,85.0,"Northern America",596026,580395,15631,433824,723040,"CAN",578432
1,85.0,"Southern Asia",652317,0,652317,293304,488841,"IRN",391073
1,85.0,"South America",2958891,1840652,1118239,1124795,1874658,"BRA",1499727
1,85.0,"Central Asia",1101543,1009781,91762,660966,1101611,"UZB",881289
1,85.0,"South-Eastern Asia",639895,0,639895,399810,666350,"IDN",533080
1,85.0,"Pakistan",1604004,1373112,230892,1092838,1821397,"PAK",1457118
1,85.0,"Southern Africa",35437,0,35437,34012,56687,"ZAF",45350
1,85.0,"Northern Europe",1826159,1810624,15535,1205406,2009010,"GBR",1607208
1,85.0,"Oceania",379595,379595,0,261248,435413,"NZL",348331
1,85.0,"Central America",341040,0,341040,296888,494813,"MEX",395851
1,85.0,"Eastern Africa",118916,0,118916,109601,182668,"ETH",146135
1,85.0,"China",9225360,8759588,465772,6053438,10089063,"CPR",8071251
1,85.0,"Eastern Europe",3285331,3044319,241012,2201805,3669675,"POL",2935740
1,85.0,"India",5370048,5231418,138630,3620392,6033987,"IND",4827190
1,85.0,"Middle Africa",53714,0,53714,40744,67907,"AGO",54326
1,85.0,"Western Asia",559801,0,559801,346746,577910,"IRQ",462328
1,85.0,"United States of America",2595061,2505450,89611,1978305,3297175,"USA",2637740
1,85.0,"Western Europe",3075563,2963206,112357,2255854,3759757,"NLD",3007806
1,85.0,"Russian Federation",2896928,2613175,283753,1979139,3298565,"RUS",2638852
1,85.0,"Northern Africa",1210366,0,1210366,727215,1212026,"EGY",969621
1,85.0,"Eastern Asia",785986,0,785986,570050,950083,"JPN",760067
1,85.0,"Western Africa",205081,0,205081,193263,322106,"NGA",257685
1,85.0,"Southern Europe",691038,0,691038,480413,800688,"ITA",640551
1,86.0,"Northern America",666241,650888,15353,433824,723040,"CAN",578432
1,86.0,"Southern Asia",420918,0,420918,293304,488841,"IRN",391073
1,86.0,"South America",2660171,1842712,817459,1124795,1874658,"BRA",1499727
1,86.0,"Central Asia",894599,818219,76380,660966,1101611,"UZB",881289
1,86.0,"South-Eastern Asia",574676,0,574676,399810,666350,"IDN",533080
1,86.0,"Pakistan",1606671,1382528,224143,1092838,1821397,"PAK",1457118
1,86.0,"Southern Africa",53631,0,53631,34012,56687,"ZAF",45350
1,86.0,"Northern Europe",1611264,1601546,9718,1205406,2009010,"GBR",1607208
1,86.0,"Oceania",349305,349305,0,261248,435413,"NZL",348331
1,86.0,"Central America",424314,0,424314,296888,494813,"MEX",395851
1,86.0,"Eastern Africa",155442,0,155442,109601,182668,"ETH",146135
1,86.0,"China",8149222,7737005,412217,6053438,10089063,"CPR",8071251
1,86.0,"Eastern Europe",3017408,2793453,223955,2201805,3669675,"POL",2935740
1,86.0,"India",5394175,5249879,144296,3620392,6033987,"IND",4827190
1,86.0,"Middle Africa",57902,0,57902,40744,67907,"AGO",54326
1,86.0,"Western Asia",477014,0,477014,346746,577910,"IRQ",462328
1,86.0,"United States of America",2872434,2774083,98351,1978305,3297175,"USA",2637740
1,86.0,"Western Europe",3205903,3095163,110740,2255854,3759757,"NLD",3007806
1,86.0,"Russian Federation",2937581,2650544,287037,1979139,3298565,"RUS",2638852
1,86.0,"Northern Africa",1051553,0,1051553,727215,1212026,"EGY",969621
1,86.0,"Eastern Asia",832224,0,832224,570050,950083,"JPN",760067
1,86.0,"Western Africa",273899,0,273899,193263,322106,"NGA",257685
1,86.0,"Southern Europe",667182,0,667182,480413,800688,"ITA",640551
1,87.0,"Northern America",627215,614837,12378,433824,723040,"CAN",578432
1,87.0,"Southern Asia",421041,0,421041,293304,488841,"IRN",391073
1,87.0,"South America",2425581,1841449,584132,1124795,1874658,"BRA",1499727
1,87.0,"Central Asia",892106,814467,77639,660966,1101611,"UZB",881289
1,87.0,"South-Eastern Asia",574843,0,574843,399810,666350,"IDN",533080
1,87.0,"Pakistan",1581612,1367624,213988,1092838,1821397,"PAK",1457118
1,87.0,"Southern Africa",53683,0,53683,34012,56687,"ZAF",45350
1,87.0,"Northern Europe",1615318,1610430,4888,1205406,2009010,"GBR",1607208
1,87.0,"Oceania",350279,350279,0,261248,435413,"NZL",348331
1,87.0,"Central America",424438,0,424438,296888,494813,"MEX",395851
1,87.0,"Eastern Africa",155493,0,155493,109601,182668,"ETH",146135
1,87.0,"China",8131657,7732690,398967,6053438,10089063,"CPR",8071251
1,87.0,"Eastern Europe",2973520,2746387,227133,2201805,3669675,"POL",2935740
1,87.0,"India",5249691,5111760,137931,3620392,6033987,"IND",4827190
1,87.0,"Middle Africa",57928,0,57928,40744,67907,"AGO",54326
1,87.0,"Western Asia",477071,0,477071,346746,577910,"IRQ",462328
1,87.0,"United States of America",2943557,2842210,101347,1978305,3297175,"USA",2637740
1,87.0,"Western Europe",3213239,3107230,106009,2255854,3759757,"NLD",3007806
1,87.0,"Russian Federation",2995905,2693242,302663,1979139,3298565,"RUS",2638852
1,87.0,"Northern Africa",1051883,0,1051883,727215,1212026,"EGY",969621
1,87.0,"Eastern Asia",832515,0,832515,570050,950083,"JPN",760067
1,87.0,"Western Africa",273974,0,273974,193263,322106,"NGA",257685
1,87.0,"Southern Europe",667291,0,667291,480413,800688,"ITA",640551
1,88.0,"Northern America",578435,568383,10052,433824,723040,"CAN",578432
1,88.0,"Southern Asia",416602,0,416602,293304,488841,"IRN",391073
1,88.0,"South America",1854011,1458043,395968,1124795,1874658,"BRA",1499727
1,88.0,"Central Asia",884240,807393,76847,660966,1101611,"UZB",881289
1,88.0,"South-Eastern Asia",568657,0,568657,399810,666350,"IDN",533080
1,88.0,"Pakistan",1466070,1267407,198663,1092838,1821397,"PAK",1457118
1,88.0,"Southern Africa",52452,0,52452,34012,56687,"ZAF",45350
1,88.0,"Northern Europe",1607142,1607142,0,1205406,2009010,"GBR",1607208
1,88.0,"Oceania",348331,348331,0,261248,435413,"NZL",348331
1,88.0,"Central America",420202,0,420202,296888,494813,"MEX",395851
1,88.0,"Eastern Africa",154107,0,154107,109601,182668,"ETH",146135
1,88.0,"China",8082348,7700710,381638,6053438,10089063,"CPR",8071251
1,88.0,"Eastern Europe",2961090,2721767,239323,2201805,3669675,"POL",2935740
1,88.0,"India",4835422,4716961,118461,3620392,6033987,"IND",4827190
1,88.0,"Middle Africa",57397,0,57397,40744,67907,"AGO",54326
1,88.0,"Western Asia",474889,0,474889,346746,577910,"IRQ",462328
1,88.0,"United States of America",2964893,2862541,102352,1978305,3297175,"USA",2637740
1,88.0,"Western Europe",3213240,3112136,101104,2255854,3759757,"NLD",3007806
1,88.0,"Russian Federation",2918641,2619591,299050,1979139,3298565,"RUS",2638852
1,88.0,"Northern Africa",1039694,0,1039694,727215,1212026,"EGY",969621
1,88.0,"Eastern Asia",821780,0,821780,570050,950083,"JPN",760067
1,88.0,"Western Africa",271563,0,271563,193263,322106,"NGA",257685
1,88.0,"Southern Europe",663330,0,663330,480413,800688,"ITA",640551
1,89.0,"Northern America",574531,566214,8317,433824,723040,"CAN",578432
1,89.0,"Southern Asia",408274,0,408274,293304,488841,"IRN",391073
1,89.0,"South America",1510078,1182667,327411,1124795,1874658,"BRA",1499727
1,89.0,"Central Asia",876614,801845,74769,660966,1101611,"UZB",881289
1,89.0,"South-Eastern Asia",557052,0,557052,399810,666350,"IDN",533080
1,89.0,"Pakistan",1453603,1257928,195675,1092838,1821397,"PAK",1457118
1,89.0,"Southern Africa",50135,0,50135,34012,56687,"ZAF",45350
1,89.0,"Northern Europe",1599098,1599098,0,1205406,2009010,"GBR",1607208
1,89.0,"Oceania",346383,346383,0,261248,435413,"NZL",348331
1,89.0,"Central America",412260,0,412260,296888,494813,"MEX",395851
1,89.0,"Eastern Africa",151508,0,151508,109601,182668,"ETH",146135
1,89.0,"China",8047768,7670737,377031,6053438,10089063,"CPR",8071251
1,89.0,"Eastern Europe",2945696,2691874,253822,2201805,3669675,"POL",2935740
1,89.0,"India",4804478,4699196,105282,3620392,6033987,"IND",4827190
1,89.0,"Middle Africa",56396,0,56396,40744,67907,"AGO",54326
1,89.0,"Western Asia",470793,0,470793,346746,577910,"IRQ",462328
1,89.0,"United States of America",2907998,2805695,102303,1978305,3297175,"USA",2637740
1,89.0,"Western Europe",3081176,2981612,99564,2255854,3759757,"NLD",3007806
1,89.0,"Russian Federation",2652563,2368805,283758,1979139,3298565,"RUS",2638852
1,89.0,"Northern Africa",1016834,0,1016834,727215,1212026,"EGY",969621
1,89.0,"Eastern Asia",801646,0,801646,570050,950083,"JPN",760067
1,89.0,"Western Africa",267035,0,267035,193263,322106,"NGA",257685
1,89.0,"Southern Europe",655898,0,655898,480413,800688,"ITA",640551
1,90.0,"Northern America",586235,579623,6612,433824,723040,"CAN",578432
1,90.0,"Southern Asia",404416,0,404416,293304,488841,"IRN",391073
1,90.0,"South America",1525860,1192198,333662,1124795,1874658,"BRA",1499727
1,90.0,"Central Asia",893025,819774,73251,660966,1101611,"UZB",881289
1,90.0,"South-Eastern Asia",551676,0,551676,399810,666350,"IDN",533080
1,90.0,"Pakistan",1480047,1277887,202160,1092838,1821397,"PAK",1457118
1,90.0,"Southern Africa",49063,0,49063,34012,56687,"ZAF",45350
1,90.0,"Northern Europe",1623425,1623425,0,1205406,2009010,"GBR",1607208
1,90.0,"Oceania",352227,352227,0,261248,435413,"NZL",348331
1,90.0,"Central America",408580,0,408580,296888,494813,"MEX",395851
1,90.0,"Eastern Africa",150304,0,150304,109601,182668,"ETH",146135
1,90.0,"China",8193049,7804575,388474,6053438,10089063,"CPR",8071251
1,90.0,"Eastern Europe",2987536,2724268,263268,2201805,3669675,"POL",2935740
1,90.0,"India",4877583,4784288,93295,3620392,6033987,"IND",4827190
1,90.0,"Middle Africa",55934,0,55934,40744,67907,"AGO",54326
1,90.0,"Western Asia",468897,0,468897,346746,577910,"IRQ",462328
1,90.0,"United States of America",2829766,2726636,103130,1978305,3297175,"USA",2637740
1,90.0,"Western Europe",3037154,2948262,88892,2255854,3759757,"NLD",3007806
1,90.0,"Russian Federation",2697548,2399493,298055,1979139,3298565,"RUS",2638852
1,90.0,"Northern Africa",1006248,0,1006248,727215,1212026,"EGY",969621
1,90.0,"Eastern Asia",792323,0,792323,570050,950083,"JPN",760067
1,90.0,"Western Africa",264944,0,264944,193263,322106,"NGA",257685
1,90.0,"Southern Europe",652456,0,652456,480413,800688,"ITA",640551
1,91.0,"Northern America",576481,571649,4832,433824,723040,"CAN",578432
1,91.0,"Southern Asia",399030,0,399030,293304,488841,"IRN",391073
1,91.0,"South America",1504546,1173161,331385,1124795,1874658,"BRA",1499727
1,91.0,"Central Asia",879267,809036,70231,660966,1101611,"UZB",881289
1,91.0,"South-Eastern Asia",544165,0,544165,399810,666350,"IDN",533080
1,91.0,"Pakistan",1460116,1259689,200427,1092838,1821397,"PAK",1457118
1,91.0,"Southern Africa",47564,0,47564,34012,56687,"ZAF",45350
1,91.0,"Northern Europe",1603154,1603154,0,1205406,2009010,"GBR",1607208
1,91.0,"Oceania",347356,347356,0,261248,435413,"NZL",348331
1,91.0,"Central America",403439,0,403439,296888,494813,"MEX",395851
1,91.0,"Eastern Africa",148622,0,148622,109601,182668,"ETH",146135
1,91.0,"China",8069674,7692779,376895,6053438,10089063,"CPR",8071251
1,91.0,"Eastern Europe",2939931,2678812,261119,2201805,3669675,"POL",2935740
1,91.0,"India",4820514,4737488,83026,3620392,6033987,"IND",4827190
1,91.0,"Middle Africa",55284,0,55284,40744,67907,"AGO",54326
1,91.0,"Western Asia",466243,0,466243,346746,577910,"IRQ",462328
1,91.0,"United States of America",2787093,2692404,94689,1978305,3297175,"USA",2637740
1,91.0,"Western Europe",3000470,2921193,79277,2255854,3759757,"NLD",3007806
1,91.0,"Russian Federation",2644542,2347882,296660,1979139,3298565,"RUS",2638852
1,91.0,"Northern Africa",991455,0,991455,727215,1212026,"EGY",969621
1,91.0,"Eastern Asia",779294,0,779294,570050,950083,"JPN",760067
1,91.0,"Western Africa",262007,0,262007,193263,322106,"NGA",257685
1,91.0,"Southern Europe",647649,0,647649,480413,800688,"ITA",640551
1,92.0,"Northern America",580383,577279,3104,433824,723040,"CAN",578432
1,92.0,"Southern Asia",395329,0,395329,293304,488841,"IRN",391073
1,92.0,"South America",1507085,1177171,329914,1124795,1874658,"BRA",1499727
1,92.0,"Central Asia",885714,816279,69435,660966,1101611,"UZB",881289
1,92.0,"South-Eastern Asia",539007,0,539007,399810,666350,"IDN",533080
1,92.0,"Pakistan",1463564,1264670,198894,1092838,1821397,"PAK",1457118
1,92.0,"Southern Africa",46536,0,46536,34012,56687,"ZAF",45350
1,92.0,"Northern Europe",1611262,1611262,0,1205406,2009010,"GBR",1607208
1,92.0,"Oceania",349306,349306,0,261248,435413,"NZL",348331
1,92.0,"Central America",399908,0,399908,296888,494813,"MEX",395851
1,92.0,"Eastern Africa",147467,0,147467,109601,182668,"ETH",146135
1,92.0,"China",8104040,7740392,363648,6053438,10089063,"CPR",8071251
1,92.0,"Eastern Europe",2950069,2691986,258083,2201805,3669675,"POL",2935740
1,92.0,"India",4841466,4770623,70843,3620392,6033987,"IND",4827190
1,92.0,"Middle Africa",54845,0,54845,40744,67907,"AGO",54326
1,92.0,"Western Asia",464425,0,464425,346746,577910,"IRQ",462328
1,92.0,"United States of America",2701750,2618438,83312,1978305,3297175,"USA",2637740
1,92.0,"Western Europe",3015141,2944757,70384,2255854,3759757,"NLD",3007806
1,92.0,"Russian Federation",2655182,2359513,295669,1979139,3298565,"RUS",2638852
1,92.0,"Northern Africa",981298,0,981298,727215,1212026,"EGY",969621
1,92.0,"Eastern Asia",770348,0,770348,570050,950083,"JPN",760067
1,92.0,"Western Africa",260002,0,260002,193263,322106,"NGA",257685
1,92.0,"Southern Europe",644347,0,644347,480413,800688,"ITA",640551
1,93.0,"Northern America",572579,571213,1366,433824,723040,"CAN",578432
1,93.0,"Southern Asia",388090,0,388090,293304,488841,"IRN",391073
1,93.0,"South America",1487387,1166149,321238,1124795,1874658,"BRA",1499727
1,93.0,"Central Asia",872446,806601,65845,660966,1101611,"UZB",881289
1,93.0,"South-Eastern Asia",528920,0,528920,399810,666350,"IDN",533080
1,93.0,"Pakistan",1445349,1254090,191259,1092838,1821397,"PAK",1457118
1,93.0,"Southern Africa",44523,0,44523,34012,56687,"ZAF",45350
1,93.0,"Northern Europe",1595045,1595045,0,1205406,2009010,"GBR",1607208
1,93.0,"Oceania",345408,345408,0,261248,435413,"NZL",348331
1,93.0,"Central America",393002,0,393002,296888,494813,"MEX",395851
1,93.0,"Eastern Africa",145207,0,145207,109601,182668,"ETH",146135
1,93.0,"China",8003212,7667989,335223,6053438,10089063,"CPR",8071251
1,93.0,"Eastern Europe",2907498,2663637,243861,2201805,3669675,"POL",2935740
1,93.0,"India",4790972,4734734,56238,3620392,6033987,"IND",4827190
1,93.0,"Middle Africa",53972,0,53972,40744,67907,"AGO",54326
1,93.0,"Western Asia",460862,0,460862,346746,577910,"IRQ",462328
1,93.0,"United States of America",2616407,2542350,74057,1978305,3297175,"USA",2637740
1,93.0,"Western Europe",2985797,2924549,61248,2255854,3759757,"NLD",3007806
1,93.0,"Russian Federation",2607497,2327241,280256,1979139,3298565,"RUS",2638852
1,93.0,"Northern Africa",961420,0,961420,727215,1212026,"EGY",969621
1,93.0,"Eastern Asia",752847,0,752847,570050,950083,"JPN",760067
1,93.0,"Western Africa",256064,0,256064,193263,322106,"NGA",257685
1,93.0,"Southern Europe",637889,0,637889,480413,800688,"ITA",640551
1,94.0,"Northern America",580383,580383,0,433824,723040,"CAN",578432
1,94.0,"Southern Asia",392063,0,392063,293304,488841,"IRN",391073
1,94.0,"South America",1503776,1183564,320212,1124795,1874658,"BRA",1499727
1,94.0,"Central Asia",884121,820064,64057,660966,1101611,"UZB",881289
1,94.0,"South-Eastern Asia",534465,0,534465,399810,666350,"IDN",533080
1,94.0,"Pakistan",1461038,1271660,189378,1092838,1821397,"PAK",1457118
1,94.0,"Southern Africa",45624,0,45624,34012,56687,"ZAF",45350
1,94.0,"Northern Europe",1611262,1611262,0,1205406,2009010,"GBR",1607208
1,94.0,"Oceania",349305,349305,0,261248,435413,"NZL",348331
1,94.0,"Central America",396797,0,396797,296888,494813,"MEX",395851
1,94.0,"Eastern Africa",146441,0,146441,109601,182668,"ETH",146135
1,94.0,"China",8092813,7778298,314515,6053438,10089063,"CPR",8071251
1,94.0,"Eastern Europe",2945042,2705898,239144,2201805,3669675,"POL",2935740
1,94.0,"India",4838907,4796915,41992,3620392,6033987,"IND",4827190
1,94.0,"Middle Africa",54439,0,54439,40744,67907,"AGO",54326
1,94.0,"Western Asia",462813,0,462813,346746,577910,"IRQ",462328
1,94.0,"United States of America",2644850,2578307,66543,1978305,3297175,"USA",2637740
1,94.0,"Western Europe",3015142,2962625,52517,2255854,3759757,"NLD",3007806
1,94.0,"Russian Federation",2649301,2371176,278125,1979139,3298565,"RUS",2638852
1,94.0,"Northern Africa",972350,0,972350,727215,1212026,"EGY",969621
1,94.0,"Eastern Asia",762470,0,762470,570050,950083,"JPN",760067
1,94.0,"Western Africa",258220,0,258220,193263,322106,"NGA",257685
1,94.0,"Southern Europe",641437,0,641437,480413,800688,"ITA",640551
1,95.0,"Northern America",584286,584286,0,433827,723045,"CAN",578436
1,95.0,"Southern Asia",394068,0,394068,293313,488855,"IRN",391084
1,95.0,"South America",1512144,1194665,317479,1124798,1874663,"BRA",1499731
1,95.0,"Central Asia",890532,828424,62108,660968,1101613,"UZB",881291
1,95.0,"South-Eastern Asia",537249,0,537249,399813,666355,"IDN",533084
1,95.0,"Pakistan",1468898,1282142,186756,1092846,1821410,"PAK",1457128
1,95.0,"Southern Africa",46185,0,46185,34017,56696,"ZAF",45357
1,95.0,"Northern Europe",1619372,1619372,0,1205411,2009018,"GBR",1607215
1,95.0,"Oceania",351254,351254,0,261254,435423,"NZL",348339
1,95.0,"Central America",398706,0,398706,296895,494826,"MEX",395861
1,95.0,"Eastern Africa",147073,0,147073,109609,182682,"ETH",146146
1,95.0,"China",8142201,7847887,294314,6053446,10089077,"CPR",8071262
1,95.0,"Eastern Europe",2964100,2730666,233434,2201811,3669686,"POL",2935749
1,95.0,"India",4863997,4836243,27754,3620393,6033988,"IND",4827191
1,95.0,"Middle Africa",54688,0,54688,40745,67908,"AGO",54327
1,95.0,"Western Asia",463802,0,463802,346747,577912,"IRQ",462330
1,95.0,"United States of America",2659077,2600563,58514,1978312,3297187,"USA",2637750
1,95.0,"Western Europe",3029818,2978478,51340,2255859,3759766,"NLD",3007813
1,95.0,"Russian Federation",2670219,2395924,274295,1979139,3298566,"RUS",2638853
1,95.0,"Northern Africa",977831,0,977831,727217,1212028,"EGY",969623
1,95.0,"Eastern Asia",767299,0,767299,570057,950096,"JPN",760077
1,95.0,"Western Africa",259316,0,259316,193271,322118,"NGA",257695
1,95.0,"Southern Europe",643223,0,643223,480417,800696,"ITA",640557
1,96.0,"Northern America",584285,584285,0,537508,895847,"CAN",716678
1,96.0,"Southern Asia",394068,0,394068,621149,1035248,"IRN",828199
1,96.0,"South America",1512356,1199173,313183,1381279,2302132,"BRA",1841706
1,96.0,"Central Asia",890695,830914,59781,851304,1418841,"UZB",1135073
1,96.0,"South-Eastern Asia",537250,0,537250,502791,837985,"IDN",670388
1,96.0,"Pakistan",1468900,1285872,183028,1343872,2239787,"PAK",1791830
1,96.0,"Southern Africa",46185,0,46185,39159,65265,"ZAF",52212
1,96.0,"Northern Europe",1619373,1619373,0,1513668,2522780,"GBR",2018224
1,96.0,"Oceania",351253,351253,0,340412,567353,"NZL",453883
1,96.0,"Central America",398706,0,398706,357577,595962,"MEX",476770
1,96.0,"Eastern Africa",147074,0,147074,126057,210096,"ETH",168077
1,96.0,"China",8144662,7870630,274032,7335534,12225891,"CPR",9780713
1,96.0,"Eastern Europe",2964187,2738230,225957,2514905,4191508,"POL",3353207
1,96.0,"India",4864931,4850788,14143,4492856,7488093,"IND",5990475
1,96.0,"Middle Africa",54693,0,54693,54690,91151,"AGO",72921
1,96.0,"Western Asia",463802,0,463802,417959,696598,"IRQ",557279
1,96.0,"United States of America",2659077,2608780,50297,2234649,3724416,"USA",2979533
1,96.0,"Western Europe",3029817,2978763,51054,2622333,4370555,"NLD",3496444
1,96.0,"Russian Federation",2670221,2402314,267907,2253341,3755568,"RUS",3004455
1,96.0,"Northern Africa",977833,0,977833,836379,1393965,"EGY",1115172
1,96.0,"Eastern Asia",767301,0,767301,676590,1127650,"JPN",902120
1,96.0,"Western Africa",259315,0,259315,205152,341920,"NGA",273536
1,96.0,"Southern Europe",643223,0,643223,534516,890860,"ITA",712688
1,97.0,"Northern America",574534,574534,0,537508,895847,"CAN",716678
1,97.0,"Southern Asia",389098,0,389098,621149,1035248,"IRN",828199
1,97.0,"South America",1491553,1188209,303344,1381279,2302132,"BRA",1841706
1,97.0,"Central Asia",875837,820158,55679,851304,1418841,"UZB",1135073
1,97.0,"South-Eastern Asia",530310,0,530310,502791,837985,"IDN",670388
1,97.0,"Pakistan",1450143,1274806,175337,1343872,2239787,"PAK",1791830
1,97.0,"Southern Africa",44807,0,44807,39159,65265,"ZAF",52212
1,97.0,"Northern Europe",1599107,1599107,0,1513668,2522780,"GBR",2018224
1,97.0,"Oceania",346391,346391,0,340412,567353,"NZL",453883
1,97.0,"Central America",393965,0,393965,357577,595962,"MEX",476770
1,97.0,"Eastern Africa",145528,0,145528,126057,210096,"ETH",168077
1,97.0,"China",8028690,7786389,242301,7335534,12225891,"CPR",9780713
1,97.0,"Eastern Europe",2918733,2706360,212373,2514905,4191508,"POL",3353207
1,97.0,"India",4803357,4803357,0,4492856,7488093,"IND",5990475
1,97.0,"Middle Africa",54096,0,54096,54690,91151,"AGO",72921
1,97.0,"Western Asia",461356,0,461356,417959,696598,"IRQ",557279
1,97.0,"United States of America",2623527,2582418,41109,2234649,3724416,"USA",2979533
1,97.0,"Western Europe",2993141,2942373,50768,2622333,4370555,"NLD",3496444
1,97.0,"Russian Federation",2618532,2366443,252089,2253341,3755568,"RUS",3004455
1,97.0,"Northern Africa",964158,0,964158,836379,1393965,"EGY",1115172
1,97.0,"Eastern Asia",755265,0,755265,676590,1127650,"JPN",902120
1,97.0,"Western Africa",256616,0,256616,205152,341920,"NGA",273536
1,97.0,"Southern Europe",638784,0,638784,534516,890860,"ITA",712688
1,98.0,"Northern America",718629,718629,0,537508,895847,"CAN",716678
1,98.0,"Southern Asia",817655,0,817655,621149,1035248,"IRN",828199
1,98.0,"South America",1834331,1474462,359869,1381279,2302132,"BRA",1841706
1,98.0,"Central Asia",1099679,1031657,68022,851304,1418841,"UZB",1135073
1,98.0,"South-Eastern Asia",655691,0,655691,502791,837985,"IDN",670388
1,98.0,"Pakistan",1596669,1389060,207609,1343872,2239787,"PAK",1791830
1,98.0,"Southern Africa",49277,0,49277,39159,65265,"ZAF",52212
1,98.0,"Northern Europe",1884411,1884411,0,1513668,2522780,"GBR",2018224
1,98.0,"Oceania",454857,454857,0,340412,567353,"NZL",453883
1,98.0,"Central America",466711,0,466711,357577,595962,"MEX",476770
1,98.0,"Eastern Africa",164784,0,164784,126057,210096,"ETH",168077
1,98.0,"China",9468775,9200198,268577,7335534,12225891,"CPR",9780713
1,98.0,"Eastern Europe",3342724,3118404,224320,2514905,4191508,"POL",3353207
1,98.0,"India",5412511,5407321,5190,4492856,7488093,"IND",5990475
1,98.0,"Middle Africa",71637,0,71637,54690,91151,"AGO",72921
1,98.0,"Western Asia",552088,0,552088,417959,696598,"IRQ",557279
1,98.0,"United States of America",2908413,2872969,35444,2234649,3724416,"USA",2979533
1,98.0,"Western Europe",3313021,3255694,57327,2622333,4370555,"NLD",3496444
1,98.0,"Russian Federation",2993511,2724209,269302,2253341,3755568,"RUS",3004455
1,98.0,"Northern Africa",1086231,0,1086231,836379,1393965,"EGY",1115172
1,98.0,"Eastern Asia",876632,0,876632,676590,1127650,"JPN",902120
1,98.0,"Western Africa",267802,0,267802,205152,341920,"NGA",273536
1,98.0,"Southern Europe",703277,0,703277,534516,890860,"ITA",712688
1,99.0,"Northern America",706923,706923,0,537508,895847,"CAN",716678
1,99.0,"Southern Asia",818216,0,818216,621149,1035248,"IRN",828199
1,99.0,"South America",1816111,1469549,346562,1381279,2302132,"BRA",1841706
1,99.0,"Central Asia",1089691,1025009,64682,851304,1418841,"UZB",1135073
1,99.0,"South-Eastern Asia",656883,0,656883,502791,837985,"IDN",670388
1,99.0,"Pakistan",1661211,1433126,228085,1343872,2239787,"PAK",1791830
1,99.0,"Southern Africa",49491,0,49491,39159,65265,"ZAF",52212
1,99.0,"Northern Europe",1929104,1922644,6460,1513668,2522780,"GBR",2018224
1,99.0,"Oceania",449012,449012,0,340412,567353,"NZL",453883
1,99.0,"Central America",467248,0,467248,357577,595962,"MEX",476770
1,99.0,"Eastern Africa",164957,0,164957,126057,210096,"ETH",168077
1,99.0,"China",9439258,9198690,240568,7335534,12225891,"CPR",9780713
1,99.0,"Eastern Europe",3303178,3097442,205736,2514905,4191508,"POL",3353207
1,99.0,"India",5415852,5394521,21331,4492856,7488093,"IND",5990475
1,99.0,"Middle Africa",71718,0,71718,54690,91151,"AGO",72921
1,99.0,"Western Asia",552365,0,552365,417959,696598,"IRQ",557279
1,99.0,"United States of America",2922636,2891290,31346,2234649,3724416,"USA",2979533
1,99.0,"Western Europe",3357042,3299623,57419,2622333,4370555,"NLD",3496444
1,99.0,"Russian Federation",2943166,2699603,243563,2253341,3755568,"RUS",3004455
1,99.0,"Northern Africa",1087779,0,1087779,836379,1393965,"EGY",1115172
1,99.0,"Eastern Asia",877995,0,877995,676590,1127650,"JPN",902120
1,99.0,"Western Africa",268014,0,268014,205152,341920,"NGA",273536
1,99.0,"Southern Europe",703784,0,703784,534516,890860,"ITA",712688
1,100.0,"Northern America",706922,706922,0,537508,895847,"CAN",716678
1,100.0,"Southern Asia",819121,0,819121,621149,1035248,"IRN",828199
1,100.0,"South America",1816894,1479176,337718,1381279,2302132,"BRA",1841706
1,100.0,"Central Asia",1084449,1019792,64657,851304,1418841,"UZB",1135073
1,100.0,"South-Eastern Asia",658082,0,658082,502791,837985,"IDN",670388
1,100.0,"Pakistan",1677622,1438562,239060,1343872,2239787,"PAK",1791830
1,100.0,"Southern Africa",49686,0,49686,39159,65265,"ZAF",52212
1,100.0,"Northern Europe",1961460,1948526,12934,1513668,2522780,"GBR",2018224
1,100.0,"Oceania",449013,449013,0,340412,567353,"NZL",453883
1,100.0,"Central America",468112,0,468112,357577,595962,"MEX",476770
1,100.0,"Eastern Africa",165240,0,165240,126057,210096,"ETH",168077
1,100.0,"China",9397629,9179149,218480,7335534,12225891,"CPR",9780713
1,100.0,"Eastern Europe",3303652,3112531,191121,2514905,4191508,"POL",3353207
1,100.0,"India",5646276,5602948,43328,4492856,7488093,"IND",5990475
1,100.0,"Middle Africa",71817,0,71817,54690,91151,"AGO",72921
1,100.0,"Western Asia",552812,0,552812,417959,696598,"IRQ",557279
1,100.0,"United States of America",2922636,2889963,32673,2234649,3724416,"USA",2979533
1,100.0,"Western Europe",3379053,3319888,59165,2622333,4370555,"NLD",3496444
1,100.0,"Russian Federation",2955379,2719598,235781,2253341,3755568,"RUS",3004455
1,100.0,"Northern Africa",1090258,0,1090258,836379,1393965,"EGY",1115172
1,100.0,"Eastern Asia",880176,0,880176,676590,1127650,"JPN",902120
1,100.0,"Western Africa",268599,0,268599,205152,341920,"NGA",273536
1,100.0,"Southern Europe",704941,0,704941,534516,890860,"ITA",712688
1,101.0,"Northern America",710824,710824,0,537508,895847,"CAN",716678
1,101.0,"Southern Asia",820913,0,820913,621149,1035248,"IRN",828199
1,101.0,"South America",1831271,1501275,329996,1381279,2302132,"BRA",1841706
1,101.0,"Central Asia",1082287,1016639,65648,851304,1418841,"UZB",1135073
1,101.0,"South-Eastern Asia",660316,0,660316,502791,837985,"IDN",670388
1,101.0,"Pakistan",1707273,1452623,254650,1343872,2239787,"PAK",1791830
1,101.0,"Southern Africa",50184,0,50184,39159,65265,"ZAF",52212
1,101.0,"Northern Europe",1997950,1978569,19381,1513668,2522780,"GBR",2018224
1,101.0,"Oceania",452909,452909,0,340412,567353,"NZL",453883
1,101.0,"Central America",469820,0,469820,357577,595962,"MEX",476770
1,101.0,"Eastern Africa",165797,0,165797,126057,210096,"ETH",168077
1,101.0,"China",9399079,9194105,204974,7335534,12225891,"CPR",9780713
1,101.0,"Eastern Europe",3338128,3159732,178396,2514905,4191508,"POL",3353207
1,101.0,"India",5695993,5632225,63768,4492856,7488093,"IND",5990475
1,101.0,"Middle Africa",72018,0,72018,54690,91151,"AGO",72921
1,101.0,"Western Asia",553689,0,553689,417959,696598,"IRQ",557279
1,101.0,"United States of America",2922637,2888187,34450,2234649,3724416,"USA",2979533
1,101.0,"Western Europe",3401064,3340429,60635,2622333,4370555,"NLD",3496444
1,101.0,"Russian Federation",2992237,2763509,228728,2253341,3755568,"RUS",3004455
1,101.0,"Northern Africa",1095175,0,1095175,836379,1393965,"EGY",1115172
1,101.0,"Eastern Asia",884509,0,884509,676590,1127650,"JPN",902120
1,101.0,"Western Africa",269574,0,269574,205152,341920,"NGA",273536
1,101.0,"Southern Europe",706169,0,706169,534516,890860,"ITA",712688
1,102.0,"Northern America",706922,706922,0,537508,895847,"CAN",716678
1,102.0,"Southern Asia",821635,0,821635,621149,1035248,"IRN",828199
1,102.0,"South America",1835209,1515165,320044,1381279,2302132,"BRA",1841706
1,102.0,"Central Asia",1082875,1015478,67397,851304,1418841,"UZB",1135073
1,102.0,"South-Eastern Asia",661123,0,661123,502791,837985,"IDN",670388
1,102.0,"Pakistan",1692074,1425217,266857,1343872,2239787,"PAK",1791830
1,102.0,"Southern Africa",50386,0,50386,39159,65265,"ZAF",52212
1,102.0,"Northern Europe",2026332,2000713,25619,1513668,2522780,"GBR",2018224
1,102.0,"Oceania",453883,453883,0,340412,567353,"NZL",453883
1,102.0,"Central America",470509,0,470509,357577,595962,"MEX",476770
1,102.0,"Eastern Africa",166024,0,166024,126057,210096,"ETH",168077
1,102.0,"China",9398279,9194683,203596,7335534,12225891,"CPR",9780713
1,102.0,"Eastern Europe",3347380,3183593,163787,2514905,4191508,"POL",3353207
1,102.0,"India",5756824,5672687,84137,4492856,7488093,"IND",5990475
1,102.0,"Middle Africa",72128,0,72128,54690,91151,"AGO",72921
1,102.0,"Western Asia",554047,0,554047,417959,696598,"IRQ",557279
1,102.0,"United States of America",2929748,2892418,37330,2234649,3724416,"USA",2979533
1,102.0,"Western Europe",3415736,3353907,61829,2622333,4370555,"NLD",3496444
1,102.0,"Russian Federation",3002075,2783390,218685,2253341,3755568,"RUS",3004455
1,102.0,"Northern Africa",1097155,0,1097155,836379,1393965,"EGY",1115172
1,102.0,"Eastern Asia",886255,0,886255,676590,1127650,"JPN",902120
1,102.0,"Western Africa",269964,0,269964,205152,341920,"NGA",273536
1,102.0,"Southern Europe",706734,0,706734,534516,890860,"ITA",712688
1,103.0,"Northern America",704970,704970,0,537508,895847,"CAN",716678
1,103.0,"Southern Asia",822275,0,822275,621149,1035248,"IRN",828199
1,103.0,"South America",1821636,1509614,312022,1381279,2302132,"BRA",1841706
1,103.0,"Central Asia",1118945,1049749,69196,851304,1418841,"UZB",1135073
1,103.0,"South-Eastern Asia",661995,0,661995,502791,837985,"IDN",670388
1,103.0,"Pakistan",1711528,1429604,281924,1343872,2239787,"PAK",1791830
1,103.0,"Southern Africa",50563,0,50563,39159,65265,"ZAF",52212
1,103.0,"Northern Europe",2030389,1998807,31582,1513668,2522780,"GBR",2018224
1,103.0,"Oceania",449012,449012,0,340412,567353,"NZL",453883
1,103.0,"Central America",471121,0,471121,357577,595962,"MEX",476770
1,103.0,"Eastern Africa",166225,0,166225,126057,210096,"ETH",168077
1,103.0,"China",9418242,9210789,207453,7335534,12225891,"CPR",9780713
1,103.0,"Eastern Europe",3310021,3158452,151569,2514905,4191508,"POL",3353207
1,103.0,"India",5781382,5677287,104095,4492856,7488093,"IND",5990475
1,103.0,"Middle Africa",72206,0,72206,54690,91151,"AGO",72921
1,103.0,"Western Asia",554362,0,554362,417959,696598,"IRQ",557279
1,103.0,"United States of America",2936860,2896256,40604,2234649,3724416,"USA",2979533
1,103.0,"Western Europe",3445085,3371585,73500,2622333,4370555,"NLD",3496444
1,103.0,"Russian Federation",2958549,2751240,207309,2253341,3755568,"RUS",3004455
1,103.0,"Northern Africa",1098919,0,1098919,836379,1393965,"EGY",1115172
1,103.0,"Eastern Asia",887807,0,887807,676590,1127650,"JPN",902120
1,103.0,"Western Africa",270316,0,270316,205152,341920,"NGA",273536
1,103.0,"Southern Europe",707802,0,707802,534516,890860,"ITA",712688
1,104.0,"Northern America",704971,704971,0,537508,895847,"CAN",716678
1,104.0,"Southern Asia",823134,0,823134,621149,1035248,"IRN",828199
1,104.0,"South America",1827716,1521539,306177,1381279,2302132,"BRA",1841706
1,104.0,"Central Asia",1128221,1059077,69144,851304,1418841,"UZB",1135073
1,104.0,"South-Eastern Asia",663885,0,663885,502791,837985,"IDN",670388
1,104.0,"Pakistan",1728194,1432945,295249,1343872,2239787,"PAK",1791830
1,104.0,"Southern Africa",50800,0,50800,39159,65265,"ZAF",52212
1,104.0,"Northern Europe",1937134,1899660,37474,1513668,2522780,"GBR",2018224
1,104.0,"Oceania",450961,450961,0,340412,567353,"NZL",453883
1,104.0,"Central America",471937,0,471937,357577,595962,"MEX",476770
1,104.0,"Eastern Africa",166494,0,166494,126057,210096,"ETH",168077
1,104.0,"China",9463005,9221518,241487,7335534,12225891,"CPR",9780713
1,104.0,"Eastern Europe",3252411,3110915,141496,2514905,4191508,"POL",3353207
1,104.0,"India",5806073,5681708,124365,4492856,7488093,"IND",5990475
1,104.0,"Middle Africa",72241,0,72241,54690,91151,"AGO",72921
1,104.0,"Western Asia",554786,0,554786,417959,696598,"IRQ",557279
1,104.0,"United States of America",2943973,2900136,43837,2234649,3724416,"USA",2979533
1,104.0,"Western Europe",3467095,3382247,84848,2622333,4370555,"NLD",3496444
1,104.0,"Russian Federation",2973908,2775304,198604,2253341,3755568,"RUS",3004455
1,104.0,"Northern Africa",1101275,0,1101275,836379,1393965,"EGY",1115172
1,104.0,"Eastern Asia",889880,0,889880,676590,1127650,"JPN",902120
1,104.0,"Western Africa",270780,0,270780,205152,341920,"NGA",273536
1,104.0,"Southern Europe",708387,0,708387,534516,890860,"ITA",712688
1,105.0,"Northern America",667897,667897,0,537508,895847,"CAN",716678
1,105.0,"Southern Asia",820838,0,820838,621149,1035248,"IRN",828199
1,105.0,"South America",1816559,1522075,294484,1381279,2302132,"BRA",1841706
1,105.0,"Central Asia",1137370,1068158,69212,851304,1418841,"UZB",1135073
1,105.0,"South-Eastern Asia",660578,0,660578,502791,837985,"IDN",670388
1,105.0,"Pakistan",1741296,1434542,306754,1343872,2239787,"PAK",1791830
1,105.0,"Southern Africa",50164,0,50164,39159,65265,"ZAF",52212
1,105.0,"Northern Europe",1953351,1908561,44790,1513668,2522780,"GBR",2018224
1,105.0,"Oceania",449012,449012,0,340412,567353,"NZL",453883
1,105.0,"Central America",469750,0,469750,357577,595962,"MEX",476770
1,105.0,"Eastern Africa",165776,0,165776,126057,210096,"ETH",168077
1,105.0,"China",9545885,9276456,269429,7335534,12225891,"CPR",9780713
1,105.0,"Eastern Europe",3200491,3059811,140680,2514905,4191508,"POL",3353207
1,105.0,"India",5829984,5685919,144065,4492856,7488093,"IND",5990475
1,105.0,"Middle Africa",72091,0,72091,54690,91151,"AGO",72921
1,105.0,"Western Asia",553657,0,553657,417959,696598,"IRQ",557279
1,105.0,"United States of America",2901300,2854495,46805,2234649,3724416,"USA",2979533
1,105.0,"Western Europe",3599158,3503270,95888,2622333,4370555,"NLD",3496444
1,105.0,"Russian Federation",2439168,2257620,181548,2253341,3755568,"RUS",3004455
1,105.0,"Northern Africa",1094977,0,1094977,836379,1393965,"EGY",1115172
1,105.0,"Eastern Asia",884333,0,884333,676590,1127650,"JPN",902120
1,105.0,"Western Africa",269533,0,269533,205152,341920,"NGA",273536
1,105.0,"Southern Europe",706542,0,706542,534516,890860,"ITA",712688
1,106.0,"Northern America",687409,687409,0,537508,895847,"CAN",716678
1,106.0,"Southern Asia",822898,0,822898,621149,1035248,"IRN",828199
1,106.0,"South America",1842677,1554506,288171,1381279,2302132,"BRA",1841706
1,106.0,"Central Asia",1246693,1176728,69965,851304,1418841,"UZB",1135073
1,106.0,"South-Eastern Asia",663160,0,663160,502791,837985,"IDN",670388
1,106.0,"Pakistan",1755301,1437491,317810,1343872,2239787,"PAK",1791830
1,106.0,"Southern Africa",50642,0,50642,39159,65265,"ZAF",52212
1,106.0,"Northern Europe",1989842,1937852,51990,1513668,2522780,"GBR",2018224
1,106.0,"Oceania",455831,455831,0,340412,567353,"NZL",453883
1,106.0,"Central America",471720,0,471720,357577,595962,"MEX",476770
1,106.0,"Eastern Africa",166418,0,166418,126057,210096,"ETH",168077
1,106.0,"China",9578241,9273696,304545,7335534,12225891,"CPR",9780713
1,106.0,"Eastern Europe",3132059,2992013,140046,2514905,4191508,"POL",3353207
1,106.0,"India",5843575,5678650,164925,4492856,7488093,"IND",5990475
1,106.0,"Middle Africa",72281,0,72281,54690,91151,"AGO",72921
1,106.0,"Western Asia",554671,0,554671,417959,696598,"IRQ",557279
1,106.0,"United States of America",2908412,2869844,38568,2234649,3724416,"USA",2979533
1,106.0,"Western Europe",3555140,3461184,93956,2622333,4370555,"NLD",3496444
1,106.0,"Russian Federation",2453816,2247971,205845,2253341,3755568,"RUS",3004455
1,106.0,"Northern Africa",1100634,0,1100634,836379,1393965,"EGY",1115172
1,106.0,"Eastern Asia",889524,0,889524,676590,1127650,"JPN",902120
1,106.0,"Western Africa",270654,0,270654,205152,341920,"NGA",273536
1,106.0,"Southern Europe",707676,0,707676,534516,890860,"ITA",712688
1,107.0,"Northern America",695215,695215,0,537511,895852,"CAN",716682
1,107.0,"Southern Asia",822466,0,822466,621153,1035256,"IRN",828205
1,107.0,"South America",1820372,1542942,277430,1381283,2302138,"BRA",1841711
1,107.0,"Central Asia",1182086,1121322,60764,851310,1418851,"UZB",1135081
1,107.0,"South-Eastern Asia",662418,0,662418,502798,837997,"IDN",670398
1,107.0,"Pakistan",1767147,1441071,326076,1343877,2239795,"PAK",1791836
1,107.0,"Southern Africa",50710,0,50710,39166,65277,"ZAF",52222
1,107.0,"Northern Europe",2010114,1951511,58603,1513671,2522786,"GBR",2018229
1,107.0,"Oceania",449013,449013,0,340416,567360,"NZL",453888
1,107.0,"Central America",471301,0,471301,357585,595976,"MEX",476781
1,107.0,"Eastern Africa",166282,0,166282,126063,210106,"ETH",168085
1,107.0,"China",9573916,9269432,304484,7335534,12225891,"CPR",9780713
1,107.0,"Eastern Europe",3111645,2969670,141975,2514906,4191511,"POL",3353209
1,107.0,"India",5867502,5682144,185358,4492857,7488095,"IND",5990476
1,107.0,"Middle Africa",72229,0,72229,54692,91153,"AGO",72923
1,107.0,"Western Asia",554460,0,554460,417960,696600,"IRQ",557280
1,107.0,"United States of America",2922637,2891530,31107,2234650,3724417,"USA",2979534
1,107.0,"Western Europe",3511119,3427367,83752,2622336,4370561,"NLD",3496449
1,107.0,"Russian Federation",2544387,2290026,254361,2253345,3755576,"RUS",3004461
1,107.0,"Northern Africa",1099439,0,1099439,836382,1393971,"EGY",1115177
1,107.0,"Eastern Asia",888255,0,888255,676596,1127661,"JPN",902129
1,107.0,"Western Africa",270416,0,270416,205159,341932,"NGA",273546
1,107.0,"Southern Europe",707984,0,707984,534518,890863,"ITA",712691
1,108.0,"Northern America",701067,700021,1046,431936,719893,"CAN",575915
1,108.0,"Southern Asia",822868,0,822868,578572,964287,"IRN",771430
1,108.0,"South America",1830060,1559338,270722,1222872,2038120,"BRA",1630496
1,108.0,"Central Asia",1102748,1048008,54740,791430,1319050,"UZB",1055240
1,108.0,"South-Eastern Asia",662983,0,662983,541857,903095,"IDN",722476
1,108.0,"Pakistan",1776841,1444008,332833,1223474,2039123,"PAK",1631299
1,108.0,"Southern Africa",50728,0,50728,45507,75845,"ZAF",60676
1,108.0,"Northern Europe",2010113,1951352,58761,1385539,2309232,"GBR",1847386
1,108.0,"Oceania",451934,451934,0,308911,514852,"NZL",411882
1,108.0,"Central America",471686,0,471686,314858,524763,"MEX",419811
1,108.0,"Eastern Africa",166411,0,166411,161103,268505,"ETH",214804
1,108.0,"China",9567815,9269291,298524,6498409,10830682,"CPR",8664546
1,108.0,"Eastern Europe",3141968,2980281,161687,2152313,3587188,"POL",2869751
1,108.0,"India",5892174,5686429,205745,4267422,7112371,"IND",5689897
1,108.0,"Middle Africa",72276,0,72276,55424,92373,"AGO",73899
1,108.0,"Western Asia",554657,0,554657,407164,678607,"IRQ",542886
1,108.0,"United States of America",2929748,2905718,24030,2054424,3424041,"USA",2739233
1,108.0,"Western Europe",3481771,3405828,75943,2587444,4312407,"NLD",3449926
1,108.0,"Russian Federation",2633774,2336894,296880,2113923,3523206,"RUS",2818565
1,108.0,"Northern Africa",1100558,0,1100558,916770,1527950,"EGY",1222360
1,108.0,"Eastern Asia",889228,0,889228,573415,955692,"JPN",764554
1,108.0,"Western Africa",270635,0,270635,224116,373527,"NGA",298822
1,108.0,"Southern Europe",708059,0,708059,437342,728903,"ITA",583123
1,109.0,"Northern America",706924,704752,2172,431936,719893,"CAN",575915
1,109.0,"Southern Asia",822990,0,822990,578572,964287,"IRN",771430
1,109.0,"South America",1549710,1286882,262828,1222872,2038120,"BRA",1630496
1,109.0,"Central Asia",1034171,981546,52625,791430,1319050,"UZB",1055240
1,109.0,"South-Eastern Asia",663183,0,663183,541857,903095,"IDN",722476
1,109.0,"Pakistan",1783453,1445498,337955,1223474,2039123,"PAK",1631299
1,109.0,"Southern Africa",50771,0,50771,45507,75845,"ZAF",60676
1,109.0,"Northern Europe",2006062,1947143,58919,1385539,2309232,"GBR",1847386
1,109.0,"Oceania",453888,453888,0,308911,514852,"NZL",411882
1,109.0,"Central America",471809,0,471809,314858,524763,"MEX",419811
1,109.0,"Eastern Africa",166454,0,166454,161103,268505,"ETH",214804
1,109.0,"China",9575607,9274966,300641,6498409,10830682,"CPR",8664546
1,109.0,"Eastern Europe",3158031,2979937,178094,2152313,3587188,"POL",2869751
1,109.0,"India",5892537,5684756,207781,4267422,7112371,"IND",5689897
1,109.0,"Middle Africa",72240,0,72240,55424,92373,"AGO",73899
1,109.0,"Western Asia",554716,0,554716,407164,678607,"IRQ",542886
1,109.0,"United States of America",2929749,2911216,18533,2054424,3424041,"USA",2739233
1,109.0,"Western Europe",3459764,3392308,67456,2587444,4312407,"NLD",3449926
1,109.0,"Russian Federation",2722889,2390561,332328,2113923,3523206,"RUS",2818565
1,109.0,"Northern Africa",1100873,0,1100873,916770,1527950,"EGY",1222360
1,109.0,"Eastern Asia",889573,0,889573,573415,955692,"JPN",764554
1,109.0,"Western Africa",270710,0,270710,224116,373527,"NGA",298822
1,109.0,"Southern Europe",707971,0,707971,437342,728903,"ITA",583123
1,110.0,"Northern America",636404,636010,394,431936,719893,"CAN",575915
1,110.0,"Southern Asia",786062,0,786062,578572,964287,"IRN",771430
1,110.0,"South America",1580635,1290953,289682,1222872,2038120,"BRA",1630496
1,110.0,"Central Asia",1035270,984923,50347,791430,1319050,"UZB",1055240
1,110.0,"South-Eastern Asia",741400,0,741400,541857,903095,"IDN",722476
1,110.0,"Pakistan",1768661,1446057,322604,1223474,2039123,"PAK",1631299
1,110.0,"Southern Africa",64736,0,64736,45507,75845,"ZAF",60676
1,110.0,"Northern Europe",1997405,1941614,55791,1385539,2309232,"GBR",1847386
1,110.0,"Oceania",407986,407986,0,308911,514852,"NZL",411882
1,110.0,"Central America",433768,0,433768,314858,524763,"MEX",419811
1,110.0,"Eastern Africa",219364,0,219364,161103,268505,"ETH",214804
1,110.0,"China",9556973,9283252,273721,6498409,10830682,"CPR",8664546
1,110.0,"Eastern Europe",3213001,3038436,174565,2152313,3587188,"POL",2869751
1,110.0,"India",5885569,5682247,203322,4267422,7112371,"IND",5689897
1,110.0,"Middle Africa",75648,0,75648,55424,92373,"AGO",73899
1,110.0,"Western Asia",550082,0,550082,407164,678607,"IRQ",542886
1,110.0,"United States of America",2867250,2857372,9878,2054424,3424041,"USA",2739233
1,110.0,"Western Europe",3457264,3400270,56994,2587444,4312407,"NLD",3449926
1,110.0,"Russian Federation",2814501,2441311,373190,2113923,3523206,"RUS",2818565
1,110.0,"Northern Africa",1262508,0,1262508,916770,1527950,"EGY",1222360
1,110.0,"Eastern Asia",799696,0,799696,573415,955692,"JPN",764554
1,110.0,"Western Africa",306865,0,306865,224116,373527,"NGA",298822
1,110.0,"Southern Europe",598413,0,598413,437342,728903,"ITA",583123
1,111.0,"Northern America",609086,609086,0,431936,719893,"CAN",575915
1,111.0,"Southern Asia",782488,0,782488,578572,964287,"IRN",771430
1,111.0,"South America",1608735,1294109,314626,1222872,2038120,"BRA",1630496
1,111.0,"Central Asia",1038534,989900,48634,791430,1319050,"UZB",1055240
1,111.0,"South-Eastern Asia",737539,0,737539,541857,903095,"IDN",722476
1,111.0,"Pakistan",1754731,1446518,308213,1223474,2039123,"PAK",1631299
1,111.0,"Southern Africa",63748,0,63748,45507,75845,"ZAF",60676
1,111.0,"Northern Europe",1981188,1933602,47586,1385539,2309232,"GBR",1847386
1,111.0,"Oceania",411882,411882,0,308911,514852,"NZL",411882
1,111.0,"Central America",430264,0,430264,314858,524763,"MEX",419811
1,111.0,"Eastern Africa",218258,0,218258,161103,268505,"ETH",214804
1,111.0,"China",9517117,9280556,236561,6498409,10830682,"CPR",8664546
1,111.0,"Eastern Europe",3264372,3095541,168831,2152313,3587188,"POL",2869751
1,111.0,"India",5885766,5686497,199269,4267422,7112371,"IND",5689897
1,111.0,"Middle Africa",75229,0,75229,55424,92373,"AGO",73899
1,111.0,"Western Asia",548325,0,548325,407164,678607,"IRQ",542886
1,111.0,"United States of America",2838801,2828421,10380,2054424,3424041,"USA",2739233
1,111.0,"Western Europe",3479275,3432698,46577,2587444,4312407,"NLD",3449926
1,111.0,"Russian Federation",2873126,2471096,402030,2113923,3523206,"RUS",2818565
1,111.0,"Northern Africa",1252705,0,1252705,916770,1527950,"EGY",1222360
1,111.0,"Eastern Asia",791281,0,791281,573415,955692,"JPN",764554
1,111.0,"Western Africa",304833,0,304833,224116,373527,"NGA",298822
1,111.0,"Southern Europe",593215,0,593215,437342,728903,"ITA",583123
1,112.0,"Northern America",597379,597379,0,431936,719893,"CAN",575915
1,112.0,"Southern Asia",781761,0,781761,578572,964287,"IRN",771430
1,112.0,"South America",1630844,1297138,333706,1222872,2038120,"BRA",1630496
1,112.0,"Central Asia",1095229,1044196,51033,791430,1319050,"UZB",1055240
1,112.0,"South-Eastern Asia",736872,0,736872,541857,903095,"IDN",722476
1,112.0,"Pakistan",1745056,1449306,295750,1223474,2039123,"PAK",1631299
1,112.0,"Southern Africa",63549,0,63549,45507,75845,"ZAF",60676
1,112.0,"Northern Europe",1940643,1900697,39946,1385539,2309232,"GBR",1847386
1,112.0,"Oceania",419675,419675,0,308911,514852,"NZL",411882
1,112.0,"Central America",429757,0,429757,314858,524763,"MEX",419811
1,112.0,"Eastern Africa",218032,0,218032,161103,268505,"ETH",214804
1,112.0,"China",9478155,9279615,198540,6498409,10830682,"CPR",8664546
1,112.0,"Eastern Europe",3193799,3047111,146688,2152313,3587188,"POL",2869751
1,112.0,"India",6469161,6272656,196505,4267422,7112371,"IND",5689897
1,112.0,"Middle Africa",75143,0,75143,55424,92373,"AGO",73899
1,112.0,"Western Asia",547971,0,547971,407164,678607,"IRQ",542886
1,112.0,"United States of America",2824577,2813044,11533,2054424,3424041,"USA",2739233
1,112.0,"Western Europe",3501285,3453880,47405,2587444,4312407,"NLD",3449926
1,112.0,"Russian Federation",2923766,2500780,422986,2113923,3523206,"RUS",2818565
1,112.0,"Northern Africa",1250713,0,1250713,916770,1527950,"EGY",1222360
1,112.0,"Eastern Asia",789524,0,789524,573415,955692,"JPN",764554
1,112.0,"Western Africa",304439,0,304439,224116,373527,"NGA",298822
1,112.0,"Southern Europe",591712,0,591712,437342,728903,"ITA",583123
1,113.0,"Northern America",579817,579817,0,431936,719893,"CAN",575915
1,113.0,"Southern Asia",777774,0,777774,578572,964287,"IRN",771430
1,113.0,"South America",1643238,1298485,344753,1222872,2038120,"BRA",1630496
1,113.0,"Central Asia",1120265,1070602,49663,791430,1319050,"UZB",1055240
1,113.0,"South-Eastern Asia",731316,0,731316,541857,903095,"IDN",722476
1,113.0,"Pakistan",1729492,1447664,281828,1223474,2039123,"PAK",1631299
1,113.0,"Southern Africa",62391,0,62391,45507,75845,"ZAF",60676
1,113.0,"Northern Europe",1823059,1789915,33144,1385539,2309232,"GBR",1847386
1,113.0,"Oceania",404089,404089,0,308911,514852,"NZL",411882
1,113.0,"Central America",426314,0,426314,314858,524763,"MEX",419811
1,113.0,"Eastern Africa",216788,0,216788,161103,268505,"ETH",214804
1,113.0,"China",8880856,8723425,157431,6498409,10830682,"CPR",8664546
1,113.0,"Eastern Europe",2818671,2692037,126634,2152313,3587188,"POL",2869751
1,113.0,"India",6459945,6280846,179099,4267422,7112371,"IND",5689897
1,113.0,"Middle Africa",74666,0,74666,55424,92373,"AGO",73899
1,113.0,"Western Asia",546007,0,546007,407164,678607,"IRQ",542886
1,113.0,"United States of America",2817466,2804971,12495,2054424,3424041,"USA",2739233
1,113.0,"Western Europe",3523296,3466148,57148,2587444,4312407,"NLD",3449926
1,113.0,"Russian Federation",2959864,2528935,430929,2113923,3523206,"RUS",2818565
1,113.0,"Northern Africa",1239769,0,1239769,916770,1527950,"EGY",1222360
1,113.0,"Eastern Asia",779887,0,779887,573415,955692,"JPN",764554
1,113.0,"Western Africa",302271,0,302271,224116,373527,"NGA",298822
1,113.0,"Southern Europe",589687,0,589687,437342,728903,"ITA",583123
1,114.0,"Northern America",566160,566160,0,431936,719893,"CAN",575915
1,114.0,"Southern Asia",773358,0,773358,578572,964287,"IRN",771430
1,114.0,"South America",1648684,1299576,349108,1222872,2038120,"BRA",1630496
1,114.0,"Central Asia",1101945,1054324,47621,791430,1319050,"UZB",1055240
1,114.0,"South-Eastern Asia",725161,0,725161,541857,903095,"IDN",722476
1,114.0,"Pakistan",1917606,1647074,270532,1223474,2039123,"PAK",1631299
1,114.0,"Southern Africa",61216,0,61216,45507,75845,"ZAF",60676
1,114.0,"Northern Europe",1827113,1799238,27875,1385539,2309232,"GBR",1847386
1,114.0,"Oceania",407011,407011,0,308911,514852,"NZL",411882
1,114.0,"Central America",422341,0,422341,314858,524763,"MEX",419811
1,114.0,"Eastern Africa",215410,0,215410,161103,268505,"ETH",214804
1,114.0,"China",8559209,8432143,127066,6498409,10830682,"CPR",8664546
1,114.0,"Eastern Europe",2831053,2707304,123749,2152313,3587188,"POL",2869751
1,114.0,"India",6327160,6164578,162582,4267422,7112371,"IND",5689897
1,114.0,"Middle Africa",74134,0,74134,55424,92373,"AGO",73899
1,114.0,"Western Asia",543836,0,543836,407164,678607,"IRQ",542886
1,114.0,"United States of America",2760570,2756376,4194,2054424,3424041,"USA",2739233
1,114.0,"Western Europe",3523295,3456821,66474,2587444,4312407,"NLD",3449926
1,114.0,"Russian Federation",2986523,2559909,426614,2113923,3523206,"RUS",2818565
1,114.0,"Northern Africa",1227644,0,1227644,916770,1527950,"EGY",1222360
1,114.0,"Eastern Asia",769207,0,769207,573415,955692,"JPN",764554
1,114.0,"Western Africa",299871,0,299871,224116,373527,"NGA",298822
1,114.0,"Southern Europe",585425,0,585425,437342,728903,"ITA",583123
1,115.0,"Northern America",581769,581769,0,431936,719893,"CAN",575915
1,115.0,"Southern Asia",775883,0,775883,578572,964287,"IRN",771430
1,115.0,"South America",1657684,1302811,354873,1222872,2038120,"BRA",1630496
1,115.0,"Central Asia",1065759,1022206,43553,791430,1319050,"UZB",1055240
1,115.0,"South-Eastern Asia",728679,0,728679,541857,903095,"IDN",722476
1,115.0,"Pakistan",1648572,1418689,229883,1223474,2039123,"PAK",1631299
1,115.0,"Southern Africa",61968,0,61968,45507,75845,"ZAF",60676
1,115.0,"Northern Europe",1859548,1837033,22515,1385539,2309232,"GBR",1847386
1,115.0,"Oceania",414804,414804,0,308911,514852,"NZL",411882
1,115.0,"Central America",423815,0,423815,314858,524763,"MEX",419811
1,115.0,"Eastern Africa",216198,0,216198,161103,268505,"ETH",214804
1,115.0,"China",8733808,8625247,108561,6498409,10830682,"CPR",8664546
1,115.0,"Eastern Europe",2896217,2776079,120138,2152313,3587188,"POL",2869751
1,115.0,"India",5732336,5598638,133698,4267422,7112371,"IND",5689897
1,115.0,"Middle Africa",74384,0,74384,55424,92373,"AGO",73899
1,115.0,"Western Asia",545077,0,545077,407164,678607,"IRQ",542886
1,115.0,"United States of America",2760569,2760569,0,2054424,3424041,"USA",2739233
1,115.0,"Western Europe",3515960,3447371,68589,2587444,4312407,"NLD",3449926
1,115.0,"Russian Federation",2999738,2576173,423565,2113923,3523206,"RUS",2818565
1,115.0,"Northern Africa",1234577,0,1234577,916770,1527950,"EGY",1222360
1,115.0,"Eastern Asia",775315,0,775315,573415,955692,"JPN",764554
1,115.0,"Western Africa",301243,0,301243,224116,373527,"NGA",298822
1,115.0,"Southern Europe",586838,0,586838,437342,728903,"ITA",583123
1,116.0,"Northern America",572012,572012,0,431936,719893,"CAN",575915
1,116.0,"Southern Asia",770173,0,770173,578572,964287,"IRN",771430
1,116.0,"South America",1655339,1302084,353255,1222872,2038120,"BRA",1630496
1,116.0,"Central Asia",1050091,1010000,40091,791430,1319050,"UZB",1055240
1,116.0,"South-Eastern Asia",720720,0,720720,541857,903095,"IDN",722476
1,116.0,"Pakistan",1625550,1402590,222960,1223474,2039123,"PAK",1631299
1,116.0,"Southern Africa",60330,0,60330,45507,75845,"ZAF",60676
1,116.0,"Northern Europe",1839278,1822387,16891,1385539,2309232,"GBR",1847386
1,116.0,"Oceania",409933,409933,0,308911,514852,"NZL",411882
1,116.0,"Central America",418855,0,418855,314858,524763,"MEX",419811
1,116.0,"Eastern Africa",214415,0,214415,161103,268505,"ETH",214804
1,116.0,"China",8622730,8540616,82114,6498409,10830682,"CPR",8664546
1,116.0,"Eastern Europe",2497869,2387098,110771,2152313,3587188,"POL",2869751
1,116.0,"India",5665878,5550111,115767,4267422,7112371,"IND",5689897
1,116.0,"Middle Africa",73752,0,73752,55424,92373,"AGO",73899
1,116.0,"Western Asia",542268,0,542268,407164,678607,"IRQ",542886
1,116.0,"United States of America",2725009,2725009,0,2054424,3424041,"USA",2739233
1,116.0,"Western Europe",3457265,3399034,58231,2587444,4312407,"NLD",3449926
1,116.0,"Russian Federation",2989434,2581010,408424,2113923,3523206,"RUS",2818565
1,116.0,"Northern Africa",1218894,0,1218894,916770,1527950,"EGY",1222360
1,116.0,"Eastern Asia",761508,0,761508,573415,955692,"JPN",764554
1,116.0,"Western Africa",298139,0,298139,224116,373527,"NGA",298822
1,116.0,"Southern Europe",582246,0,582246,437342,728903,"ITA",583123
1,117.0,"Northern America",564208,564208,0,431936,719893,"CAN",575915
1,117.0,"Southern Asia",765448,0,765448,578572,964287,"IRN",771430
1,117.0,"South America",1650712,1303294,347418,1222872,2038120,"BRA",1630496
1,117.0,"Central Asia",1038388,1001387,37001,791430,1319050,"UZB",1055240
1,117.0,"South-Eastern Asia",714143,0,714143,541857,903095,"IDN",722476
1,117.0,"Pakistan",1610555,1393452,217103,1223474,2039123,"PAK",1631299
1,117.0,"Southern Africa",59011,0,59011,45507,75845,"ZAF",60676
1,117.0,"Northern Europe",1823058,1811672,11386,1385539,2309232,"GBR",1847386
1,117.0,"Oceania",406038,406038,0,308911,514852,"NZL",411882
1,117.0,"Central America",414702,0,414702,314858,524763,"MEX",419811
1,117.0,"Eastern Africa",212933,0,212933,161103,268505,"ETH",214804
1,117.0,"China",8531807,8475498,56309,6498409,10830682,"CPR",8664546
1,117.0,"Eastern Europe",2587889,2455279,132610,2152313,3587188,"POL",2869751
1,117.0,"India",5616442,5517868,98574,4267422,7112371,"IND",5689897
1,117.0,"Middle Africa",73180,0,73180,55424,92373,"AGO",73899
1,117.0,"Western Asia",539942,0,539942,407164,678607,"IRQ",542886
1,117.0,"United States of America",2696561,2696561,0,2054424,3424041,"USA",2739233
1,117.0,"Western Europe",3405907,3357883,48024,2587444,4312407,"NLD",3449926
1,117.0,"Russian Federation",3266615,2880870,385745,2113923,3523206,"RUS",2818565
1,117.0,"Northern Africa",1205947,0,1205947,916770,1527950,"EGY",1222360
1,117.0,"Eastern Asia",750099,0,750099,573415,955692,"JPN",764554
1,117.0,"Western Africa",295569,0,295569,224116,373527,"NGA",298822
1,117.0,"Southern Europe",578356,0,578356,437342,728903,"ITA",583123
1,118.0,"Northern America",579817,579817,0,431936,719893,"CAN",575915
1,118.0,"Southern Asia",773417,0,773417,578572,964287,"IRN",771430
1,118.0,"South America",1652013,1301743,350270,1222872,2038120,"BRA",1630496
1,118.0,"Central Asia",1060149,1025914,34235,791430,1319050,"UZB",1055240
1,118.0,"South-Eastern Asia",725250,0,725250,541857,903095,"IDN",722476
1,118.0,"Pakistan",1637505,1422378,215127,1223474,2039123,"PAK",1631299
1,118.0,"Southern Africa",61224,0,61224,45507,75845,"ZAF",60676
1,118.0,"Northern Europe",1855494,1849593,5901,1385539,2309232,"GBR",1847386
1,118.0,"Oceania",413830,413830,0,308911,514852,"NZL",411882
1,118.0,"Central America",421365,0,421365,314858,524763,"MEX",419811
1,118.0,"Eastern Africa",215422,0,215422,161103,268505,"ETH",214804
1,118.0,"China",8704512,8673875,30637,6498409,10830682,"CPR",8664546
1,118.0,"Eastern Europe",2691248,2536892,154356,2152313,3587188,"POL",2869751
1,118.0,"India",5713634,5631074,82560,4267422,7112371,"IND",5689897
1,118.0,"Middle Africa",74132,0,74132,55424,92373,"AGO",73899
1,118.0,"Western Asia",543860,0,543860,407164,678607,"IRQ",542886
1,118.0,"United States of America",2753457,2753457,0,2054424,3424041,"USA",2739233
1,118.0,"Western Europe",3464597,3426345,38252,2587444,4312407,"NLD",3449926
1,118.0,"Russian Federation",3220394,2884424,335970,2113923,3523206,"RUS",2818565
1,118.0,"Northern Africa",1227827,0,1227827,916770,1527950,"EGY",1222360
1,118.0,"Eastern Asia",769365,0,769365,573415,955692,"JPN",764554
1,118.0,"Western Africa",299902,0,299902,224116,373527,"NGA",298822
1,118.0,"Southern Europe",584636,0,584636,437342,728903,"ITA",583123
1,119.0,"Northern America",572013,572013,0,431940,719901,"CAN",575921
1,119.0,"Southern Asia",769442,0,769442,578574,964290,"IRN",771432
1,119.0,"South America",1651269,1302450,348819,1222874,2038123,"BRA",1630499
1,119.0,"Central Asia",1049877,1018925,30952,791434,1319057,"UZB",1055246
1,119.0,"South-Eastern Asia",719701,0,719701,541859,903098,"IDN",722479
1,119.0,"Pakistan",1624642,1415646,208996,1223475,2039126,"PAK",1631301
1,119.0,"Southern Africa",60129,0,60129,45510,75850,"ZAF",60680
1,119.0,"Northern Europe",1839278,1838920,358,1385542,2309237,"GBR",1847390
1,119.0,"Oceania",409934,409934,0,308916,514860,"NZL",411888
1,119.0,"Central America",418161,0,418161,314858,524763,"MEX",419811
1,119.0,"Eastern Africa",214184,0,214184,161103,268505,"ETH",214804
1,119.0,"China",8621874,8617244,4630,6498409,10830682,"CPR",8664546
1,119.0,"Eastern Europe",2782166,2611868,170298,2152317,3587195,"POL",2869756
1,119.0,"India",5665706,5600608,65098,4267428,7112381,"IND",5689905
1,119.0,"Middle Africa",73666,0,73666,55425,92375,"AGO",73900
1,119.0,"Western Asia",541911,0,541911,407172,678620,"IRQ",542896
1,119.0,"United States of America",2725009,2725009,0,2054425,3424042,"USA",2739234
1,119.0,"Western Europe",3435254,3407222,28032,2587447,4312412,"NLD",3449930
1,119.0,"Russian Federation",3156068,2868093,287975,2113927,3523212,"RUS",2818570
1,119.0,"Northern Africa",1216893,0,1216893,916774,1527957,"EGY",1222366
1,119.0,"Eastern Asia",759741,0,759741,573418,955697,"JPN",764558
1,119.0,"Western Africa",297742,0,297742,224117,373528,"NGA",298823
1,119.0,"Southern Europe",581563,0,581563,437343,728905,"ITA",583124
1,120.0,"Northern America",603232,603232,0,460564,767607,"CAN",614086
1,120.0,"Southern Asia",785374,0,785374,674532,1124220,"IRN",899376
1,120.0,"South America",1667097,1303792,363305,1409269,2348782,"BRA",1879026
1,120.0,"Central Asia",1094900,1065889,29011,873583,1455972,"UZB",1164778
1,120.0,"South-Eastern Asia",741914,0,741914,546042,910070,"IDN",728056
1,120.0,"Pakistan",1680182,1470425,209757,1230260,2050433,"PAK",1640347
1,120.0,"Southern Africa",64545,0,64545,2436,4061,"ZAF",3249
1,120.0,"Northern Europe",1904148,1904148,0,1476412,2460687,"GBR",1968550
1,120.0,"Oceania",425519,425519,0,344616,574360,"NZL",459488
1,120.0,"Central America",431620,0,431620,389967,649946,"MEX",519957
1,120.0,"Eastern Africa",219156,0,219156,169678,282797,"ETH",226238
1,120.0,"China",8978680,8970179,8501,6970407,11617346,"CPR",9293877
1,120.0,"Eastern Europe",2852558,2659587,192971,2561281,4268802,"POL",3415042
1,120.0,"India",5860545,5811235,49310,4457332,7428887,"IND",5943110
1,120.0,"Middle Africa",75568,0,75568,58010,96683,"AGO",77347
1,120.0,"Western Asia",549742,0,549742,289647,482746,"IRQ",386197
1,120.0,"United States of America",2838801,2838801,0,1997673,3329456,"USA",2663565
1,120.0,"Western Europe",3552641,3531728,20913,2911403,4852338,"NLD",3881871
1,120.0,"Russian Federation",2962795,2699867,262928,2875160,4791933,"RUS",3833547
1,120.0,"Northern Africa",1260650,0,1260650,896427,1494046,"EGY",1195237
1,120.0,"Eastern Asia",798275,0,798275,622203,1037005,"JPN",829604
1,120.0,"Western Africa",306400,0,306400,238461,397436,"NGA",317949
1,120.0,"Southern Europe",594188,0,594188,624480,1040801,"ITA",832641
1,121.0,"Northern America",573970,573970,0,460564,767607,"CAN",614086
1,121.0,"Southern Asia",770440,0,770440,674532,1124220,"IRN",899376
1,121.0,"South America",1854454,1493943,360511,1409269,2348782,"BRA",1879026
1,121.0,"Central Asia",1053483,1029122,24361,873583,1455972,"UZB",1164778
1,121.0,"South-Eastern Asia",721094,0,721094,546042,910070,"IDN",728056
1,121.0,"Pakistan",1628665,1430111,198554,1230260,2050433,"PAK",1640347
1,121.0,"Southern Africa",60408,0,60408,2436,4061,"ZAF",3249
1,121.0,"Northern Europe",1843336,1843336,0,1476412,2460687,"GBR",1968550
1,121.0,"Oceania",410914,410914,0,344616,574360,"NZL",459488
1,121.0,"Central America",419284,0,419284,389967,649946,"MEX",519957
1,121.0,"Eastern Africa",214497,0,214497,169678,282797,"ETH",226238
1,121.0,"China",8651578,8651578,0,6970407,11617346,"CPR",9293877
1,121.0,"Eastern Europe",2900785,2697582,203203,2561281,4268802,"POL",3415042
1,121.0,"India",5679599,5648806,30793,4457332,7428887,"IND",5943110
1,121.0,"Middle Africa",73787,0,73787,58010,96683,"AGO",77347
1,121.0,"Western Asia",542411,0,542411,289647,482746,"IRQ",386197
1,121.0,"United States of America",2732122,2732122,0,1997673,3329456,"USA",2663565
1,121.0,"Western Europe",3442594,3421929,20665,2911403,4852338,"NLD",3881871
1,121.0,"Russian Federation",2812332,2575052,237280,2875160,4791933,"RUS",3833547
1,121.0,"Northern Africa",1219635,0,1219635,896427,1494046,"EGY",1195237
1,121.0,"Eastern Asia",762152,0,762152,622203,1037005,"JPN",829604
1,121.0,"Western Africa",298286,0,298286,238461,397436,"NGA",317949
1,121.0,"Southern Europe",582498,0,582498,624480,1040801,"ITA",832641
1,122.0,"Northern America",608232,608232,0,460564,767607,"CAN",614086
1,122.0,"Southern Asia",890786,0,890786,674532,1124220,"IRN",899376
1,122.0,"South America",1860980,1509420,351560,1409269,2348782,"BRA",1879026
1,122.0,"Central Asia",1151895,1129801,22094,873583,1455972,"UZB",1164778
1,122.0,"South-Eastern Asia",716086,0,716086,546042,910070,"IDN",728056
1,122.0,"Pakistan",1624992,1435649,189343,1230260,2050433,"PAK",1640347
1,122.0,"Southern Africa",4699,0,4699,2436,4061,"ZAF",3249
1,122.0,"Northern Europe",1956386,1956386,0,1476412,2460687,"GBR",1968550
1,122.0,"Oceania",456566,456566,0,344616,574360,"NZL",459488
1,122.0,"Central America",511109,0,511109,389967,649946,"MEX",519957
1,122.0,"Eastern Africa",223553,0,223553,169678,282797,"ETH",226238
1,122.0,"China",9122135,9122135,0,6970407,11617346,"CPR",9293877
1,122.0,"Eastern Europe",2962695,2721010,241685,2561281,4268802,"POL",3415042
1,122.0,"India",5903921,5890508,13413,4457332,7428887,"IND",5943110
1,122.0,"Middle Africa",76307,0,76307,58010,96683,"AGO",77347
1,122.0,"Western Asia",381976,0,381976,289647,482746,"IRQ",386197
1,122.0,"United States of America",2642229,2642229,0,1997673,3329456,"USA",2663565
1,122.0,"Western Europe",3691111,3668217,22894,2911403,4852338,"NLD",3881871
1,122.0,"Russian Federation",3206514,2887138,319376,2875160,4791933,"RUS",3833547
1,122.0,"Northern Africa",1171667,0,1171667,896427,1494046,"EGY",1195237
1,122.0,"Eastern Asia",808841,0,808841,622203,1037005,"JPN",829604
1,122.0,"Western Africa",313279,0,313279,238461,397436,"NGA",317949
1,122.0,"Southern Europe",821562,0,821562,624480,1040801,"ITA",832641
1,123.0,"Northern America",623843,623843,0,460564,767607,"CAN",614086
1,123.0,"Southern Asia",897532,0,897532,674532,1124220,"IRN",899376
1,123.0,"South America",1894946,1545807,349139,1409269,2348782,"BRA",1879026
1,123.0,"Central Asia",1179785,1159369,20416,873583,1455972,"UZB",1164778
1,123.0,"South-Eastern Asia",725491,0,725491,546042,910070,"IDN",728056
1,123.0,"Pakistan",1653136,1469632,183504,1230260,2050433,"PAK",1640347
1,123.0,"Southern Africa",4553,0,4553,2436,4061,"ZAF",3249
1,123.0,"Northern Europe",1972605,1972605,0,1476412,2460687,"GBR",1968550
1,123.0,"Oceania",464359,464359,0,344616,574360,"NZL",459488
1,123.0,"Central America",518199,0,518199,389967,649946,"MEX",519957
1,123.0,"Eastern Africa",225659,0,225659,169678,282797,"ETH",226238
1,123.0,"China",9137480,9135544,1936,6970407,11617346,"CPR",9293877
1,123.0,"Eastern Europe",3039260,2751742,287518,2561281,4268802,"POL",3415042
1,123.0,"India",6003560,6003328,232,4457332,7428887,"IND",5943110
1,123.0,"Middle Africa",77129,0,77129,58010,96683,"AGO",77347
1,123.0,"Western Asia",385288,0,385288,289647,482746,"IRQ",386197
1,123.0,"United States of America",2692013,2692013,0,1997673,3329456,"USA",2663565
1,123.0,"Western Europe",3727795,3698090,29705,2911403,4852338,"NLD",3881871
1,123.0,"Russian Federation",3267511,2881074,386437,2875160,4791933,"RUS",3833547
1,123.0,"Northern Africa",1190185,0,1190185,896427,1494046,"EGY",1195237
1,123.0,"Eastern Asia",825153,0,825153,622203,1037005,"JPN",829604
1,123.0,"Western Africa",316946,0,316946,238461,397436,"NGA",317949
1,123.0,"Southern Europe",830350,0,830350,624480,1040801,"ITA",832641
1,124.0,"Northern America",610183,610183,0,460564,767607,"CAN",614086
1,124.0,"Southern Asia",894578,0,894578,674532,1124220,"IRN",899376
1,124.0,"South America",1871989,1532141,339848,1409269,2348782,"BRA",1879026
1,124.0,"Central Asia",1158928,1143042,15886,873583,1455972,"UZB",1164778
1,124.0,"South-Eastern Asia",721371,0,721371,546042,910070,"IDN",728056
1,124.0,"Pakistan",1630964,1457148,173816,1230260,2050433,"PAK",1640347
1,124.0,"Southern Africa",4225,0,4225,2436,4061,"ZAF",3249
1,124.0,"Northern Europe",1952332,1952332,0,1476412,2460687,"GBR",1968550
1,124.0,"Oceania",457539,457539,0,344616,574360,"NZL",459488
1,124.0,"Central America",515381,0,515381,389967,649946,"MEX",519957
1,124.0,"Eastern Africa",224738,0,224738,169678,282797,"ETH",226238
1,124.0,"China",9136003,9135368,635,6970407,11617346,"CPR",9293877
1,124.0,"Eastern Europe",3099712,2776657,323055,2561281,4268802,"POL",3415042
1,124.0,"India",5919498,5919498,0,4457332,7428887,"IND",5943110
1,124.0,"Middle Africa",76767,0,76767,58010,96683,"AGO",77347
1,124.0,"Western Asia",383835,0,383835,289647,482746,"IRQ",386197
1,124.0,"United States of America",2656453,2656453,0,1997673,3329456,"USA",2663565
1,124.0,"Western Europe",3771816,3729239,42577,2911403,4852338,"NLD",3881871
1,124.0,"Russian Federation",3331441,2884566,446875,2875160,4791933,"RUS",3833547
1,124.0,"Northern Africa",1182073,0,1182073,896427,1494046,"EGY",1195237
1,124.0,"Eastern Asia",818011,0,818011,622203,1037005,"JPN",829604
1,124.0,"Western Africa",315340,0,315340,238461,397436,"NGA",317949
1,124.0,"Southern Europe",828521,0,828521,624480,1040801,"ITA",832641
1,125.0,"Northern America",606281,606281,0,460564,767607,"CAN",614086
1,125.0,"Southern Asia",893550,0,893550,674532,1124220,"IRN",899376
1,125.0,"South America",1863207,1530404,332803,1409269,2348782,"BRA",1879026
1,125.0,"Central Asia",1152412,1141048,11364,873583,1455972,"UZB",1164778
1,125.0,"South-Eastern Asia",719944,0,719944,546042,910070,"IDN",728056
1,125.0,"Pakistan",1624483,1457609,166874,1230260,2050433,"PAK",1640347
1,125.0,"Southern Africa",3906,0,3906,2436,4061,"ZAF",3249
1,125.0,"Northern Europe",1928005,1928005,0,1476412,2460687,"GBR",1968550
1,125.0,"Oceania",455592,455592,0,344616,574360,"NZL",459488
1,125.0,"Central America",514402,0,514402,389967,649946,"MEX",519957
1,125.0,"Eastern Africa",224416,0,224416,169678,282797,"ETH",226238
1,125.0,"China",9135961,9130260,5701,6970407,11617346,"CPR",9293877
1,125.0,"Eastern Europe",3146835,2794511,352324,2561281,4268802,"POL",3415042
1,125.0,"India",5894351,5894351,0,4457332,7428887,"IND",5943110
1,125.0,"Middle Africa",76645,0,76645,58010,96683,"AGO",77347
1,125.0,"Western Asia",383332,0,383332,289647,482746,"IRQ",386197
1,125.0,"United States of America",2635117,2635117,0,1997673,3329456,"USA",2663565
1,125.0,"Western Europe",3801164,3745826,55338,2911403,4852338,"NLD",3881871
1,125.0,"Russian Federation",3390189,2884660,505529,2875160,4791933,"RUS",3833547
1,125.0,"Northern Africa",1179257,0,1179257,896427,1494046,"EGY",1195237
1,125.0,"Eastern Asia",815532,0,815532,622203,1037005,"JPN",829604
1,125.0,"Western Africa",314782,0,314782,238461,397436,"NGA",317949
1,125.0,"Southern Europe",827773,0,827773,624480,1040801,"ITA",832641
1,126.0,"Northern America",617989,617989,0,460564,767607,"CAN",614086
1,126.0,"Southern Asia",895923,0,895923,674532,1124220,"IRN",899376
1,126.0,"South America",1883965,1555333,328632,1409269,2348782,"BRA",1879026
1,126.0,"Central Asia",1170043,1161901,8142,873583,1455972,"UZB",1164778
1,126.0,"South-Eastern Asia",723245,0,723245,546042,910070,"IDN",728056
1,126.0,"Pakistan",1645135,1482671,162464,1230260,2050433,"PAK",1640347
1,126.0,"Southern Africa",3834,0,3834,2436,4061,"ZAF",3249
1,126.0,"Northern Europe",1915841,1915841,0,1476412,2460687,"GBR",1968550
1,126.0,"Oceania",461436,461436,0,344616,574360,"NZL",459488
1,126.0,"Central America",516663,0,516663,389967,649946,"MEX",519957
1,126.0,"Eastern Africa",225157,0,225157,169678,282797,"ETH",226238
1,126.0,"China",9136342,9122293,14049,6970407,11617346,"CPR",9293877
1,126.0,"Eastern Europe",3190924,2809538,381386,2561281,4268802,"POL",3415042
1,126.0,"India",5966845,5966845,0,4457332,7428887,"IND",5943110
1,126.0,"Middle Africa",76930,0,76930,58010,96683,"AGO",77347
1,126.0,"Western Asia",384497,0,384497,289647,482746,"IRQ",386197
1,126.0,"United States of America",2635117,2635117,0,1997673,3329456,"USA",2663565
1,126.0,"Western Europe",3815837,3747864,67973,2911403,4852338,"NLD",3881871
1,126.0,"Russian Federation",3446409,2883979,562430,2875160,4791933,"RUS",3833547
1,126.0,"Northern Africa",1185764,0,1185764,896427,1494046,"EGY",1195237
1,126.0,"Eastern Asia",821263,0,821263,622203,1037005,"JPN",829604
1,126.0,"Western Africa",316069,0,316069,238461,397436,"NGA",317949
1,126.0,"Southern Europe",829295,0,829295,624480,1040801,"ITA",832641
1,127.0,"Northern America",619939,619939,0,460564,767607,"CAN",614086
1,127.0,"Southern Asia",896819,0,896819,674532,1124220,"IRN",899376
1,127.0,"South America",1891235,1570012,321223,1409269,2348782,"BRA",1879026
1,127.0,"Central Asia",1145854,1140980,4874,873583,1455972,"UZB",1164778
1,127.0,"South-Eastern Asia",724740,0,724740,546042,910070,"IDN",728056
1,127.0,"Pakistan",1652585,1496028,156557,1230260,2050433,"PAK",1640347
1,127.0,"Southern Africa",3837,0,3837,2436,4061,"ZAF",3249
1,127.0,"Northern Europe",1911786,1911483,303,1476412,2460687,"GBR",1968550
1,127.0,"Oceania",463385,463385,0,344616,574360,"NZL",459488
1,127.0,"Central America",517521,0,517521,389967,649946,"MEX",519957
1,127.0,"Eastern Africa",225436,0,225436,169678,282797,"ETH",226238
1,127.0,"China",9160188,9127732,32456,6970407,11617346,"CPR",9293877
1,127.0,"Eastern Europe",3240927,2832755,408172,2561281,4268802,"POL",3415042
1,127.0,"India",5991872,5991872,0,4457332,7428887,"IND",5943110
1,127.0,"Middle Africa",77035,0,77035,58010,96683,"AGO",77347
1,127.0,"Western Asia",384937,0,384937,289647,482746,"IRQ",386197
1,127.0,"United States of America",2635117,2635117,0,1997673,3329456,"USA",2663565
1,127.0,"Western Europe",3830511,3749944,80567,2911403,4852338,"NLD",3881871
1,127.0,"Russian Federation",3499970,2884977,614993,2875160,4791933,"RUS",3833547
1,127.0,"Northern Africa",1188231,0,1188231,896427,1494046,"EGY",1195237
1,127.0,"Eastern Asia",823434,0,823434,622203,1037005,"JPN",829604
1,127.0,"Western Africa",316558,0,316558,238461,397436,"NGA",317949
1,127.0,"Southern Europe",830026,0,830026,624480,1040801,"ITA",832641
1,128.0,"Northern America",606281,606281,0,460564,767607,"CAN",614086
1,128.0,"Southern Asia",894495,0,894495,674532,1124220,"IRN",899376
1,128.0,"South America",1870378,1559218,311160,1409269,2348782,"BRA",1879026
1,128.0,"Central Asia",1133029,1130206,2823,873583,1455972,"UZB",1164778
1,128.0,"South-Eastern Asia",722565,0,722565,546042,910070,"IDN",728056
1,128.0,"Pakistan",1632501,1483915,148586,1230260,2050433,"PAK",1640347
1,128.0,"Southern Africa",3657,0,3657,2436,4061,"ZAF",3249
1,128.0,"Northern Europe",1790150,1783813,6337,1476412,2460687,"GBR",1968550
1,128.0,"Oceania",457539,457539,0,344616,574360,"NZL",459488
1,128.0,"Central America",515303,0,515303,389967,649946,"MEX",519957
1,128.0,"Eastern Africa",224711,0,224711,169678,282797,"ETH",226238
1,128.0,"China",9180361,9124089,56272,6970407,11617346,"CPR",9293877
1,128.0,"Eastern Europe",3942958,3515782,427176,2561281,4268802,"POL",3415042
1,128.0,"India",5919374,5919374,0,4457332,7428887,"IND",5943110
1,128.0,"Middle Africa",76758,0,76758,58010,96683,"AGO",77347
1,128.0,"Western Asia",383794,0,383794,289647,482746,"IRQ",386197
1,128.0,"United States of America",2635116,2634673,443,1997673,3329456,"USA",2663565
1,128.0,"Western Europe",3845185,3752129,93056,2911403,4852338,"NLD",3881871
1,128.0,"Russian Federation",3539059,2881534,657525,2875160,4791933,"RUS",3833547
1,128.0,"Northern Africa",1181847,0,1181847,896427,1494046,"EGY",1195237
1,128.0,"Eastern Asia",819005,0,819005,622203,1037005,"JPN",829604
1,128.0,"Western Africa",315294,0,315294,238461,397436,"NGA",317949
1,128.0,"Southern Europe",828340,0,828340,624480,1040801,"ITA",832641
1,129.0,"Northern America",561402,561402,0,460564,767607,"CAN",614086
1,129.0,"Southern Asia",874104,0,874104,674532,1124220,"IRN",899376
1,129.0,"South America",1860383,1575155,285228,1409269,2348782,"BRA",1879026
1,129.0,"Central Asia",1127737,1121966,5771,873583,1455972,"UZB",1164778
1,129.0,"South-Eastern Asia",693980,0,693980,546042,910070,"IDN",728056
1,129.0,"Pakistan",1641320,1498883,142437,1230260,2050433,"PAK",1640347
1,129.0,"Southern Africa",3605,0,3605,2436,4061,"ZAF",3249
1,129.0,"Northern Europe",1810422,1797390,13032,1476412,2460687,"GBR",1968550
1,129.0,"Oceania",460462,460462,0,344616,574360,"NZL",459488
1,129.0,"Central America",495848,0,495848,389967,649946,"MEX",519957
1,129.0,"Eastern Africa",218349,0,218349,169678,282797,"ETH",226238
1,129.0,"China",9203621,9120063,83558,6970407,11617346,"CPR",9293877
1,129.0,"Eastern Europe",3880243,3529794,350449,2561281,4268802,"POL",3415042
1,129.0,"India",5954984,5954984,0,4457332,7428887,"IND",5943110
1,129.0,"Middle Africa",74310,0,74310,58010,96683,"AGO",77347
1,129.0,"Western Asia",373762,0,373762,289647,482746,"IRQ",386197
1,129.0,"United States of America",2379086,2378197,889,1997673,3329456,"USA",2663565
1,129.0,"Western Europe",3808500,3703121,105379,2911403,4852338,"NLD",3881871
1,129.0,"Russian Federation",4584417,3925403,659014,2875160,4791933,"RUS",3833547
1,129.0,"Northern Africa",1125864,0,1125864,896427,1494046,"EGY",1195237
1,129.0,"Eastern Asia",770453,0,770453,622203,1037005,"JPN",829604
1,129.0,"Western Africa",304212,0,304212,238461,397436,"NGA",317949
1,129.0,"Southern Europe",810036,0,810036,624480,1040801,"ITA",832641
1,130.0,"Northern America",584817,584817,0,460564,767607,"CAN",614086
1,130.0,"Southern Asia",882655,0,882655,674532,1124220,"IRN",899376
1,130.0,"South America",1868016,1599270,268746,1409269,2348782,"BRA",1879026
1,130.0,"Central Asia",1033819,1023990,9829,873583,1455972,"UZB",1164778
1,130.0,"South-Eastern Asia",705551,0,705551,546042,910070,"IDN",728056
1,130.0,"Pakistan",1576531,1439848,136683,1230260,2050433,"PAK",1640347
1,130.0,"Southern Africa",3806,0,3806,2436,4061,"ZAF",3249
1,130.0,"Northern Europe",1834748,1814794,19954,1476412,2460687,"GBR",1968550
1,130.0,"Oceania",468255,468255,0,344616,574360,"NZL",459488
1,130.0,"Central America",504007,0,504007,389967,649946,"MEX",519957
1,130.0,"Eastern Africa",221013,0,221013,169678,282797,"ETH",226238
1,130.0,"China",9228347,9121231,107116,6970407,11617346,"CPR",9293877
1,130.0,"Eastern Europe",3853888,3536453,317435,2561281,4268802,"POL",3415042
1,130.0,"India",6052842,6052381,461,4457332,7428887,"IND",5943110
1,130.0,"Middle Africa",75332,0,75332,58010,96683,"AGO",77347
1,130.0,"Western Asia",377970,0,377970,289647,482746,"IRQ",386197
1,130.0,"United States of America",2457316,2451300,6016,1997673,3329456,"USA",2663565
1,130.0,"Western Europe",3823174,3716437,106737,2911403,4852338,"NLD",3881871
1,130.0,"Russian Federation",4469995,3921345,548650,2875160,4791933,"RUS",3833547
1,130.0,"Northern Africa",1149342,0,1149342,896427,1494046,"EGY",1195237
1,130.0,"Eastern Asia",790380,0,790380,622203,1037005,"JPN",829604
1,130.0,"Western Africa",308860,0,308860,238461,397436,"NGA",317949
1,130.0,"Southern Europe",817719,0,817719,624480,1040801,"ITA",832641
1,131.0,"Northern America",596525,596525,0,460569,767616,"CAN",614093
1,131.0,"Southern Asia",888101,0,888101,674532,1124221,"IRN",899377
1,131.0,"South America",1846531,1591099,255432,1409273,2348788,"BRA",1879031
1,131.0,"Central Asia",1049684,1034717,14967,873586,1455977,"UZB",1164782
1,131.0,"South-Eastern Asia",712787,0,712787,546046,910077,"IDN",728062
1,131.0,"Pakistan",1584116,1442411,141705,1230268,2050447,"PAK",1640358
1,131.0,"Southern Africa",3814,0,3814,2438,4063,"ZAF",3251
1,131.0,"Northern Europe",1891511,1864537,26974,1476415,2460692,"GBR",1968554
1,131.0,"Oceania",463385,463385,0,344624,574373,"NZL",459499
1,131.0,"Central America",509451,0,509451,389973,649956,"MEX",519965
1,131.0,"Eastern Africa",222715,0,222715,169683,282805,"ETH",226244
1,131.0,"China",9249499,9112583,136916,6970414,11617357,"CPR",9293886
1,131.0,"Eastern Europe",3814103,3528552,285551,2561286,4268810,"POL",3415048
1,131.0,"India",5992911,5992779,132,4457333,7428888,"IND",5943111
1,131.0,"Middle Africa",76012,0,76012,58017,96695,"AGO",77356
1,131.0,"Western Asia",380650,0,380650,289650,482751,"IRQ",386201
1,131.0,"United States of America",2521324,2506622,14702,1997677,3329462,"USA",2663570
1,131.0,"Western Europe",3845184,3737362,107822,2911408,4852347,"NLD",3881878
1,131.0,"Russian Federation",4393035,3924508,468527,2875163,4791938,"RUS",3833551
1,131.0,"Northern Africa",1164289,0,1164289,896428,1494047,"EGY",1195238
1,131.0,"Eastern Asia",802992,0,802992,622206,1037011,"JPN",829609
1,131.0,"Western Africa",311818,0,311818,238462,397437,"NGA",317950
1,131.0,"Southern Europe",822579,0,822579,624485,1040808,"ITA",832647
1,132.0,"Northern America",604329,602455,1874,476081,793468,"CAN",634775
1,132.0,"Southern Asia",891374,0,891374,462297,770496,"IRN",616397
1,132.0,"South America",1829076,1581026,248050,1316415,2194025,"BRA",1755220
1,132.0,"Central Asia",1075011,1055002,20009,936867,1561446,"UZB",1249157
1,132.0,"South-Eastern Asia",717089,0,717089,675164,1125273,"IDN",900219
1,132.0,"Pakistan",1587629,1441448,146181,1141178,1901963,"PAK",1521571
1,132.0,"Southern Africa",3730,0,3730,43911,73186,"ZAF",58549
1,132.0,"Northern Europe",1932057,1898396,33661,1438818,2398030,"GBR",1918424
1,132.0,"Oceania",460462,460462,0,360921,601535,"NZL",481228
1,132.0,"Central America",512418,0,512418,338025,563375,"MEX",450700
1,132.0,"Eastern Africa",223739,0,223739,151367,252278,"ETH",201823
1,132.0,"China",9293038,9127329,165709,6422388,10703980,"CPR",8563184
1,132.0,"Eastern Europe",3781627,3524218,257409,2384755,3974592,"POL",3179674
1,132.0,"India",5943636,5943636,0,4238274,7063791,"IND",5651033
1,132.0,"Middle Africa",76380,0,76380,63836,106393,"AGO",85115
1,132.0,"Western Asia",382259,0,382259,357588,595981,"IRQ",476785
1,132.0,"United States of America",2556883,2533450,23433,1738656,2897760,"USA",2318208
1,132.0,"Western Europe",3859859,3751359,108500,2777207,4628678,"NLD",3702943
1,132.0,"Russian Federation",4340153,3918223,421930,2100451,3500752,"RUS",2800602
1,132.0,"Northern Africa",1173280,0,1173280,1023844,1706407,"EGY",1365126
1,132.0,"Eastern Asia",810499,0,810499,611110,1018517,"JPN",814814
1,132.0,"Western Africa",313597,0,313597,251361,418936,"NGA",335149
1,132.0,"Southern Europe",825498,0,825498,722764,1204607,"ITA",963686
1,133.0,"Northern America",612141,608327,3814,476081,793468,"CAN",634775
1,133.0,"Southern Asia",894384,0,894384,462297,770496,"IRN",616397
1,133.0,"South America",1974698,1728444,246254,1316415,2194025,"BRA",1755220
1,133.0,"Central Asia",1106208,1081198,25010,936867,1561446,"UZB",1249157
1,133.0,"South-Eastern Asia",721046,0,721046,675164,1125273,"IDN",900219
1,133.0,"Pakistan",1612930,1462643,150287,1141178,1901963,"PAK",1521571
1,133.0,"Southern Africa",3545,0,3545,43911,73186,"ZAF",58549
1,133.0,"Northern Europe",1968550,1928702,39848,1438818,2398030,"GBR",1918424
1,133.0,"Oceania",457551,457551,0,360921,601535,"NZL",481228
1,133.0,"Central America",515136,0,515136,338025,563375,"MEX",450700
1,133.0,"Eastern Africa",224682,0,224682,151367,252278,"ETH",201823
1,133.0,"China",9293307,9122309,170998,6422388,10703980,"CPR",8563184
1,133.0,"Eastern Europe",3756823,3524953,231870,2384755,3974592,"POL",3179674
1,133.0,"India",5858227,5858227,0,4238274,7063791,"IND",5651033
1,133.0,"Middle Africa",76752,0,76752,63836,106393,"AGO",85115
1,133.0,"Western Asia",383743,0,383743,357588,595981,"IRQ",476785
1,133.0,"United States of America",2592450,2561342,31108,1738656,2897760,"USA",2318208
1,133.0,"Western Europe",3867200,3758295,108905,2777207,4628678,"NLD",3702943
1,133.0,"Russian Federation",4304271,3923730,380541,2100451,3500752,"RUS",2800602
1,133.0,"Northern Africa",1181541,0,1181541,1023844,1706407,"EGY",1365126
1,133.0,"Eastern Asia",817377,0,817377,611110,1018517,"JPN",814814
1,133.0,"Western Africa",315234,0,315234,251361,418936,"NGA",335149
1,133.0,"Southern Europe",828192,0,828192,722764,1204607,"ITA",963686
1,134.0,"Northern America",634774,628930,5844,476081,793468,"CAN",634775
1,134.0,"Southern Asia",626615,0,626615,462297,770496,"IRN",616397
1,134.0,"South America",1763307,1549445,213862,1316415,2194025,"BRA",1755220
1,134.0,"Central Asia",1185999,1154890,31109,936867,1561446,"UZB",1249157
1,134.0,"South-Eastern Asia",912962,0,912962,675164,1125273,"IDN",900219
1,134.0,"Pakistan",1627366,1483150,144216,1141178,1901963,"PAK",1521571
1,134.0,"Southern Africa",26473,0,26473,43911,73186,"ZAF",58549
1,134.0,"Northern Europe",1979243,1935669,43574,1438818,2398030,"GBR",1918424
1,134.0,"Oceania",480254,480254,0,360921,601535,"NZL",481228
1,134.0,"Central America",460717,0,460717,338025,563375,"MEX",450700
1,134.0,"Eastern Africa",205016,0,205016,151367,252278,"ETH",201823
1,134.0,"China",9304611,9120276,184335,6422388,10703980,"CPR",8563184
1,134.0,"Eastern Europe",3437348,3246335,191013,2384755,3974592,"POL",3179674
1,134.0,"India",5713855,5713855,0,4238274,7063791,"IND",5651033
1,134.0,"Middle Africa",86382,0,86382,63836,106393,"AGO",85115
1,134.0,"Western Asia",481804,0,481804,357588,595981,"IRQ",476785
1,134.0,"United States of America",2446226,2410432,35794,1738656,2897760,"USA",2318208
1,134.0,"Western Europe",3783652,3677787,105865,2777207,4628678,"NLD",3702943
1,134.0,"Russian Federation",3097454,2843980,253474,2100451,3500752,"RUS",2800602
1,134.0,"Northern Africa",1393160,0,1393160,1023844,1706407,"EGY",1365126
1,134.0,"Eastern Asia",838748,0,838748,611110,1018517,"JPN",814814
1,134.0,"Western Africa",340696,0,340696,251361,418936,"NGA",335149
1,134.0,"Southern Europe",972795,0,972795,722764,1204607,"ITA",963686
1,135.0,"Northern America",646481,638733,7748,476081,793468,"CAN",634775
1,135.0,"Southern Asia",625588,0,625588,462297,770496,"IRN",616397
1,135.0,"South America",1735829,1521945,213884,1316415,2194025,"BRA",1755220
1,135.0,"Central Asia",1233407,1197089,36318,936867,1561446,"UZB",1249157
1,135.0,"South-Eastern Asia",912558,0,912558,675164,1125273,"IDN",900219
1,135.0,"Pakistan",1624073,1487790,136283,1141178,1901963,"PAK",1521571
1,135.0,"Southern Africa",60496,0,60496,43911,73186,"ZAF",58549
1,135.0,"Northern Europe",1991407,1942988,48419,1438818,2398030,"GBR",1918424
1,135.0,"Oceania",473435,473435,0,360921,601535,"NZL",481228
1,135.0,"Central America",459185,0,459185,338025,563375,"MEX",450700
1,135.0,"Eastern Africa",204695,0,204695,151367,252278,"ETH",201823
1,135.0,"China",9153869,8965309,188560,6422388,10703980,"CPR",8563184
1,135.0,"Eastern Europe",3127544,2956847,170697,2384755,3974592,"POL",3179674
1,135.0,"India",5554679,5554679,0,4238274,7063791,"IND",5651033
1,135.0,"Middle Africa",86225,0,86225,63836,106393,"AGO",85115
1,135.0,"Western Asia",481308,0,481308,357588,595981,"IRQ",476785
1,135.0,"United States of America",2417779,2376294,41485,1738656,2897760,"USA",2318208
1,135.0,"Western Europe",3783652,3679280,104372,2777207,4628678,"NLD",3702943
1,135.0,"Russian Federation",2744617,2521618,222999,2100451,3500752,"RUS",2800602
1,135.0,"Northern Africa",1390350,0,1390350,1023844,1706407,"EGY",1365126
1,135.0,"Eastern Asia",836304,0,836304,611110,1018517,"JPN",814814
1,135.0,"Western Africa",340133,0,340133,251361,418936,"NGA",335149
1,135.0,"Southern Europe",971888,0,971888,722764,1204607,"ITA",963686
1,136.0,"Northern America",648389,638843,9546,476081,793468,"CAN",634775
1,136.0,"Southern Asia",625812,0,625812,462297,770496,"IRN",616397
1,136.0,"South America",1751398,1533506,217892,1316415,2194025,"BRA",1755220
1,136.0,"Central Asia",1265938,1224827,41111,936867,1561446,"UZB",1249157
1,136.0,"South-Eastern Asia",912745,0,912745,675164,1125273,"IDN",900219
1,136.0,"Pakistan",1520272,1395566,124706,1141178,1901963,"PAK",1521571
1,136.0,"Southern Africa",61066,0,61066,43911,73186,"ZAF",58549
1,136.0,"Northern Europe",2007627,1954674,52953,1438818,2398030,"GBR",1918424
1,136.0,"Oceania",478305,478305,0,360921,601535,"NZL",481228
1,136.0,"Central America",459423,0,459423,338025,563375,"MEX",450700
1,136.0,"Eastern Africa",204765,0,204765,151367,252278,"ETH",201823
1,136.0,"China",8513972,8358642,155330,6422388,10703980,"CPR",8563184
1,136.0,"Eastern Europe",3157582,2989538,168044,2384755,3974592,"POL",3179674
1,136.0,"India",5613634,5613634,0,4238274,7063791,"IND",5651033
1,136.0,"Middle Africa",86250,0,86250,63836,106393,"AGO",85115
1,136.0,"Western Asia",481419,0,481419,357588,595981,"IRQ",476785
1,136.0,"United States of America",2410665,2363374,47291,1738656,2897760,"USA",2318208
1,136.0,"Western Europe",3783651,3680772,102879,2777207,4628678,"NLD",3702943
1,136.0,"Russian Federation",2774019,2553475,220544,2100451,3500752,"RUS",2800602
1,136.0,"Northern Africa",1390964,0,1390964,1023844,1706407,"EGY",1365126
1,136.0,"Eastern Asia",836610,0,836610,611110,1018517,"JPN",814814
1,136.0,"Western Africa",340268,0,340268,251361,418936,"NGA",335149
1,136.0,"Southern Europe",972087,0,972087,722764,1204607,"ITA",963686
1,137.0,"Northern America",648435,639013,9422,476081,793468,"CAN",634775
1,137.0,"Southern Asia",625474,0,625474,462297,770496,"IRN",616397
1,137.0,"South America",1757732,1538687,219045,1316415,2194025,"BRA",1755220
1,137.0,"Central Asia",1295034,1249525,45509,936867,1561446,"UZB",1249157
1,137.0,"South-Eastern Asia",912215,0,912215,675164,1125273,"IDN",900219
1,137.0,"Pakistan",1520357,1398124,122233,1141178,1901963,"PAK",1521571
1,137.0,"Southern Africa",61169,0,61169,43911,73186,"ZAF",58549
1,137.0,"Northern Europe",2015735,1958682,57053,1438818,2398030,"GBR",1918424
1,137.0,"Oceania",480254,480254,0,360921,601535,"NZL",481228
1,137.0,"Central America",459358,0,459358,338025,563375,"MEX",450700
1,137.0,"Eastern Africa",204658,0,204658,151367,252278,"ETH",201823
1,137.0,"China",8539884,8409720,130164,6422388,10703980,"CPR",8563184
1,137.0,"Eastern Europe",3175624,3011134,164490,2384755,3974592,"POL",3179674
1,137.0,"India",5638511,5638511,0,4238274,7063791,"IND",5651033
1,137.0,"Middle Africa",86154,0,86154,63836,106393,"AGO",85115
1,137.0,"Western Asia",481250,0,481250,357588,595981,"IRQ",476785
1,137.0,"United States of America",2396444,2343420,53024,1738656,2897760,"USA",2318208
1,137.0,"Western Europe",3783651,3674690,108961,2777207,4628678,"NLD",3702943
1,137.0,"Russian Federation",2793354,2576739,216615,2100451,3500752,"RUS",2800602
1,137.0,"Northern Africa",1390038,0,1390038,1023844,1706407,"EGY",1365126
1,137.0,"Eastern Asia",835693,0,835693,611110,1018517,"JPN",814814
1,137.0,"Western Africa",340082,0,340082,251361,418936,"NGA",335149
1,137.0,"Southern Europe",971784,0,971784,722764,1204607,"ITA",963686
1,138.0,"Northern America",648414,639138,9276,476081,793468,"CAN",634775
1,138.0,"Southern Asia",626153,0,626153,462297,770496,"IRN",616397
1,138.0,"South America",1770936,1551638,219298,1316415,2194025,"BRA",1755220
1,138.0,"Central Asia",1321185,1271757,49428,936867,1561446,"UZB",1249157
1,138.0,"South-Eastern Asia",913158,0,913158,675164,1125273,"IDN",900219
1,138.0,"Pakistan",1533507,1413230,120277,1141178,1901963,"PAK",1521571
1,138.0,"Southern Africa",61265,0,61265,43911,73186,"ZAF",58549
1,138.0,"Northern Europe",2015735,1954915,60820,1438818,2398030,"GBR",1918424
1,138.0,"Oceania",484151,484151,0,360921,601535,"NZL",481228
1,138.0,"Central America",460006,0,460006,338025,563375,"MEX",450700
1,138.0,"Eastern Africa",204871,0,204871,151367,252278,"ETH",201823
1,138.0,"China",8628289,8523616,104673,6422388,10703980,"CPR",8563184
1,138.0,"Eastern Europe",3209016,3048706,160310,2384755,3974592,"POL",3179674
1,138.0,"India",5687282,5687282,0,4238274,7063791,"IND",5651033
1,138.0,"Middle Africa",86344,0,86344,63836,106393,"AGO",85115
1,138.0,"Western Asia",481587,0,481587,357588,595981,"IRQ",476785
1,138.0,"United States of America",2396441,2337634,58807,1738656,2897760,"USA",2318208
1,138.0,"Western Europe",3790988,3672688,118300,2777207,4628678,"NLD",3702943
1,138.0,"Russian Federation",2829578,2617537,212041,2100451,3500752,"RUS",2800602
1,138.0,"Northern Africa",1391901,0,1391901,1023844,1706407,"EGY",1365126
1,138.0,"Eastern Asia",837324,0,837324,611110,1018517,"JPN",814814
1,138.0,"Western Africa",340455,0,340455,251361,418936,"NGA",335149
1,138.0,"Southern Europe",972391,0,972391,722764,1204607,"ITA",963686
1,139.0,"Northern America",648435,640361,8074,476081,793468,"CAN",634775
1,139.0,"Southern Asia",625502,0,625502,462297,770496,"IRN",616397
1,139.0,"South America",1751719,1533994,217725,1316415,2194025,"BRA",1755220
1,139.0,"Central Asia",1349267,1297156,52111,936867,1561446,"UZB",1249157
1,139.0,"South-Eastern Asia",912704,0,912704,675164,1125273,"IDN",900219
1,139.0,"Pakistan",1514486,1397716,116770,1141178,1901963,"PAK",1521571
1,139.0,"Southern Africa",61084,0,61084,43911,73186,"ZAF",58549
1,139.0,"Northern Europe",2015735,1951337,64398,1438818,2398030,"GBR",1918424
1,139.0,"Oceania",478305,478305,0,360921,601535,"NZL",481228
1,139.0,"Central America",459384,0,459384,338025,563375,"MEX",450700
1,139.0,"Eastern Africa",204669,0,204669,151367,252278,"ETH",201823
1,139.0,"China",8499250,8420685,78565,6422388,10703980,"CPR",8563184
1,139.0,"Eastern Europe",3161431,3007012,154419,2384755,3974592,"POL",3179674
1,139.0,"India",5615034,5615034,0,4238274,7063791,"IND",5651033
1,139.0,"Middle Africa",86212,0,86212,63836,106393,"AGO",85115
1,139.0,"Western Asia",481264,0,481264,357588,595981,"IRQ",476785
1,139.0,"United States of America",2396442,2338148,58294,1738656,2897760,"USA",2318208
1,139.0,"Western Europe",3790987,3663691,127296,2777207,4628678,"NLD",3702943
1,139.0,"Russian Federation",2777995,2574219,203776,2100451,3500752,"RUS",2800602
1,139.0,"Northern Africa",1390108,0,1390108,1023844,1706407,"EGY",1365126
1,139.0,"Eastern Asia",836353,0,836353,611110,1018517,"JPN",814814
1,139.0,"Western Africa",340097,0,340097,251361,418936,"NGA",335149
1,139.0,"Southern Europe",971810,0,971810,722764,1204607,"ITA",963686
1,140.0,"Northern America",648434,642348,6086,476081,793468,"CAN",634775
1,140.0,"Southern Asia",625842,0,625842,462297,770496,"IRN",616397
1,140.0,"South America",1754878,1535671,219207,1316415,2194025,"BRA",1755220
1,140.0,"Central Asia",1369194,1315702,53492,936867,1561446,"UZB",1249157
1,140.0,"South-Eastern Asia",913381,0,913381,675164,1125273,"IDN",900219
1,140.0,"Pakistan",1517129,1402284,114845,1141178,1901963,"PAK",1521571
1,140.0,"Southern Africa",61178,0,61178,43911,73186,"ZAF",58549
1,140.0,"Northern Europe",1983301,1915519,67782,1438818,2398030,"GBR",1918424
1,140.0,"Oceania",479280,479280,0,360921,601535,"NZL",481228
1,140.0,"Central America",460132,0,460132,338025,563375,"MEX",450700
1,140.0,"Eastern Africa",204773,0,204773,151367,252278,"ETH",201823
1,140.0,"China",8517551,8464399,53152,6422388,10703980,"CPR",8563184
1,140.0,"Eastern Europe",3167758,3017098,150660,2384755,3974592,"POL",3179674
1,140.0,"India",5626399,5626399,0,4238274,7063791,"IND",5651033
1,140.0,"Middle Africa",86255,0,86255,63836,106393,"AGO",85115
1,140.0,"Western Asia",481433,0,481433,357588,595981,"IRQ",476785
1,140.0,"United States of America",2403554,2339630,63924,1738656,2897760,"USA",2318208
1,140.0,"Western Europe",3790988,3658082,132906,2777207,4628678,"NLD",3702943
1,140.0,"Russian Federation",2784667,2585437,199230,2100451,3500752,"RUS",2800602
1,140.0,"Northern Africa",1391050,0,1391050,1023844,1706407,"EGY",1365126
1,140.0,"Eastern Asia",837646,0,837646,611110,1018517,"JPN",814814
1,140.0,"Western Africa",340284,0,340284,251361,418936,"NGA",335149
1,140.0,"Southern Europe",972115,0,972115,722764,1204607,"ITA",963686
1,141.0,"Northern America",498189,494065,4124,476081,793468,"CAN",634775
1,141.0,"Southern Asia",595998,0,595998,462297,770496,"IRN",616397
1,141.0,"South America",1726611,1531444,195167,1316415,2194025,"BRA",1755220
1,141.0,"Central Asia",1377046,1327475,49571,936867,1561446,"UZB",1249157
1,141.0,"South-Eastern Asia",871783,0,871783,675164,1125273,"IDN",900219
1,141.0,"Pakistan",1510772,1401351,109421,1141178,1901963,"PAK",1521571
1,141.0,"Southern Africa",52886,0,52886,43911,73186,"ZAF",58549
1,141.0,"Northern Europe",1979243,1913042,66201,1438818,2398030,"GBR",1918424
1,141.0,"Oceania",478306,478306,0,360921,601535,"NZL",481228
1,141.0,"Central America",431780,0,431780,338025,563375,"MEX",450700
1,141.0,"Eastern Africa",195460,0,195460,151367,252278,"ETH",201823
1,141.0,"China",8496144,8468580,27564,6422388,10703980,"CPR",8563184
1,141.0,"Eastern Europe",3153628,3013284,140344,2384755,3974592,"POL",3179674
1,141.0,"India",5614392,5614392,0,4238274,7063791,"IND",5651033
1,141.0,"Middle Africa",82672,0,82672,63836,106393,"AGO",85115
1,141.0,"Western Asia",466749,0,466749,357588,595981,"IRQ",476785
1,141.0,"United States of America",2247090,2189570,57520,1738656,2897760,"USA",2318208
1,141.0,"Western Europe",3666260,3524676,141584,2777207,4628678,"NLD",3702943
1,141.0,"Russian Federation",2746095,2582088,164007,2100451,3500752,"RUS",2800602
1,141.0,"Northern Africa",1309111,0,1309111,1023844,1706407,"EGY",1365126
1,141.0,"Eastern Asia",765485,0,765485,611110,1018517,"JPN",814814
1,141.0,"Western Africa",324063,0,324063,251361,418936,"NGA",335149
1,141.0,"Southern Europe",945483,0,945483,722764,1204607,"ITA",963686
1,142.0,"Northern America",578185,571309,6876,476081,793468,"CAN",634775
1,142.0,"Southern Asia",603770,0,603770,462297,770496,"IRN",616397
1,142.0,"South America",1749787,1564056,185731,1316415,2194025,"BRA",1755220
1,142.0,"Central Asia",1317637,1269230,48407,936867,1561446,"UZB",1249157
1,142.0,"South-Eastern Asia",882626,0,882626,675164,1125273,"IDN",900219
1,142.0,"Pakistan",1523342,1418741,104601,1141178,1901963,"PAK",1521571
1,142.0,"Southern Africa",55034,0,55034,43911,73186,"ZAF",58549
1,142.0,"Northern Europe",1971134,1907397,63737,1438818,2398030,"GBR",1918424
1,142.0,"Oceania",482201,482201,0,360921,601535,"NZL",481228
1,142.0,"Central America",438087,0,438087,338025,563375,"MEX",450700
1,142.0,"Eastern Africa",197878,0,197878,151367,252278,"ETH",201823
1,142.0,"China",8583226,8581341,1885,6422388,10703980,"CPR",8563184
1,142.0,"Eastern Europe",3185185,3054976,130209,2384755,3974592,"POL",3179674
1,142.0,"India",5662773,5662773,0,4238274,7063791,"IND",5651033
1,142.0,"Middle Africa",83592,0,83592,63836,106393,"AGO",85115
1,142.0,"Western Asia",470576,0,470576,357588,595981,"IRQ",476785
1,142.0,"United States of America",2225749,2174209,51540,1738656,2897760,"USA",2318208
1,142.0,"Western Europe",3658919,3505137,153782,2777207,4628678,"NLD",3702943
1,142.0,"Russian Federation",2796241,2647894,148347,2100451,3500752,"RUS",2800602
1,142.0,"Northern Africa",1330472,0,1330472,1023844,1706407,"EGY",1365126
1,142.0,"Eastern Asia",784294,0,784294,611110,1018517,"JPN",814814
1,142.0,"Western Africa",328286,0,328286,251361,418936,"NGA",335149
1,142.0,"Southern Europe",952421,0,952421,722764,1204607,"ITA",963686
1,143.0,"Northern America",613309,604081,9228,476088,793480,"CAN",634784
1,143.0,"Southern Asia",609438,0,609438,462302,770503,"IRN",616403
1,143.0,"South America",1770132,1593467,176665,1316418,2194030,"BRA",1755224
1,143.0,"Central Asia",1268350,1225370,42980,936873,1561455,"UZB",1249164
1,143.0,"South-Eastern Asia",890521,0,890521,675164,1125273,"IDN",900219
1,143.0,"Pakistan",1541097,1440647,100450,1141184,1901973,"PAK",1521579
1,143.0,"Southern Africa",56611,0,56611,43914,73190,"ZAF",58552
1,143.0,"Northern Europe",1958972,1902140,56832,1438824,2398040,"GBR",1918432
1,143.0,"Oceania",487073,487073,0,360922,601537,"NZL",481230
1,143.0,"Central America",443667,0,443667,338028,563380,"MEX",450704
1,143.0,"Eastern Africa",199649,0,199649,151369,252282,"ETH",201826
1,143.0,"China",8695266,8695266,0,6422388,10703981,"CPR",8563185
1,143.0,"Eastern Europe",3227375,3108073,119302,2384760,3974601,"POL",3179681
1,143.0,"India",5723920,5723920,0,4238280,7063801,"IND",5651041
1,143.0,"Middle Africa",84273,0,84273,63843,106405,"AGO",85124
1,143.0,"Western Asia",473360,0,473360,357596,595993,"IRQ",476795
1,143.0,"United States of America",2239976,2183392,56584,1738663,2897772,"USA",2318218
1,143.0,"Western Europe",3673594,3507300,166294,2777211,4628686,"NLD",3702949
1,143.0,"Russian Federation",2849644,2712146,137498,2100458,3500763,"RUS",2800611
1,143.0,"Northern Africa",1346028,0,1346028,1023845,1706408,"EGY",1365127
1,143.0,"Eastern Asia",797994,0,797994,611117,1018528,"JPN",814823
1,143.0,"Western Africa",331365,0,331365,251370,418950,"NGA",335160
1,143.0,"Southern Europe",957477,0,957477,722769,1204616,"ITA",963693
1,144.0,"Northern America",632823,621486,11337,462597,770996,"CAN",616797
1,144.0,"Southern Asia",611583,0,611583,326114,543523,"IRN",434819
1,144.0,"South America",1733180,1566553,166627,1475713,2459522,"BRA",1967618
1,144.0,"Central Asia",1233281,1194477,38804,1060683,1767805,"UZB",1414244
1,144.0,"South-Eastern Asia",893516,0,893516,577857,963095,"IDN",770476
1,144.0,"Pakistan",1503098,1408709,94389,1234669,2057782,"PAK",1646226
1,144.0,"Southern Africa",57205,0,57205,52056,86761,"ZAF",69409
1,144.0,"Northern Europe",1926534,1876253,50281,1518131,2530218,"GBR",2024175
1,144.0,"Oceania",475383,475383,0,405348,675581,"NZL",540465
1,144.0,"Central America",446024,0,446024,375885,626475,"MEX",501180
1,144.0,"Eastern Africa",200317,0,200317,217480,362467,"ETH",289974
1,144.0,"China",8435364,8435364,0,6705209,11175348,"CPR",8940279
1,144.0,"Eastern Europe",3131515,3024727,106788,2002410,3337350,"POL",2669880
1,144.0,"India",5579039,5579039,0,4337031,7228385,"IND",5782708
1,144.0,"Middle Africa",84532,0,84532,69132,115220,"AGO",92176
1,144.0,"Western Asia",474416,0,474416,341202,568670,"IRQ",454936
1,144.0,"United States of America",2261310,2196481,64829,2015148,3358580,"USA",2686864
1,144.0,"Western Europe",3680930,3502530,178400,2691367,4485612,"NLD",3588490
1,144.0,"Russian Federation",2749165,2624560,124605,1978290,3297151,"RUS",2637721
1,144.0,"Northern Africa",1351922,0,1351922,822822,1371370,"EGY",1097096
1,144.0,"Eastern Asia",803184,0,803184,600287,1000478,"JPN",800383
1,144.0,"Western Africa",332532,0,332532,249888,416480,"NGA",333184
1,144.0,"Southern Europe",959389,0,959389,596340,993900,"ITA",795120
1,145.0,"Northern America",640636,627428,13208,462597,770996,"CAN",616797
1,145.0,"Southern Asia",613988,0,613988,326114,543523,"IRN",434819
1,145.0,"South America",1732618,1571604,161014,1475713,2459522,"BRA",1967618
1,145.0,"Central Asia",1231958,1197081,34877,1060683,1767805,"UZB",1414244
1,145.0,"South-Eastern Asia",896855,0,896855,577857,963095,"IDN",770476
1,145.0,"Pakistan",1501233,1411391,89842,1234669,2057782,"PAK",1646226
1,145.0,"Southern Africa",57877,0,57877,52056,86761,"ZAF",69409
1,145.0,"Northern Europe",1894106,1850036,44070,1518131,2530218,"GBR",2024175
1,145.0,"Oceania",475385,475385,0,405348,675581,"NZL",540465
1,145.0,"Central America",448908,0,448908,375885,626475,"MEX",501180
1,145.0,"Eastern Africa",201069,0,201069,217480,362467,"ETH",289974
1,145.0,"China",8428085,8428085,0,6705209,11175348,"CPR",8940279
1,145.0,"Eastern Europe",3128926,3028823,100103,2002410,3337350,"POL",2669880
1,145.0,"India",5577518,5577518,0,4337031,7228385,"IND",5782708
1,145.0,"Middle Africa",84830,0,84830,69132,115220,"AGO",92176
1,145.0,"Western Asia",475603,0,475603,341202,568670,"IRQ",454936
1,145.0,"United States of America",2282656,2208712,73944,2015148,3358580,"USA",2686864
1,145.0,"Western Europe",3695609,3505651,189958,2691367,4485612,"NLD",3588490
1,145.0,"Russian Federation",2746336,2626825,119511,1978290,3297151,"RUS",2637721
1,145.0,"Northern Africa",1358508,0,1358508,822822,1371370,"EGY",1097096
1,145.0,"Eastern Asia",808995,0,808995,600287,1000478,"JPN",800383
1,145.0,"Western Africa",333848,0,333848,249888,416480,"NGA",333184
1,145.0,"Southern Europe",961537,0,961537,596340,993900,"ITA",795120
1,146.0,"Northern America",681189,666433,14756,462597,770996,"CAN",616797
1,146.0,"Southern Asia",440183,0,440183,326114,543523,"IRN",434819
1,146.0,"South America",1947875,1764466,183409,1475713,2459522,"BRA",1967618
1,146.0,"Central Asia",1397428,1362456,34972,1060683,1767805,"UZB",1414244
1,146.0,"South-Eastern Asia",777949,0,777949,577857,963095,"IDN",770476
1,146.0,"Pakistan",1569174,1471761,97413,1234669,2057782,"PAK",1646226
1,146.0,"Southern Africa",70886,0,70886,52056,86761,"ZAF",69409
1,146.0,"Northern Europe",1914702,1874767,39935,1518131,2530218,"GBR",2024175
1,146.0,"Oceania",536569,536569,0,405348,675581,"NZL",540465
1,146.0,"Central America",505863,0,505863,375885,626475,"MEX",501180
1,146.0,"Eastern Africa",291641,0,291641,217480,362467,"ETH",289974
1,146.0,"China",8838253,8838253,0,6705209,11175348,"CPR",8940279
1,146.0,"Eastern Europe",2661416,2577179,84237,2002410,3337350,"POL",2669880
1,146.0,"India",5732035,5732035,0,4337031,7228385,"IND",5782708
1,146.0,"Middle Africa",92804,0,92804,69132,115220,"AGO",92176
1,146.0,"Western Asia",457578,0,457578,341202,568670,"IRQ",454936
1,146.0,"United States of America",2558847,2468521,90326,2015148,3358580,"USA",2686864
1,146.0,"Western Europe",3786588,3589952,196636,2691367,4485612,"NLD",3588490
1,146.0,"Russian Federation",2619118,2502177,116941,1978290,3297151,"RUS",2637721
1,146.0,"Northern Africa",1111813,0,1111813,822822,1371370,"EGY",1097096
1,146.0,"Eastern Asia",813346,0,813346,600287,1000478,"JPN",800383
1,146.0,"Western Africa",336102,0,336102,249888,416480,"NGA",333184
1,146.0,"Southern Europe",801189,0,801189,596340,993900,"ITA",795120
1,147.0,"Northern America",651923,636235,15688,462597,770996,"CAN",616797
1,147.0,"Southern Asia",440919,0,440919,326114,543523,"IRN",434819
1,147.0,"South America",1989719,1803512,186207,1475713,2459522,"BRA",1967618
1,147.0,"Central Asia",1429480,1396456,33024,1060683,1767805,"UZB",1414244
1,147.0,"South-Eastern Asia",779117,0,779117,577857,963095,"IDN",770476
1,147.0,"Pakistan",1600492,1494132,106360,1234669,2057782,"PAK",1646226
1,147.0,"Southern Africa",71109,0,71109,52056,86761,"ZAF",69409
1,147.0,"Northern Europe",1926866,1880801,46065,1518131,2530218,"GBR",2024175
1,147.0,"Oceania",545334,545334,0,405348,675581,"NZL",540465
1,147.0,"Central America",506998,0,506998,375885,626475,"MEX",501180
1,147.0,"Eastern Africa",291882,0,291882,217480,362467,"ETH",289974
1,147.0,"China",8937421,8937421,0,6705209,11175348,"CPR",8940279
1,147.0,"Eastern Europe",2717062,2633628,83434,2002410,3337350,"POL",2669880
1,147.0,"India",5842808,5842808,0,4337031,7228385,"IND",5782708
1,147.0,"Middle Africa",92913,0,92913,69132,115220,"AGO",92176
1,147.0,"Western Asia",457939,0,457939,341202,568670,"IRQ",454936
1,147.0,"United States of America",2644190,2542934,101256,2015148,3358580,"USA",2686864
1,147.0,"Western Europe",3727893,3543209,184684,2691367,4485612,"NLD",3588490
1,147.0,"Russian Federation",2688214,2570183,118031,1978290,3297151,"RUS",2637721
1,147.0,"Northern Africa",1113836,0,1113836,822822,1371370,"EGY",1097096
1,147.0,"Eastern Asia",815123,0,815123,600287,1000478,"JPN",800383
1,147.0,"Western Africa",336501,0,336501,249888,416480,"NGA",333184
1,147.0,"Southern Europe",800168,0,800168,596340,993900,"ITA",795120
1,148.0,"Northern America",638262,623075,15187,462597,770996,"CAN",616797
1,148.0,"Southern Asia",441073,0,441073,326114,543523,"IRN",434819
1,148.0,"South America",2003550,1819848,183702,1475713,2459522,"BRA",1967618
1,148.0,"Central Asia",1440917,1411143,29774,1060683,1767805,"UZB",1414244
1,148.0,"South-Eastern Asia",779842,0,779842,577857,963095,"IDN",770476
1,148.0,"Pakistan",1632038,1519725,112313,1234669,2057782,"PAK",1646226
1,148.0,"Southern Africa",71149,0,71149,52056,86761,"ZAF",69409
1,148.0,"Northern Europe",1943083,1889129,53954,1518131,2530218,"GBR",2024175
1,148.0,"Oceania",549232,549232,0,405348,675581,"NZL",540465
1,148.0,"Central America",507127,0,507127,375885,626475,"MEX",501180
1,148.0,"Eastern Africa",291929,0,291929,217480,362467,"ETH",289974
1,148.0,"China",8940198,8940198,0,6705209,11175348,"CPR",8940279
1,148.0,"Eastern Europe",2748806,2670531,78275,2002410,3337350,"POL",2669880
1,148.0,"India",5892486,5892486,0,4337031,7228385,"IND",5782708
1,148.0,"Middle Africa",92930,0,92930,69132,115220,"AGO",92176
1,148.0,"Western Asia",458014,0,458014,341202,568670,"IRQ",454936
1,148.0,"United States of America",2693974,2583626,110348,2015148,3358580,"USA",2686864
1,148.0,"Western Europe",3676534,3507508,169026,2691367,4485612,"NLD",3588490
1,148.0,"Russian Federation",2727063,2610300,116763,1978290,3297151,"RUS",2637721
1,148.0,"Northern Africa",1114253,0,1114253,822822,1371370,"EGY",1097096
1,148.0,"Eastern Asia",816358,0,816358,600287,1000478,"JPN",800383
1,148.0,"Western Africa",336583,0,336583,249888,416480,"NGA",333184
1,148.0,"Southern Europe",799902,0,799902,596340,993900,"ITA",795120
1,149.0,"Northern America",634360,619164,15196,462597,770996,"CAN",616797
1,149.0,"Southern Asia",438878,0,438878,326114,543523,"IRN",434819
1,149.0,"South America",1968682,1791676,177006,1475713,2459522,"BRA",1967618
1,149.0,"Central Asia",1412252,1387246,25006,1060683,1767805,"UZB",1414244
1,149.0,"South-Eastern Asia",776602,0,776602,577857,963095,"IDN",770476
1,149.0,"Pakistan",1652383,1533901,118482,1234669,2057782,"PAK",1646226
1,149.0,"Southern Africa",70543,0,70543,52056,86761,"ZAF",69409
1,149.0,"Northern Europe",1967410,1905700,61710,1518131,2530218,"GBR",2024175
1,149.0,"Oceania",539491,539491,0,405348,675581,"NZL",540465
1,149.0,"Central America",505378,0,505378,375885,626475,"MEX",501180
1,149.0,"Eastern Africa",291243,0,291243,217480,362467,"ETH",289974
1,149.0,"China",8941198,8940276,922,6705209,11175348,"CPR",8940279
1,149.0,"Eastern Europe",2665129,2596527,68602,2002410,3337350,"POL",2669880
1,149.0,"India",5771740,5771740,0,4337031,7228385,"IND",5782708
1,149.0,"Middle Africa",92667,0,92667,69132,115220,"AGO",92176
1,149.0,"Western Asia",456933,0,456933,341202,568670,"IRQ",454936
1,149.0,"United States of America",2722427,2612249,110178,2015148,3358580,"USA",2686864
1,149.0,"Western Europe",3603167,3447798,155369,2691367,4485612,"NLD",3588490
1,149.0,"Russian Federation",2635550,2528514,107036,1978290,3297151,"RUS",2637721
1,149.0,"Northern Africa",1108227,0,1108227,822822,1371370,"EGY",1097096
1,149.0,"Eastern Asia",811052,0,811052,600287,1000478,"JPN",800383
1,149.0,"Western Africa",335391,0,335391,249888,416480,"NGA",333184
1,149.0,"Southern Europe",798906,0,798906,596340,993900,"ITA",795120
1,150.0,"Northern America",632408,615649,16759,462597,770996,"CAN",616797
1,150.0,"Southern Asia",437785,0,437785,326114,543523,"IRN",434819
1,150.0,"South America",1960896,1786884,174012,1475713,2459522,"BRA",1967618
1,150.0,"Central Asia",1405589,1385085,20504,1060683,1767805,"UZB",1414244
1,150.0,"South-Eastern Asia",774851,0,774851,577857,963095,"IDN",770476
1,150.0,"Pakistan",1730790,1608605,122185,1234669,2057782,"PAK",1646226
1,150.0,"Southern Africa",70237,0,70237,52056,86761,"ZAF",69409
1,150.0,"Northern Europe",1995792,1926715,69077,1518131,2530218,"GBR",2024175
1,150.0,"Oceania",537543,537543,0,405348,675581,"NZL",540465
1,150.0,"Central America",504180,0,504180,375885,626475,"MEX",501180
1,150.0,"Eastern Africa",290904,0,290904,217480,362467,"ETH",289974
1,150.0,"China",8940305,8940305,0,6705209,11175348,"CPR",8940279
1,150.0,"Eastern Europe",2644299,2584665,59634,2002410,3337350,"POL",2669880
1,150.0,"India",5746211,5746211,0,4337031,7228385,"IND",5782708
1,150.0,"Middle Africa",92537,0,92537,69132,115220,"AGO",92176
1,150.0,"Western Asia",456398,0,456398,341202,568670,"IRQ",454936
1,150.0,"United States of America",2729539,2620220,109319,2015148,3358580,"USA",2686864
1,150.0,"Western Europe",3566482,3422325,144157,2691367,4485612,"NLD",3588490
1,150.0,"Russian Federation",2612902,2512428,100474,1978290,3297151,"RUS",2637721
1,150.0,"Northern Africa",1105231,0,1105231,822822,1371370,"EGY",1097096
1,150.0,"Eastern Asia",808001,0,808001,600287,1000478,"JPN",800383
1,150.0,"Western Africa",334798,0,334798,249888,416480,"NGA",333184
1,150.0,"Southern Europe",798114,0,798114,596340,993900,"ITA",795120
1,151.0,"Northern America",628507,610180,18327,462597,770996,"CAN",616797
1,151.0,"Southern Asia",437791,0,437791,326114,543523,"IRN",434819
1,151.0,"South America",1964063,1792061,172002,1475713,2459522,"BRA",1967618
1,151.0,"Central Asia",1408271,1392064,16207,1060683,1767805,"UZB",1414244
1,151.0,"South-Eastern Asia",774730,0,774730,577857,963095,"IDN",770476
1,151.0,"Pakistan",1708263,1592405,115858,1234669,2057782,"PAK",1646226
1,151.0,"Southern Africa",70241,0,70241,52056,86761,"ZAF",69409
1,151.0,"Northern Europe",2012010,1936157,75853,1518131,2530218,"GBR",2024175
1,151.0,"Oceania",538517,538517,0,405348,675581,"NZL",540465
1,151.0,"Central America",504096,0,504096,375885,626475,"MEX",501180
1,151.0,"Eastern Africa",290905,0,290905,217480,362467,"ETH",289974
1,151.0,"China",8940280,8940280,0,6705209,11175348,"CPR",8940279
1,151.0,"Eastern Europe",2652082,2600509,51573,2002410,3337350,"POL",2669880
1,151.0,"India",5758068,5758068,0,4337031,7228385,"IND",5782708
1,151.0,"Middle Africa",92440,0,92440,69132,115220,"AGO",92176
1,151.0,"Western Asia",456402,0,456402,341202,568670,"IRQ",454936
1,151.0,"United States of America",2729538,2621250,108288,2015148,3358580,"USA",2686864
1,151.0,"Western Europe",3573815,3439801,134014,2691367,4485612,"NLD",3588490
1,151.0,"Russian Federation",2620834,2525632,95202,1978290,3297151,"RUS",2637721
1,151.0,"Northern Africa",1105245,0,1105245,822822,1371370,"EGY",1097096
1,151.0,"Eastern Asia",807780,0,807780,600287,1000478,"JPN",800383
1,151.0,"Western Africa",334800,0,334800,249888,416480,"NGA",333184
1,151.0,"Southern Europe",798010,0,798010,596340,993900,"ITA",795120
1,152.0,"Northern America",628506,608562,19944,462597,770996,"CAN",616797
1,152.0,"Southern Asia",439451,0,439451,326114,543523,"IRN",434819
1,152.0,"South America",1964656,1794515,170141,1475713,2459522,"BRA",1967618
1,152.0,"Central Asia",1408495,1396493,12002,1060683,1767805,"UZB",1414244
1,152.0,"South-Eastern Asia",775296,0,775296,577857,963095,"IDN",770476
1,152.0,"Pakistan",1641307,1535041,106266,1234669,2057782,"PAK",1646226
1,152.0,"Southern Africa",70697,0,70697,52056,86761,"ZAF",69409
1,152.0,"Northern Europe",2247171,2164921,82250,1518131,2530218,"GBR",2024175
1,152.0,"Oceania",538516,538516,0,405348,675581,"NZL",540465
1,152.0,"Central America",505034,0,505034,375885,626475,"MEX",501180
1,152.0,"Eastern Africa",291423,0,291423,217480,362467,"ETH",289974
1,152.0,"China",8940280,8940280,0,6705209,11175348,"CPR",8940279
1,152.0,"Eastern Europe",2652339,2609068,43271,2002410,3337350,"POL",2669880
1,152.0,"India",5758194,5758194,0,4337031,7228385,"IND",5782708
1,152.0,"Middle Africa",92833,0,92833,69132,115220,"AGO",92176
1,152.0,"Western Asia",457215,0,457215,341202,568670,"IRQ",454936
1,152.0,"United States of America",2736650,2622232,114418,2015148,3358580,"USA",2686864
1,152.0,"Western Europe",3573813,3450184,123629,2691367,4485612,"NLD",3588490
1,152.0,"Russian Federation",2621037,2531643,89394,1978290,3297151,"RUS",2637721
1,152.0,"Northern Africa",1109805,0,1109805,822822,1371370,"EGY",1097096
1,152.0,"Eastern Asia",809170,0,809170,600287,1000478,"JPN",800383
1,152.0,"Western Africa",335705,0,335705,249888,416480,"NGA",333184
1,152.0,"Southern Europe",799487,0,799487,596340,993900,"ITA",795120
1,153.0,"Northern America",581677,563794,17883,462597,770996,"CAN",616797
1,153.0,"Southern Asia",448414,0,448414,326114,543523,"IRN",434819
1,153.0,"South America",1999742,1822542,177200,1475713,2459522,"BRA",1967618
1,153.0,"Central Asia",1430857,1422856,8001,1060683,1767805,"UZB",1414244
1,153.0,"South-Eastern Asia",789418,0,789418,577857,963095,"IDN",770476
1,153.0,"Pakistan",1663246,1563359,99887,1234669,2057782,"PAK",1646226
1,153.0,"Southern Africa",73187,0,73187,52056,86761,"ZAF",69409
1,153.0,"Northern Europe",2218793,2136894,81899,1518131,2530218,"GBR",2024175
1,153.0,"Oceania",546309,546309,0,405348,675581,"NZL",540465
1,153.0,"Central America",514144,0,514144,375885,626475,"MEX",501180
1,153.0,"Eastern Africa",294221,0,294221,217480,362467,"ETH",289974
1,153.0,"China",8940280,8940280,0,6705209,11175348,"CPR",8940279
1,153.0,"Eastern Europe",2714284,2682294,31990,2002410,3337350,"POL",2669880
1,153.0,"India",5855211,5855211,0,4337031,7228385,"IND",5782708
1,153.0,"Middle Africa",93812,0,93812,69132,115220,"AGO",92176
1,153.0,"Western Asia",461625,0,461625,341202,568670,"IRQ",454936
1,153.0,"United States of America",3014017,2892913,121104,2015148,3358580,"USA",2686864
1,153.0,"Western Europe",3500447,3387235,113212,2691367,4485612,"NLD",3588490
1,153.0,"Russian Federation",2690215,2606755,83460,1978290,3297151,"RUS",2637721
1,153.0,"Northern Africa",1134409,0,1134409,822822,1371370,"EGY",1097096
1,153.0,"Eastern Asia",833243,0,833243,600287,1000478,"JPN",800383
1,153.0,"Western Africa",340573,0,340573,249888,416480,"NGA",333184
1,153.0,"Southern Europe",806732,0,806732,596340,993900,"ITA",795120
1,154.0,"Northern America",626549,606115,20434,462597,770996,"CAN",616797
1,154.0,"Southern Asia",447504,0,447504,326114,543523,"IRN",434819
1,154.0,"South America",1967186,1787502,179684,1475713,2459522,"BRA",1967618
1,154.0,"Central Asia",1406469,1400043,6426,1060683,1767805,"UZB",1414244
1,154.0,"South-Eastern Asia",788153,0,788153,577857,963095,"IDN",770476
1,154.0,"Pakistan",1633427,1540241,93186,1234669,2057782,"PAK",1646226
1,154.0,"Southern Africa",72940,0,72940,52056,86761,"ZAF",69409
1,154.0,"Northern Europe",2007959,1937321,70638,1518131,2530218,"GBR",2024175
1,154.0,"Oceania",536569,536569,0,405348,675581,"NZL",540465
1,154.0,"Central America",513994,0,513994,375885,626475,"MEX",501180
1,154.0,"Eastern Africa",293937,0,293937,217480,362467,"ETH",289974
1,154.0,"China",8940280,8940280,0,6705209,11175348,"CPR",8940279
1,154.0,"Eastern Europe",2638003,2615857,22146,2002410,3337350,"POL",2669880
1,154.0,"India",5734965,5734965,0,4337031,7228385,"IND",5782708
1,154.0,"Middle Africa",93704,0,93704,69132,115220,"AGO",92176
1,154.0,"Western Asia",461177,0,461177,341202,568670,"IRQ",454936
1,154.0,"United States of America",2907337,2802529,104808,2015148,3358580,"USA",2686864
1,154.0,"Western Europe",3573815,3450311,123504,2691367,4485612,"NLD",3588490
1,154.0,"Russian Federation",2606567,2531937,74630,1978290,3297151,"RUS",2637721
1,154.0,"Northern Africa",1131910,0,1131910,822822,1371370,"EGY",1097096
1,154.0,"Eastern Asia",831043,0,831043,600287,1000478,"JPN",800383
1,154.0,"Western Africa",340079,0,340079,249888,416480,"NGA",333184
1,154.0,"Southern Europe",806999,0,806999,596340,993900,"ITA",795120
1,155.0,"Northern America",642166,621925,20241,462600,771001,"CAN",616801
1,155.0,"Southern Asia",439288,0,439288,326114,543523,"IRN",434819
1,155.0,"South America",1968839,1790520,178319,1475718,2459530,"BRA",1967624
1,155.0,"Central Asia",1411645,1409017,2628,1060684,1767807,"UZB",1414246
1,155.0,"South-Eastern Asia",776701,0,776701,577865,963108,"IDN",770487
1,155.0,"Pakistan",1643337,1553659,89678,1234677,2057796,"PAK",1646237
1,155.0,"Southern Africa",70659,0,70659,52061,86768,"ZAF",69415
1,155.0,"Northern Europe",2020118,1955158,64960,1518135,2530225,"GBR",2024180
1,155.0,"Oceania",539490,539490,0,405357,675595,"NZL",540476
1,155.0,"Central America",505844,0,505844,375893,626488,"MEX",501191
1,155.0,"Eastern Africa",291372,0,291372,217482,362471,"ETH",289977
1,155.0,"China",8940280,8940280,0,6705210,11175351,"CPR",8940281
1,155.0,"Eastern Europe",2662176,2645976,16200,2002416,3337361,"POL",2669889
1,155.0,"India",5770077,5770077,0,4337033,7228388,"IND",5782711
1,155.0,"Middle Africa",92719,0,92719,69140,115233,"AGO",92187
1,155.0,"Western Asia",457138,0,457138,341208,568680,"IRQ",454944
1,155.0,"United States of America",2701090,2609604,91486,2015151,3358586,"USA",2686869
1,155.0,"Western Europe",3617836,3486957,130879,2691369,4485616,"NLD",3588493
1,155.0,"Russian Federation",2627003,2559799,67204,1978293,3297156,"RUS",2637725
1,155.0,"Northern Africa",1109355,0,1109355,822829,1371382,"EGY",1097106
1,155.0,"Eastern Asia",811182,0,811182,600294,1000491,"JPN",800393
1,155.0,"Western Africa",335613,0,335613,249896,416493,"NGA",333195
1,155.0,"Southern Europe",799379,0,799379,596342,993903,"ITA",795123
1,156.0,"Northern America",638264,618529,19735,582852,971420,"CAN",777136
1,156.0,"Southern Asia",438365,0,438365,246203,410338,"IRN",328271
1,156.0,"South America",1967950,1792096,175854,1490019,2483365,"BRA",1986692
1,156.0,"Central Asia",1411388,1411388,0,1105047,1841745,"UZB",1473396
1,156.0,"South-Eastern Asia",775416,0,775416,785642,1309403,"IDN",1047523
1,156.0,"Pakistan",1644210,1558074,86136,1309280,2182133,"PAK",1745707
1,156.0,"Southern Africa",70399,0,70399,85858,143097,"ZAF",114478
1,156.0,"Northern Europe",2020119,1961143,58976,1579578,2632631,"GBR",2106105
1,156.0,"Oceania",539491,539491,0,429351,715585,"NZL",572468
1,156.0,"Central America",504773,0,504773,405351,675585,"MEX",540468
1,156.0,"Eastern Africa",291086,0,291086,181521,302535,"ETH",242028
1,156.0,"China",8940280,8940280,0,6743456,11239093,"CPR",8991275
1,156.0,"Eastern Europe",2664041,2653194,10847,2620725,4367876,"POL",3494301
1,156.0,"India",5770447,5770447,0,4548952,7581587,"IND",6065270
1,156.0,"Middle Africa",92606,0,92606,75163,125272,"AGO",100218
1,156.0,"Western Asia",456684,0,456684,448245,747076,"IRQ",597661
1,156.0,"United States of America",2679755,2596636,83119,2023456,3372427,"USA",2697942
1,156.0,"Western Europe",3639850,3505501,134349,2923180,4871967,"NLD",3897574
1,156.0,"Russian Federation",2632740,2568916,63824,2726607,4544345,"RUS",3635476
1,156.0,"Northern Africa",1106828,0,1106828,907674,1512791,"EGY",1210233
1,156.0,"Eastern Asia",808952,0,808952,627604,1046007,"JPN",836806
1,156.0,"Western Africa",335114,0,335114,280808,468013,"NGA",374411
1,156.0,"Southern Europe",798446,0,798446,664310,1107183,"ITA",885747
1,157.0,"Northern America",638267,618960,19307,582852,971420,"CAN",777136
1,157.0,"Southern Asia",435589,0,435589,246203,410338,"IRN",328271
1,157.0,"South America",1437345,1266417,170928,1490019,2483365,"BRA",1986692
1,157.0,"Central Asia",1406797,1405846,951,1105047,1841745,"UZB",1473396
1,157.0,"South-Eastern Asia",771556,0,771556,785642,1309403,"IDN",1047523
1,157.0,"Pakistan",1636694,1555697,80997,1309280,2182133,"PAK",1745707
1,157.0,"Southern Africa",69633,0,69633,85858,143097,"ZAF",114478
1,157.0,"Northern Europe",2012014,1959277,52737,1579578,2632631,"GBR",2106105
1,157.0,"Oceania",537554,537554,0,429351,715585,"NZL",572468
1,157.0,"Central America",502319,0,502319,405351,675585,"MEX",540468
1,157.0,"Eastern Africa",290220,0,290220,181521,302535,"ETH",242028
1,157.0,"China",8940280,8940280,0,6743456,11239093,"CPR",8991275
1,157.0,"Eastern Europe",2645193,2644918,275,2620725,4367876,"POL",3494301
1,157.0,"India",5746199,5746199,0,4548952,7581587,"IND",6065270
1,157.0,"Middle Africa",92284,0,92284,75163,125272,"AGO",100218
1,157.0,"Western Asia",455322,0,455322,448245,747076,"IRQ",597661
1,157.0,"United States of America",2665531,2590367,75164,2023456,3372427,"USA",2697942
1,157.0,"Western Europe",3588494,3466253,122241,2923180,4871967,"NLD",3897574
1,157.0,"Russian Federation",2615793,2558449,57344,2726607,4544345,"RUS",3635476
1,157.0,"Northern Africa",1099209,0,1099209,907674,1512791,"EGY",1210233
1,157.0,"Eastern Asia",802246,0,802246,627604,1046007,"JPN",836806
1,157.0,"Western Africa",333613,0,333613,280808,468013,"NGA",374411
1,157.0,"Southern Europe",796148,0,796148,664310,1107183,"ITA",885747
1,158.0,"Northern America",667861,648442,19419,582852,971420,"CAN",777136
1,158.0,"Southern Asia",303892,0,303892,246203,410338,"IRN",328271
1,158.0,"South America",1497629,1273915,223714,1490019,2483365,"BRA",1986692
1,158.0,"Central Asia",1471317,1471160,157,1105047,1841745,"UZB",1473396
1,158.0,"South-Eastern Asia",1013534,0,1013534,785642,1309403,"IDN",1047523
1,158.0,"Pakistan",1711670,1632388,79282,1309280,2182133,"PAK",1745707
1,158.0,"Southern Africa",107788,0,107788,85858,143097,"ZAF",114478
1,158.0,"Northern Europe",2106103,2058051,48052,1579578,2632631,"GBR",2106105
1,158.0,"Oceania",551037,551037,0,429351,715585,"NZL",572468
1,158.0,"Central America",518598,0,518598,405351,675585,"MEX",540468
1,158.0,"Eastern Africa",234424,0,234424,181521,302535,"ETH",242028
1,158.0,"China",8946010,8946010,0,6743456,11239093,"CPR",8991275
1,158.0,"Eastern Europe",2668473,2667398,1075,2620725,4367876,"POL",3494301
1,158.0,"India",6061904,6061904,0,4548952,7581587,"IND",6065270
1,158.0,"Middle Africa",97243,0,97243,75163,125272,"AGO",100218
1,158.0,"Western Asia",585662,0,585662,448245,747076,"IRQ",597661
1,158.0,"United States of America",2690827,2623190,67637,2023456,3372427,"USA",2697942
1,158.0,"Western Europe",3611435,3493507,117928,2923180,4871967,"NLD",3897574
1,158.0,"Russian Federation",3242589,3175074,67515,2726607,4544345,"RUS",3635476
1,158.0,"Northern Africa",1143287,0,1143287,907674,1512791,"EGY",1210233
1,158.0,"Eastern Asia",777849,0,777849,627604,1046007,"JPN",836806
1,158.0,"Western Africa",361525,0,361525,280808,468013,"NGA",374411
1,158.0,"Southern Europe",864791,0,864791,664310,1107183,"ITA",885747
1,159.0,"Northern America",712741,691399,21342,582852,971420,"CAN",777136
1,159.0,"Southern Asia",304536,0,304536,246203,410338,"IRN",328271
1,159.0,"South America",1542925,1273509,269416,1490019,2483365,"BRA",1986692
1,159.0,"Central Asia",1459491,1459491,0,1105047,1841745,"UZB",1473396
1,159.0,"South-Eastern Asia",1014445,0,1014445,785642,1309403,"IDN",1047523
1,159.0,"Pakistan",1702966,1626598,76368,1309280,2182133,"PAK",1745707
1,159.0,"Southern Africa",107880,0,107880,85858,143097,"ZAF",114478
1,159.0,"Northern Europe",2085832,2044098,41734,1579578,2632631,"GBR",2106105
1,159.0,"Oceania",546167,546167,0,429351,715585,"NZL",572468
1,159.0,"Central America",520117,0,520117,405351,675585,"MEX",540468
1,159.0,"Eastern Africa",234618,0,234618,181521,302535,"ETH",242028
1,159.0,"China",8924250,8924250,0,6743456,11239093,"CPR",8991275
1,159.0,"Eastern Europe",2685606,2671438,14168,2620725,4367876,"POL",3494301
1,159.0,"India",6004599,6004599,0,4548952,7581587,"IND",6065270
1,159.0,"Middle Africa",97362,0,97362,75163,125272,"AGO",100218
1,159.0,"Western Asia",585984,0,585984,448245,747076,"IRQ",597661
1,159.0,"United States of America",2605486,2545833,59653,2023456,3372427,"USA",2697942
1,159.0,"Western Europe",3648119,3523568,124551,2923180,4871967,"NLD",3897574
1,159.0,"Russian Federation",3256380,3181575,74805,2726607,4544345,"RUS",3635476
1,159.0,"Northern Africa",1145082,0,1145082,907674,1512791,"EGY",1210233
1,159.0,"Eastern Asia",779426,0,779426,627604,1046007,"JPN",836806
1,159.0,"Western Africa",362811,0,362811,280808,468013,"NGA",374411
1,159.0,"Southern Europe",866876,0,866876,664310,1107183,"ITA",885747
1,160.0,"Northern America",730301,707828,22473,582852,971420,"CAN",777136
1,160.0,"Southern Asia",304534,0,304534,246203,410338,"IRN",328271
1,160.0,"South America",1584052,1275301,308751,1490019,2483365,"BRA",1986692
1,160.0,"Central Asia",1472930,1472930,0,1105047,1841745,"UZB",1473396
1,160.0,"South-Eastern Asia",1014442,0,1014442,785642,1309403,"IDN",1047523
1,160.0,"Pakistan",1696214,1618493,77721,1309280,2182133,"PAK",1745707
1,160.0,"Southern Africa",107882,0,107882,85858,143097,"ZAF",114478
1,160.0,"Northern Europe",2097995,2062320,35675,1579578,2632631,"GBR",2106105
1,160.0,"Oceania",541295,539519,1776,429351,715585,"NZL",572468
1,160.0,"Central America",520670,0,520670,405351,675585,"MEX",540468
1,160.0,"Eastern Africa",234616,0,234616,181521,302535,"ETH",242028
1,160.0,"China",8923643,8923643,0,6743456,11239093,"CPR",8991275
1,160.0,"Eastern Europe",2718932,2690181,28751,2620725,4367876,"POL",3494301
1,160.0,"India",5955486,5955486,0,4548952,7581587,"IND",6065270
1,160.0,"Middle Africa",97362,0,97362,75163,125272,"AGO",100218
1,160.0,"Western Asia",585983,0,585983,448245,747076,"IRQ",597661
1,160.0,"United States of America",2562812,2510020,52792,2023456,3372427,"USA",2697942
1,160.0,"Western Europe",3677466,3547141,130325,2923180,4871967,"NLD",3897574
1,160.0,"Russian Federation",3274651,3182899,91752,2726607,4544345,"RUS",3635476
1,160.0,"Northern Africa",1151939,0,1151939,907674,1512791,"EGY",1210233
1,160.0,"Eastern Asia",779426,0,779426,627604,1046007,"JPN",836806
1,160.0,"Western Africa",363133,0,363133,280808,468013,"NGA",374411
1,160.0,"Southern Europe",867390,0,867390,664310,1107183,"ITA",885747
1,161.0,"Northern America",738109,714813,23296,582852,971420,"CAN",777136
1,161.0,"Southern Asia",303896,0,303896,246203,410338,"IRN",328271
1,161.0,"South America",1621173,1276607,344566,1490019,2483365,"BRA",1986692
1,161.0,"Central Asia",1451243,1451243,0,1105047,1841745,"UZB",1473396
1,161.0,"South-Eastern Asia",1013551,0,1013551,785642,1309403,"IDN",1047523
1,161.0,"Pakistan",1699026,1614395,84631,1309280,2182133,"PAK",1745707
1,161.0,"Southern Africa",107703,0,107703,85858,143097,"ZAF",114478
1,161.0,"Northern Europe",2045286,2015844,29442,1579578,2632631,"GBR",2106105
1,161.0,"Oceania",538373,534741,3632,429351,715585,"NZL",572468
1,161.0,"Central America",520386,0,520386,405351,675585,"MEX",540468
1,161.0,"Eastern Africa",234416,0,234416,181521,302535,"ETH",242028
1,161.0,"China",8901705,8901705,0,6743456,11239093,"CPR",8991275
1,161.0,"Eastern Europe",2744380,2700415,43965,2620725,4367876,"POL",3494301
1,161.0,"India",5954968,5954968,0,4548952,7581587,"IND",6065270
1,161.0,"Middle Africa",97285,0,97285,75163,125272,"AGO",100218
1,161.0,"Western Asia",585671,0,585671,448245,747076,"IRQ",597661
1,161.0,"United States of America",2534365,2488141,46224,2023456,3372427,"USA",2697942
1,161.0,"Western Europe",3699478,3564058,135420,2923180,4871967,"NLD",3897574
1,161.0,"Russian Federation",3301227,3192686,108541,2726607,4544345,"RUS",3635476
1,161.0,"Northern Africa",1151614,0,1151614,907674,1512791,"EGY",1210233
1,161.0,"Eastern Asia",777878,0,777878,627604,1046007,"JPN",836806
1,161.0,"Western Africa",362972,0,362972,280808,468013,"NGA",374411
1,161.0,"Southern Europe",867119,0,867119,664310,1107183,"ITA",885747
1,162.0,"Northern America",740059,716078,23981,582852,971420,"CAN",777136
1,162.0,"Southern Asia",303736,0,303736,246203,410338,"IRN",328271
1,162.0,"South America",1654582,1277805,376777,1490019,2483365,"BRA",1986692
1,162.0,"Central Asia",1483722,1483722,0,1105047,1841745,"UZB",1473396
1,162.0,"South-Eastern Asia",1013331,0,1013331,785642,1309403,"IDN",1047523
1,162.0,"Pakistan",1645535,1553991,91544,1309280,2182133,"PAK",1745707
1,162.0,"Southern Africa",107656,0,107656,85858,143097,"ZAF",114478
1,162.0,"Northern Europe",2000687,1977060,23627,1579578,2632631,"GBR",2106105
1,162.0,"Oceania",536424,530851,5573,429351,715585,"NZL",572468
1,162.0,"Central America",520432,0,520432,405351,675585,"MEX",540468
1,162.0,"Eastern Africa",234367,0,234367,181521,302535,"ETH",242028
1,162.0,"China",8901093,8901093,0,6743456,11239093,"CPR",8991275
1,162.0,"Eastern Europe",2778488,2717926,60562,2620725,4367876,"POL",3494301
1,162.0,"India",5954962,5954962,0,4548952,7581587,"IND",6065270
1,162.0,"Middle Africa",97360,0,97360,75163,125272,"AGO",100218
1,162.0,"Western Asia",585588,0,585588,448245,747076,"IRQ",597661
1,162.0,"United States of America",2527253,2487599,39654,2023456,3372427,"USA",2697942
1,162.0,"Western Europe",3714150,3574145,140005,2923180,4871967,"NLD",3897574
1,162.0,"Russian Federation",3328391,3203402,124989,2726607,4544345,"RUS",3635476
1,162.0,"Northern Africa",1151762,0,1151762,907674,1512791,"EGY",1210233
1,162.0,"Eastern Asia",777494,0,777494,627604,1046007,"JPN",836806
1,162.0,"Western Africa",362997,0,362997,280808,468013,"NGA",374411
1,162.0,"Southern Europe",867165,0,867165,664310,1107183,"ITA",885747
1,163.0,"Northern America",740059,715427,24632,582852,971420,"CAN",777136
1,163.0,"Southern Asia",303718,0,303718,246203,410338,"IRN",328271
1,163.0,"South America",1684329,1278978,405351,1490019,2483365,"BRA",1986692
1,163.0,"Central Asia",1462674,1462674,0,1105047,1841745,"UZB",1473396
1,163.0,"South-Eastern Asia",1013306,0,1013306,785642,1309403,"IDN",1047523
1,163.0,"Pakistan",1649133,1548549,100584,1309280,2182133,"PAK",1745707
1,163.0,"Southern Africa",107652,0,107652,85858,143097,"ZAF",114478
1,163.0,"Northern Europe",1992577,1971954,20623,1579578,2632631,"GBR",2106105
1,163.0,"Oceania",534475,526875,7600,429351,715585,"NZL",572468
1,163.0,"Central America",520624,0,520624,405351,675585,"MEX",540468
1,163.0,"Eastern Africa",234361,0,234361,181521,302535,"ETH",242028
1,163.0,"China",8879156,8879156,0,6743456,11239093,"CPR",8991275
1,163.0,"Eastern Europe",2813057,2734701,78356,2620725,4367876,"POL",3494301
1,163.0,"India",5942835,5941522,1313,4548952,7581587,"IND",6065270
1,163.0,"Middle Africa",97266,0,97266,75163,125272,"AGO",100218
1,163.0,"Western Asia",585580,0,585580,448245,747076,"IRQ",597661
1,163.0,"United States of America",2527252,2490423,36829,2023456,3372427,"USA",2697942
1,163.0,"Western Europe",3721487,3577237,144250,2923180,4871967,"NLD",3897574
1,163.0,"Russian Federation",3355942,3214622,141320,2726607,4544345,"RUS",3635476
1,163.0,"Northern Africa",1152317,0,1152317,907674,1512791,"EGY",1210233
1,163.0,"Eastern Asia",777452,0,777452,627604,1046007,"JPN",836806
1,163.0,"Western Africa",363124,0,363124,280808,468013,"NGA",374411
1,163.0,"Southern Europe",867345,0,867345,664310,1107183,"ITA",885747
1,164.0,"Northern America",742012,714887,27125,582852,971420,"CAN",777136
1,164.0,"Southern Asia",303774,0,303774,246203,410338,"IRN",328271
1,164.0,"South America",1710755,1280136,430619,1490019,2483365,"BRA",1986692
1,164.0,"Central Asia",1448132,1448132,0,1105047,1841745,"UZB",1473396
1,164.0,"South-Eastern Asia",1013630,0,1013630,785642,1309403,"IDN",1047523
1,164.0,"Pakistan",1652471,1542792,109679,1309280,2182133,"PAK",1745707
1,164.0,"Southern Africa",107668,0,107668,85858,143097,"ZAF",114478
1,164.0,"Northern Europe",1891214,1869802,21412,1579578,2632631,"GBR",2106105
1,164.0,"Oceania",533501,523783,9718,429351,715585,"NZL",572468
1,164.0,"Central America",521259,0,521259,405351,675585,"MEX",540468
1,164.0,"Eastern Africa",234378,0,234378,181521,302535,"ETH",242028
1,164.0,"China",8856623,8856623,0,6743456,11239093,"CPR",8991275
1,164.0,"Eastern Europe",3219548,3123493,96055,2620725,4367876,"POL",3494301
1,164.0,"India",5942707,5936183,6524,4548952,7581587,"IND",6065270
1,164.0,"Middle Africa",97273,0,97273,75163,125272,"AGO",100218
1,164.0,"Western Asia",585610,0,585610,448245,747076,"IRQ",597661
1,164.0,"United States of America",2527252,2489005,38247,2023456,3372427,"USA",2697942
1,164.0,"Western Europe",3736161,3587836,148325,2923180,4871967,"NLD",3897574
1,164.0,"Russian Federation",3383731,3226097,157634,2726607,4544345,"RUS",3635476
1,164.0,"Northern Africa",1152783,0,1152783,907674,1512791,"EGY",1210233
1,164.0,"Eastern Asia",779375,0,779375,627604,1046007,"JPN",836806
1,164.0,"Western Africa",363201,0,363201,280808,468013,"NGA",374411
1,164.0,"Southern Europe",867493,0,867493,664310,1107183,"ITA",885747
1,165.0,"Northern America",919574,889400,30174,582852,971420,"CAN",777136
1,165.0,"Southern Asia",340149,0,340149,246203,410338,"IRN",328271
1,165.0,"South America",1769212,1280971,488241,1490019,2483365,"BRA",1986692
1,165.0,"Central Asia",1458715,1458715,0,1105047,1841745,"UZB",1473396
1,165.0,"South-Eastern Asia",1065484,0,1065484,785642,1309403,"IDN",1047523
1,165.0,"Pakistan",1655797,1536978,118819,1309280,2182133,"PAK",1745707
1,165.0,"Southern Africa",117776,0,117776,85858,143097,"ZAF",114478
1,165.0,"Northern Europe",1891215,1868307,22908,1579578,2632631,"GBR",2106105
1,165.0,"Oceania",535450,523531,11919,429351,715585,"NZL",572468
1,165.0,"Central America",556256,0,556256,405351,675585,"MEX",540468
1,165.0,"Eastern Africa",245731,0,245731,181521,302535,"ETH",242028
1,165.0,"China",7935359,7935359,0,6743456,11239093,"CPR",8991275
1,165.0,"Eastern Europe",3245289,3128579,116710,2620725,4367876,"POL",3494301
1,165.0,"India",5954833,5939171,15662,4548952,7581587,"IND",6065270
1,165.0,"Middle Africa",101637,0,101637,75163,125272,"AGO",100218
1,165.0,"Western Asia",603502,0,603502,448245,747076,"IRQ",597661
1,165.0,"United States of America",2769058,2729394,39664,2023456,3372427,"USA",2697942
1,165.0,"Western Europe",3816867,3664807,152060,2923180,4871967,"NLD",3897574
1,165.0,"Russian Federation",3936512,3757138,179374,2726607,4544345,"RUS",3635476
1,165.0,"Northern Africa",1252071,0,1252071,907674,1512791,"EGY",1210233
1,165.0,"Eastern Asia",867813,0,867813,627604,1046007,"JPN",836806
1,165.0,"Western Africa",382853,0,382853,280808,468013,"NGA",374411
1,165.0,"Southern Europe",899759,0,899759,664310,1107183,"ITA",885747
1,166.0,"Northern America",839580,812325,27255,582852,971420,"CAN",777136
1,166.0,"Southern Asia",335761,0,335761,246203,410338,"IRN",328271
1,166.0,"South America",1814226,1283269,530957,1490019,2483365,"BRA",1986692
1,166.0,"Central Asia",1185122,1185122,0,1105047,1841745,"UZB",1473396
1,166.0,"South-Eastern Asia",1059568,0,1059568,785642,1309403,"IDN",1047523
1,166.0,"Pakistan",1668585,1540599,127986,1309280,2182133,"PAK",1745707
1,166.0,"Southern Africa",116562,0,116562,85858,143097,"ZAF",114478
1,166.0,"Northern Europe",1903378,1878804,24574,1579578,2632631,"GBR",2106105
1,166.0,"Oceania",564673,550511,14162,429351,715585,"NZL",572468
1,166.0,"Central America",549944,0,549944,405351,675585,"MEX",540468
1,166.0,"Eastern Africa",244370,0,244370,181521,302535,"ETH",242028
1,166.0,"China",7953462,7945780,7682,6743456,11239093,"CPR",8991275
1,166.0,"Eastern Europe",3311085,3157804,153281,2620725,4367876,"POL",3494301
1,166.0,"India",5942833,5932971,9862,4548952,7581587,"IND",6065270
1,166.0,"Middle Africa",101121,0,101121,75163,125272,"AGO",100218
1,166.0,"Western Asia",601346,0,601346,448245,747076,"IRQ",597661
1,166.0,"United States of America",2754840,2717427,37413,2023456,3372427,"USA",2697942
1,166.0,"Western Europe",3875561,3721634,153927,2923180,4871967,"NLD",3897574
1,166.0,"Russian Federation",3956513,3765625,190888,2726607,4544345,"RUS",3635476
1,166.0,"Northern Africa",1234712,0,1234712,907674,1512791,"EGY",1210233
1,166.0,"Eastern Asia",857784,0,857784,627604,1046007,"JPN",836806
1,166.0,"Western Africa",379147,0,379147,280808,468013,"NGA",374411
1,166.0,"Southern Europe",893413,0,893413,664310,1107183,"ITA",885747
1,167.0,"Northern America",802505,778751,23754,582852,971421,"CAN",777137
1,167.0,"Southern Asia",332796,0,332796,246204,410341,"IRN",328273
1,167.0,"South America",1849225,1285695,563530,1490027,2483378,"BRA",1986703
1,167.0,"Central Asia",1209168,1204132,5036,1105053,1841755,"UZB",1473404
1,167.0,"South-Eastern Asia",1055254,0,1055254,785646,1309411,"IDN",1047529
1,167.0,"Pakistan",1691318,1554587,136731,1309286,2182143,"PAK",1745715
1,167.0,"Southern Africa",115709,0,115709,85861,143102,"ZAF",114482
1,167.0,"Northern Europe",1923651,1890973,32678,1579584,2632641,"GBR",2106113
1,167.0,"Oceania",578310,562308,16002,429355,715592,"NZL",572474
1,167.0,"Central America",545374,0,545374,405357,675595,"MEX",540476
1,167.0,"Eastern Africa",243441,0,243441,181527,302546,"ETH",242037
1,167.0,"China",7975887,7950825,25062,6743463,11239106,"CPR",8991285
1,167.0,"Eastern Europe",3361426,3181688,179738,2620732,4367887,"POL",3494310
1,167.0,"India",5833563,5833563,0,4548957,7581596,"IND",6065277
1,167.0,"Middle Africa",100767,0,100767,75166,125277,"AGO",100222
1,167.0,"Western Asia",599890,0,599890,448248,747080,"IRQ",597664
1,167.0,"United States of America",2733504,2702329,31175,2023464,3372441,"USA",2697953
1,167.0,"Western Europe",3897571,3743137,154434,2923184,4871973,"NLD",3897579
1,167.0,"Russian Federation",3950057,3766749,183308,2726609,4544348,"RUS",3635479
1,167.0,"Northern Africa",1221759,0,1221759,907678,1512797,"EGY",1210238
1,167.0,"Eastern Asia",850270,0,850270,627611,1046018,"JPN",836815
1,167.0,"Western Africa",376626,0,376626,280811,468018,"NGA",374415
1,167.0,"Southern Europe",889318,0,889318,664311,1107186,"ITA",885749
1,168.0,"Northern America",769334,748338,20996,490386,817310,"CAN",653848
1,168.0,"Southern Asia",329702,0,329702,255829,426382,"IRN",341106
1,168.0,"South America",1874687,1287180,587507,1423938,2373231,"BRA",1898585
1,168.0,"Central Asia",1243179,1232663,10516,1152527,1920878,"UZB",1536703
1,168.0,"South-Eastern Asia",1050223,0,1050223,702500,1170833,"IDN",936667
1,168.0,"Pakistan",1695625,1556420,139205,1262535,2104225,"PAK",1683380
1,168.0,"Southern Africa",115027,0,115027,88632,147721,"ZAF",118177
1,168.0,"Northern Europe",1935813,1894900,40913,1532297,2553828,"GBR",2043063
1,168.0,"Oceania",584081,568250,15831,452909,754848,"NZL",603879
1,168.0,"Central America",541189,0,541189,391149,651916,"MEX",521533
1,168.0,"Eastern Africa",242345,0,242345,207168,345281,"ETH",276225
1,168.0,"China",7998434,7943032,55402,6345839,10576398,"CPR",8461119
1,168.0,"Eastern Europe",3404052,3206771,197281,2373705,3956176,"POL",3164941
1,168.0,"India",5783903,5783903,0,4151478,6919130,"IND",5535304
1,168.0,"Middle Africa",100344,0,100344,73038,121731,"AGO",97385
1,168.0,"Western Asia",598156,0,598156,324147,540246,"IRQ",432197
1,168.0,"United States of America",2719280,2692571,26709,1890547,3150912,"USA",2520730
1,168.0,"Western Europe",3904910,3750476,154434,3104968,5174947,"NLD",4139958
1,168.0,"Russian Federation",3934468,3765113,169355,2288659,3814432,"RUS",3051546
1,168.0,"Northern Africa",1211810,0,1211810,1004696,1674493,"EGY",1339595
1,168.0,"Eastern Asia",841526,0,841526,590778,984630,"JPN",787704
1,168.0,"Western Africa",374297,0,374297,358696,597827,"NGA",478262
1,168.0,"Southern Europe",885529,0,885529,847699,1412832,"ITA",1130266
1,169.0,"Northern America",755673,736519,19154,490386,817310,"CAN",653848
1,169.0,"Southern Asia",352073,0,352073,255829,426382,"IRN",341106
1,169.0,"South America",2548349,1922158,626191,1423938,2373231,"BRA",1898585
1,169.0,"Central Asia",1293290,1274912,18378,1152527,1920878,"UZB",1536703
1,169.0,"South-Eastern Asia",1080687,0,1080687,702500,1170833,"IDN",936667
1,169.0,"Pakistan",1698678,1554367,144311,1262535,2104225,"PAK",1683380
1,169.0,"Southern Africa",121098,0,121098,88632,147721,"ZAF",118177
1,169.0,"Northern Europe",1943929,1901227,42702,1532297,2553828,"GBR",2043063
1,169.0,"Oceania",803343,785905,17438,452909,754848,"NZL",603879
1,169.0,"Central America",538622,0,538622,391149,651916,"MEX",521533
1,169.0,"Eastern Africa",249192,0,249192,207168,345281,"ETH",276225
1,169.0,"China",8042913,7957328,85585,6345839,10576398,"CPR",8461119
1,169.0,"Eastern Europe",3448596,3225180,223416,2373705,3956176,"POL",3164941
1,169.0,"India",5771260,5771260,0,4151478,6919130,"IND",5535304
1,169.0,"Middle Africa",102974,0,102974,73038,121731,"AGO",97385
1,169.0,"Western Asia",608941,0,608941,324147,540246,"IRQ",432197
1,169.0,"United States of America",2705067,2683581,21486,1890547,3150912,"USA",2520730
1,169.0,"Western Europe",3897582,3743315,154267,3104968,5174947,"NLD",4139958
1,169.0,"Russian Federation",3886156,3734521,151635,2288659,3814432,"RUS",3051546
1,169.0,"Northern Africa",1223129,0,1223129,1004696,1674493,"EGY",1339595
1,169.0,"Eastern Asia",894300,0,894300,590778,984630,"JPN",787704
1,169.0,"Western Africa",373935,0,373935,358696,597827,"NGA",478262
1,169.0,"Southern Europe",883213,0,883213,847699,1412832,"ITA",1130266
1,170.0,"Northern America",694828,679035,15793,490386,817310,"CAN",653848
1,170.0,"Southern Asia",345240,0,345240,255829,426382,"IRN",341106
1,170.0,"South America",2469129,1925759,543370,1423938,2373231,"BRA",1898585
1,170.0,"Central Asia",1362207,1332205,30002,1152527,1920878,"UZB",1536703
1,170.0,"South-Eastern Asia",943021,0,943021,702500,1170833,"IDN",936667
1,170.0,"Pakistan",1699506,1556316,143190,1262535,2104225,"PAK",1683380
1,170.0,"Southern Africa",119319,0,119319,88632,147721,"ZAF",118177
1,170.0,"Northern Europe",1937644,1893901,43743,1532297,2553828,"GBR",2043063
1,170.0,"Oceania",600001,587538,12463,452909,754848,"NZL",603879
1,170.0,"Central America",524708,0,524708,391149,651916,"MEX",521533
1,170.0,"Eastern Africa",277281,0,277281,207168,345281,"ETH",276225
1,170.0,"China",8076216,7963208,113008,6345839,10576398,"CPR",8461119
1,170.0,"Eastern Europe",3455884,3233679,222205,2373705,3956176,"POL",3164941
1,170.0,"India",5778705,5764141,14564,4151478,6919130,"IND",5535304
1,170.0,"Middle Africa",97800,0,97800,73038,121731,"AGO",97385
1,170.0,"Western Asia",433870,0,433870,324147,540246,"IRQ",432197
1,170.0,"United States of America",2641636,2628270,13366,1890547,3150912,"USA",2520730
1,170.0,"Western Europe",3927186,3767310,159876,3104968,5174947,"NLD",4139958
1,170.0,"Russian Federation",3561817,3445994,115823,2288659,3814432,"RUS",3051546
1,170.0,"Northern Africa",1348908,0,1348908,1004696,1674493,"EGY",1339595
1,170.0,"Eastern Asia",818753,0,818753,590778,984630,"JPN",787704
1,170.0,"Western Africa",480104,0,480104,358696,597827,"NGA",478262
1,170.0,"Southern Europe",1132084,0,1132084,847699,1412832,"ITA",1130266
1,171.0,"Northern America",677265,662035,15230,490386,817310,"CAN",653848
1,171.0,"Southern Asia",343860,0,343860,255829,426382,"IRN",341106
1,171.0,"South America",2409823,1926226,483597,1423938,2373231,"BRA",1898585
1,171.0,"Central Asia",1422094,1378480,43614,1152527,1920878,"UZB",1536703
1,171.0,"South-Eastern Asia",940450,0,940450,702500,1170833,"IDN",936667
1,171.0,"Pakistan",1698872,1557516,141356,1262535,2104225,"PAK",1683380
1,171.0,"Southern Africa",118944,0,118944,88632,147721,"ZAF",118177
1,171.0,"Northern Europe",1945752,1900903,44849,1532297,2553828,"GBR",2043063
1,171.0,"Oceania",592187,581484,10703,452909,754848,"NZL",603879
1,171.0,"Central America",525441,0,525441,391149,651916,"MEX",521533
1,171.0,"Eastern Africa",276906,0,276906,207168,345281,"ETH",276225
1,171.0,"China",8119343,7980226,139117,6345839,10576398,"CPR",8461119
1,171.0,"Eastern Europe",3471917,3243727,228190,2373705,3956176,"POL",3164941
1,171.0,"India",5791478,5762232,29246,4151478,6919130,"IND",5535304
1,171.0,"Middle Africa",97725,0,97725,73038,121731,"AGO",97385
1,171.0,"Western Asia",433270,0,433270,324147,540246,"IRQ",432197
1,171.0,"United States of America",2634524,2622224,12300,1890547,3150912,"USA",2520730
1,171.0,"Western Europe",3985882,3821082,164800,3104968,5174947,"NLD",4139958
1,171.0,"Russian Federation",2978810,2882989,95821,2288659,3814432,"RUS",3051546
1,171.0,"Northern Africa",1347093,0,1347093,1004696,1674493,"EGY",1339595
1,171.0,"Eastern Asia",811450,0,811450,590778,984630,"JPN",787704
1,171.0,"Western Africa",479444,0,479444,358696,597827,"NGA",478262
1,171.0,"Southern Europe",1132204,0,1132204,847699,1412832,"ITA",1130266
1,172.0,"Northern America",667508,654519,12989,490386,817310,"CAN",653848
1,172.0,"Southern Asia",344302,0,344302,255829,426382,"IRN",341106
1,172.0,"South America",2360024,1929216,430808,1423938,2373231,"BRA",1898585
1,172.0,"Central Asia",1472025,1417052,54973,1152527,1920878,"UZB",1536703
1,172.0,"South-Eastern Asia",941079,0,941079,702500,1170833,"IDN",936667
1,172.0,"Pakistan",1696696,1556134,140562,1262535,2104225,"PAK",1683380
1,172.0,"Southern Africa",119064,0,119064,88632,147721,"ZAF",118177
1,172.0,"Northern Europe",1953861,1907991,45870,1532297,2553828,"GBR",2043063
1,172.0,"Oceania",603876,594854,9022,452909,754848,"NZL",603879
1,172.0,"Central America",524664,0,524664,391149,651916,"MEX",521533
1,172.0,"Eastern Africa",277002,0,277002,207168,345281,"ETH",276225
1,172.0,"China",8167595,7999021,168574,6345839,10576398,"CPR",8461119
1,172.0,"Eastern Europe",3486943,3255277,231666,2373705,3956176,"POL",3164941
1,172.0,"India",5525583,5483538,42045,4151478,6919130,"IND",5535304
1,172.0,"Middle Africa",97712,0,97712,73038,121731,"AGO",97385
1,172.0,"Western Asia",433516,0,433516,324147,540246,"IRQ",432197
1,172.0,"United States of America",2613186,2604786,8400,1890547,3150912,"USA",2520730
1,172.0,"Western Europe",4029901,3861538,168363,3104968,5174947,"NLD",4139958
1,172.0,"Russian Federation",3046937,2959024,87913,2288659,3814432,"RUS",3051546
1,172.0,"Northern Africa",1348342,0,1348342,1004696,1674493,"EGY",1339595
1,172.0,"Eastern Asia",807890,0,807890,590778,984630,"JPN",787704
1,172.0,"Western Africa",479718,0,479718,358696,597827,"NGA",478262
1,172.0,"Southern Europe",1132653,0,1132653,847699,1412832,"ITA",1130266
1,173.0,"Northern America",667509,656619,10890,490386,817310,"CAN",653848
1,173.0,"Southern Asia",345365,0,345365,255829,426382,"IRN",341106
1,173.0,"South America",2306910,1928401,378509,1423938,2373231,"BRA",1898585
1,173.0,"Central Asia",1524976,1460365,64611,1152527,1920878,"UZB",1536703
1,173.0,"South-Eastern Asia",942554,0,942554,702500,1170833,"IDN",936667
1,173.0,"Pakistan",1698102,1556719,141383,1262535,2104225,"PAK",1683380
1,173.0,"Southern Africa",119361,0,119361,88632,147721,"ZAF",118177
1,173.0,"Northern Europe",1961969,1913428,48541,1532297,2553828,"GBR",2043063
1,173.0,"Oceania",609723,602512,7211,452909,754848,"NZL",603879
1,173.0,"Central America",525026,0,525026,391149,651916,"MEX",521533
1,173.0,"Eastern Africa",277407,0,277407,207168,345281,"ETH",276225
1,173.0,"China",8194441,7992874,201567,6345839,10576398,"CPR",8461119
1,173.0,"Eastern Europe",3503196,3269309,233887,2373705,3956176,"POL",3164941
1,173.0,"India",5535603,5478134,57469,4151478,6919130,"IND",5535304
1,173.0,"Middle Africa",97843,0,97843,73038,121731,"AGO",97385
1,173.0,"Western Asia",434058,0,434058,324147,540246,"IRQ",432197
1,173.0,"United States of America",2598963,2598143,820,1890547,3150912,"USA",2520730
1,173.0,"Western Europe",4066586,3895679,170907,3104968,5174947,"NLD",4139958
1,173.0,"Russian Federation",3104778,3024367,80411,2288659,3814432,"RUS",3051546
1,173.0,"Northern Africa",1351256,0,1351256,1004696,1674493,"EGY",1339595
1,173.0,"Eastern Asia",806938,0,806938,590778,984630,"JPN",787704
1,173.0,"Western Africa",480318,0,480318,358696,597827,"NGA",478262
1,173.0,"Southern Europe",1133636,0,1133636,847699,1412832,"ITA",1130266
1,174.0,"Northern America",649947,641132,8815,490386,817310,"CAN",653848
1,174.0,"Southern Asia",337332,0,337332,255829,426382,"IRN",341106
1,174.0,"South America",2251888,1927444,324444,1423938,2373231,"BRA",1898585
1,174.0,"Central Asia",1577238,1508444,68794,1152527,1920878,"UZB",1536703
1,174.0,"South-Eastern Asia",931344,0,931344,702500,1170833,"IDN",936667
1,174.0,"Pakistan",1663600,1524483,139117,1262535,2104225,"PAK",1683380
1,174.0,"Southern Africa",117128,0,117128,88632,147721,"ZAF",118177
1,174.0,"Northern Europe",1986298,1930634,55664,1532297,2553828,"GBR",2043063
1,174.0,"Oceania",592192,586830,5362,452909,754848,"NZL",603879
1,174.0,"Central America",519222,0,519222,391149,651916,"MEX",521533
1,174.0,"Eastern Africa",274936,0,274936,207168,345281,"ETH",276225
1,174.0,"China",8232412,8004396,228016,6345839,10576398,"CPR",8461119
1,174.0,"Eastern Europe",3482377,3269542,212835,2373705,3956176,"POL",3164941
1,174.0,"India",5546654,5473363,73291,4151478,6919130,"IND",5535304
1,174.0,"Middle Africa",96892,0,96892,73038,121731,"AGO",97385
1,174.0,"Western Asia",430162,0,430162,324147,540246,"IRQ",432197
1,174.0,"United States of America",2513618,2513618,0,1890547,3150912,"USA",2520730
1,174.0,"Western Europe",4088597,3915994,172603,3104968,5174947,"NLD",4139958
1,174.0,"Russian Federation",2949452,2880498,68954,2288659,3814432,"RUS",3051546
1,174.0,"Northern Africa",1329197,0,1329197,1004696,1674493,"EGY",1339595
1,174.0,"Eastern Asia",785562,0,785562,590778,984630,"JPN",787704
1,174.0,"Western Africa",476012,0,476012,358696,597827,"NGA",478262
1,174.0,"Southern Europe",1126569,0,1126569,847699,1412832,"ITA",1130266
1,175.0,"Northern America",644090,637211,6879,490386,817310,"CAN",653848
1,175.0,"Southern Asia",336170,0,336170,255829,426382,"IRN",341106
1,175.0,"South America",2203962,1927980,275982,1423938,2373231,"BRA",1898585
1,175.0,"Central Asia",1618600,1548251,70349,1152527,1920878,"UZB",1536703
1,175.0,"South-Eastern Asia",929841,0,929841,702500,1170833,"IDN",936667
1,175.0,"Pakistan",1662647,1523430,139217,1262535,2104225,"PAK",1683380
1,175.0,"Southern Africa",116804,0,116804,88632,147721,"ZAF",118177
1,175.0,"Northern Europe",2010625,1948060,62565,1532297,2553828,"GBR",2043063
1,175.0,"Oceania",599005,595403,3602,452909,754848,"NZL",603879
1,175.0,"Central America",517325,0,517325,391149,651916,"MEX",521533
1,175.0,"Eastern Africa",274646,0,274646,207168,345281,"ETH",276225
1,175.0,"China",8255342,8001074,254268,6345839,10576398,"CPR",8461119
1,175.0,"Eastern Europe",3463789,3273006,190783,2373705,3956176,"POL",3164941
1,175.0,"India",5559341,5475417,83924,4151478,6919130,"IND",5535304
1,175.0,"Middle Africa",96775,0,96775,73038,121731,"AGO",97385
1,175.0,"Western Asia",429709,0,429709,324147,540246,"IRQ",432197
1,175.0,"United States of America",2485170,2485170,0,1890547,3150912,"USA",2520730
1,175.0,"Western Europe",4103270,3929481,173789,3104968,5174947,"NLD",4139958
1,175.0,"Russian Federation",3001794,2940792,61002,2288659,3814432,"RUS",3051546
1,175.0,"Northern Africa",1326072,0,1326072,1004696,1674493,"EGY",1339595
1,175.0,"Eastern Asia",778523,0,778523,590778,984630,"JPN",787704
1,175.0,"Western Africa",475514,0,475514,358696,597827,"NGA",478262
1,175.0,"Southern Europe",1125758,0,1125758,847699,1412832,"ITA",1130266
1,176.0,"Northern America",632384,627421,4963,490386,817310,"CAN",653848
1,176.0,"Southern Asia",331762,0,331762,255829,426382,"IRN",341106
1,176.0,"South America",2158142,1927190,230952,1423938,2373231,"BRA",1898585
1,176.0,"Central Asia",1636561,1568153,68408,1152527,1920878,"UZB",1536703
1,176.0,"South-Eastern Asia",923718,0,923718,702500,1170833,"IDN",936667
1,176.0,"Pakistan",1662596,1523239,139357,1262535,2104225,"PAK",1683380
1,176.0,"Southern Africa",115581,0,115581,88632,147721,"ZAF",118177
1,176.0,"Northern Europe",2140368,2071191,69177,1532297,2553828,"GBR",2043063
1,176.0,"Oceania",593162,591361,1801,452909,754848,"NZL",603879
1,176.0,"Central America",513701,0,513701,391149,651916,"MEX",521533
1,176.0,"Eastern Africa",273491,0,273491,207168,345281,"ETH",276225
1,176.0,"China",8298287,8019334,278953,6345839,10576398,"CPR",8461119
1,176.0,"Eastern Europe",3993207,3829052,164155,2373705,3956176,"POL",3164941
1,176.0,"India",5559069,5476128,82941,4151478,6919130,"IND",5535304
1,176.0,"Middle Africa",96262,0,96262,73038,121731,"AGO",97385
1,176.0,"Western Asia",427892,0,427892,324147,540246,"IRQ",432197
1,176.0,"United States of America",2442498,2442498,0,1890547,3150912,"USA",2520730
1,176.0,"Western Europe",4103271,3928635,174636,3104968,5174947,"NLD",4139958
1,176.0,"Russian Federation",2953165,2900820,52345,2288659,3814432,"RUS",3051546
1,176.0,"Northern Africa",1313984,0,1313984,1004696,1674493,"EGY",1339595
1,176.0,"Eastern Asia",766803,0,766803,590778,984630,"JPN",787704
1,176.0,"Western Africa",473504,0,473504,358696,597827,"NGA",478262
1,176.0,"Southern Europe",1122461,0,1122461,847699,1412832,"ITA",1130266
1,177.0,"Northern America",614822,611760,3062,490386,817310,"CAN",653848
1,177.0,"Southern Asia",348231,0,348231,255829,426382,"IRN",341106
1,177.0,"South America",1974635,1785069,189566,1423938,2373231,"BRA",1898585
1,177.0,"Central Asia",1651240,1584951,66289,1152527,1920878,"UZB",1536703
1,177.0,"South-Eastern Asia",946730,0,946730,702500,1170833,"IDN",936667
1,177.0,"Pakistan",1660362,1519010,141352,1262535,2104225,"PAK",1683380
1,177.0,"Southern Africa",120162,0,120162,88632,147721,"ZAF",118177
1,177.0,"Northern Europe",2176865,2103142,73723,1532297,2553828,"GBR",2043063
1,177.0,"Oceania",603878,603878,0,452909,754848,"NZL",603879
1,177.0,"Central America",528220,0,528220,391149,651916,"MEX",521533
1,177.0,"Eastern Africa",278711,0,278711,207168,345281,"ETH",276225
1,177.0,"China",8566636,8259293,307343,6345839,10576398,"CPR",8461119
1,177.0,"Eastern Europe",3943951,3825589,118362,2373705,3956176,"POL",3164941
1,177.0,"India",5547695,5472672,75023,4151478,6919130,"IND",5535304
1,177.0,"Middle Africa",98407,0,98407,73038,121731,"AGO",97385
1,177.0,"Western Asia",436123,0,436123,324147,540246,"IRQ",432197
1,177.0,"United States of America",2485171,2485171,0,1890547,3150912,"USA",2520730
1,177.0,"Western Europe",4550819,4375336,175483,3104968,5174947,"NLD",4139958
1,177.0,"Russian Federation",3045315,3001312,44003,2288659,3814432,"RUS",3051546
1,177.0,"Northern Africa",1359226,0,1359226,1004696,1674493,"EGY",1339595
1,177.0,"Eastern Asia",769043,0,769043,590778,984630,"JPN",787704
1,177.0,"Western Africa",482598,0,482598,358696,597827,"NGA",478262
1,177.0,"Southern Europe",1137387,0,1137387,847699,1412832,"ITA",1130266
1,178.0,"Northern America",646041,640839,5202,490386,817310,"CAN",653848
1,178.0,"Southern Asia",351420,0,351420,255829,426382,"IRN",341106
1,178.0,"South America",1924692,1748158,176534,1423938,2373231,"BRA",1898585
1,178.0,"Central Asia",1703536,1637782,65754,1152527,1920878,"UZB",1536703
1,178.0,"South-Eastern Asia",950942,0,950942,702500,1170833,"IDN",936667
1,178.0,"Pakistan",1670316,1522099,148217,1262535,2104225,"PAK",1683380
1,178.0,"Southern Africa",121043,0,121043,88632,147721,"ZAF",118177
1,178.0,"Northern Europe",2209300,2131808,77492,1532297,2553828,"GBR",2043063
1,178.0,"Oceania",610696,610696,0,452909,754848,"NZL",603879
1,178.0,"Central America",530753,0,530753,391149,651916,"MEX",521533
1,178.0,"Eastern Africa",279689,0,279689,207168,345281,"ETH",276225
1,178.0,"China",8597230,8264640,332590,6345839,10576398,"CPR",8461119
1,178.0,"Eastern Europe",3922776,3827601,95175,2373705,3956176,"POL",3164941
1,178.0,"India",5560093,5483195,76898,4151478,6919130,"IND",5535304
1,178.0,"Middle Africa",98659,0,98659,73038,121731,"AGO",97385
1,178.0,"Western Asia",437656,0,437656,324147,540246,"IRQ",432197
1,178.0,"United States of America",2513618,2513618,0,1890547,3150912,"USA",2520730
1,178.0,"Western Europe",4462783,4296808,165975,3104968,5174947,"NLD",4139958
1,178.0,"Russian Federation",3111748,3076861,34887,2288659,3814432,"RUS",3051546
1,178.0,"Northern Africa",1367857,0,1367857,1004696,1674493,"EGY",1339595
1,178.0,"Eastern Asia",783522,0,783522,590778,984630,"JPN",787704
1,178.0,"Western Africa",484293,0,484293,358696,597827,"NGA",478262
1,178.0,"Southern Europe",1140164,0,1140164,847699,1412832,"ITA",1130266
1,179.0,"Northern America",659701,652489,7212,490392,817321,"CAN",653857
1,179.0,"Southern Asia",351903,0,351903,255832,426387,"IRN",341110
1,179.0,"South America",1921072,1750901,170171,1423942,2373237,"BRA",1898590
1,179.0,"Central Asia",1707824,1644048,63776,1152531,1920885,"UZB",1536708
1,179.0,"South-Eastern Asia",951570,0,951570,702507,1170846,"IDN",936677
1,179.0,"Pakistan",1680143,1525655,154488,1262537,2104228,"PAK",1683383
1,179.0,"Southern Africa",121172,0,121172,88632,147721,"ZAF",118177
1,179.0,"Northern Europe",2241737,2161280,80457,1532301,2553836,"GBR",2043069
1,179.0,"Oceania",609725,609725,0,452916,754860,"NZL",603888
1,179.0,"Central America",531351,0,531351,391153,651922,"MEX",521538
1,179.0,"Eastern Africa",279881,0,279881,207176,345293,"ETH",276235
1,179.0,"China",8641558,8284777,356781,6345846,10576410,"CPR",8461128
1,179.0,"Eastern Europe",3917028,3833179,83849,2373708,3956180,"POL",3164944
1,179.0,"India",5560183,5479606,80577,4151484,6919141,"IND",5535313
1,179.0,"Middle Africa",98888,0,98888,73039,121732,"AGO",97386
1,179.0,"Western Asia",437953,0,437953,324152,540253,"IRQ",432203
1,179.0,"United States of America",2534954,2534954,0,1890554,3150923,"USA",2520739
1,179.0,"Western Europe",4396751,4238246,158505,3104970,5174950,"NLD",4139960
1,179.0,"Russian Federation",3107303,3081859,25444,2288663,3814438,"RUS",3051551
1,179.0,"Northern Africa",1369161,0,1369161,1004696,1674493,"EGY",1339595
1,179.0,"Eastern Asia",808109,0,808109,590779,984632,"JPN",787706
1,179.0,"Western Africa",484620,0,484620,358704,597841,"NGA",478273
1,179.0,"Southern Europe",1140703,0,1140703,847700,1412833,"ITA",1130267
1,180.0,"Northern America",669459,660333,9126,517487,862478,"CAN",689983
1,180.0,"Southern Asia",351638,0,351638,331722,552871,"IRN",442297
1,180.0,"South America",1896102,1730642,165460,1553353,2588922,"BRA",2071138
1,180.0,"Central Asia",1719510,1657591,61919,1286442,2144071,"UZB",1715257
1,180.0,"South-Eastern Asia",951194,0,951194,810939,1351565,"IDN",1081252
1,180.0,"Pakistan",1686220,1526668,159552,1431990,2386651,"PAK",1909321
1,180.0,"Southern Africa",121098,0,121098,76379,127298,"ZAF",101839
1,180.0,"Northern Europe",2253902,2171385,82517,1612846,2688077,"GBR",2150462
1,180.0,"Oceania",601932,601932,0,523109,871848,"NZL",697479
1,180.0,"Central America",531938,0,531938,381900,636501,"MEX",509201
1,180.0,"Eastern Africa",279876,0,279876,223113,371855,"ETH",297484
1,180.0,"China",8684285,8306700,377585,6851757,11419595,"CPR",9135676
1,180.0,"Eastern Europe",3228136,3163134,65002,2270412,3784021,"POL",3027217
1,180.0,"India",5571960,5483977,87983,4796362,7993937,"IND",6395150
1,180.0,"Middle Africa",98712,0,98712,89043,148406,"AGO",118725
1,180.0,"Western Asia",437850,0,437850,343455,572425,"IRQ",457940
1,180.0,"United States of America",2556289,2556289,0,1983710,3306183,"USA",2644947
1,180.0,"Western Europe",4345393,4185124,160269,3347390,5578983,"NLD",4463187
1,180.0,"Russian Federation",3037765,3021645,16120,2363439,3939066,"RUS",3151253
1,180.0,"Northern Africa",1369766,0,1369766,1123390,1872317,"EGY",1497854
1,180.0,"Eastern Asia",812927,0,812927,609777,1016296,"JPN",813037
1,180.0,"Western Africa",484507,0,484507,359793,599655,"NGA",479724
1,180.0,"Southern Europe",1140517,0,1140517,758971,1264952,"ITA",1011962
1,181.0,"Northern America",671419,660955,10464,517487,862478,"CAN",689983
1,181.0,"Southern Asia",347874,0,347874,331722,552871,"IRN",442297
1,181.0,"South America",1860908,1699892,161016,1553353,2588922,"BRA",2071138
1,181.0,"Central Asia",1728314,1668199,60115,1286442,2144071,"UZB",1715257
1,181.0,"South-Eastern Asia",944663,0,944663,810939,1351565,"IDN",1081252
1,181.0,"Pakistan",1698279,1534172,164107,1431990,2386651,"PAK",1909321
1,181.0,"Southern Africa",119968,0,119968,76379,127298,"ZAF",101839
1,181.0,"Northern Europe",2253907,2169595,84312,1612846,2688077,"GBR",2150462
1,181.0,"Oceania",592198,592198,0,523109,871848,"NZL",697479
1,181.0,"Central America",528524,0,528524,381900,636501,"MEX",509201
1,181.0,"Eastern Africa",278361,0,278361,223113,371855,"ETH",297484
1,181.0,"China",8704504,8308136,396368,6851757,11419595,"CPR",9135676
1,181.0,"Eastern Europe",3072107,3015654,56453,2270412,3784021,"POL",3027217
1,181.0,"India",5596351,5502716,93635,4796362,7993937,"IND",6395150
1,181.0,"Middle Africa",98208,0,98208,89043,148406,"AGO",118725
1,181.0,"Western Asia",435549,0,435549,343455,572425,"IRQ",457940
1,181.0,"United States of America",2506516,2506516,0,1983710,3306183,"USA",2644947
1,181.0,"Western Europe",4316049,4147801,168248,3347390,5578983,"NLD",4463187
1,181.0,"Russian Federation",2946791,2940107,6684,2363439,3939066,"RUS",3151253
1,181.0,"Northern Africa",1358246,0,1358246,1123390,1872317,"EGY",1497854
1,181.0,"Eastern Asia",801628,0,801628,609777,1016296,"JPN",813037
1,181.0,"Western Africa",481972,0,481972,359793,599655,"NGA",479724
1,181.0,"Southern Europe",1136333,0,1136333,758971,1264952,"ITA",1011962
1,182.0,"Northern America",660712,652178,8534,517487,862478,"CAN",689983
1,182.0,"Southern Asia",431488,0,431488,331722,552871,"IRN",442297
1,182.0,"South America",2075780,1905037,170743,1553353,2588922,"BRA",2071138
1,182.0,"Central Asia",1729705,1664600,65105,1286442,2144071,"UZB",1715257
1,182.0,"South-Eastern Asia",1064588,0,1064588,810939,1351565,"IDN",1081252
1,182.0,"Pakistan",1717309,1534339,182970,1431990,2386651,"PAK",1909321
1,182.0,"Southern Africa",98747,0,98747,76379,127298,"ZAF",101839
1,182.0,"Northern Europe",2259937,2171633,88304,1612846,2688077,"GBR",2150462
1,182.0,"Oceania",702340,702340,0,523109,871848,"NZL",697479
1,182.0,"Central America",498440,0,498440,381900,636501,"MEX",509201
1,182.0,"Eastern Africa",294107,0,294107,223113,371855,"ETH",297484
1,182.0,"China",8753623,8317628,435995,6851757,11419595,"CPR",9135676
1,182.0,"Eastern Europe",3070839,3023113,47726,2270412,3784021,"POL",3027217
1,182.0,"India",5574453,5492528,81925,4796362,7993937,"IND",6395150
1,182.0,"Middle Africa",117414,0,117414,89043,148406,"AGO",118725
1,182.0,"Western Asia",452621,0,452621,343455,572425,"IRQ",457940
1,182.0,"United States of America",2573827,2573827,0,1983710,3306183,"USA",2644947
1,182.0,"Western Europe",4323784,4150137,173647,3347390,5578983,"NLD",4463187
1,182.0,"Russian Federation",3095021,3095021,0,2363439,3939066,"RUS",3151253
1,182.0,"Northern Africa",1468188,0,1468188,1123390,1872317,"EGY",1497854
1,182.0,"Eastern Asia",785403,0,785403,609777,1016296,"JPN",813037
1,182.0,"Western Africa",473857,0,473857,359793,599655,"NGA",479724
1,182.0,"Southern Europe",1002325,0,1002325,758971,1264952,"ITA",1011962
1,183.0,"Northern America",666566,659935,6631,517487,862478,"CAN",689983
1,183.0,"Southern Asia",432736,0,432736,331722,552871,"IRN",442297
1,183.0,"South America",2061772,1900688,161084,1553353,2588922,"BRA",2071138
1,183.0,"Central Asia",1729440,1664838,64602,1286442,2144071,"UZB",1715257
1,183.0,"South-Eastern Asia",1067048,0,1067048,810939,1351565,"IDN",1081252
1,183.0,"Pakistan",1745967,1545540,200427,1431990,2386651,"PAK",1909321
1,183.0,"Southern Africa",99275,0,99275,76379,127298,"ZAF",101839
1,183.0,"Northern Europe",2255881,2163919,91962,1612846,2688077,"GBR",2150462
1,183.0,"Oceania",695532,695532,0,523109,871848,"NZL",697479
1,183.0,"Central America",499407,0,499407,381900,636501,"MEX",509201
1,183.0,"Eastern Africa",294495,0,294495,223113,371855,"ETH",297484
1,183.0,"China",8796749,8323778,472971,6851757,11419595,"CPR",9135676
1,183.0,"Eastern Europe",3013980,2974921,39059,2270412,3784021,"POL",3027217
1,183.0,"India",5611177,5500148,111029,4796362,7993937,"IND",6395150
1,183.0,"Middle Africa",117573,0,117573,89043,148406,"AGO",118725
1,183.0,"Western Asia",453231,0,453231,343455,572425,"IRQ",457940
1,183.0,"United States of America",2580939,2580939,0,1983710,3306183,"USA",2644947
1,183.0,"Western Europe",4353132,4173836,179296,3347390,5578983,"NLD",4463187
1,183.0,"Russian Federation",3052463,3052463,0,2363439,3939066,"RUS",3151253
1,183.0,"Northern Africa",1471608,0,1471608,1123390,1872317,"EGY",1497854
1,183.0,"Eastern Asia",788331,0,788331,609777,1016296,"JPN",813037
1,183.0,"Western Africa",474525,0,474525,359793,599655,"NGA",479724
1,183.0,"Southern Europe",1003427,0,1003427,758971,1264952,"ITA",1011962
1,184.0,"Northern America",670470,663706,6764,517487,862478,"CAN",689983
1,184.0,"Southern Asia",432977,0,432977,331722,552871,"IRN",442297
1,184.0,"South America",2022452,1869438,153014,1553353,2588922,"BRA",2071138
1,184.0,"Central Asia",1726065,1662558,63507,1286442,2144071,"UZB",1715257
1,184.0,"South-Eastern Asia",1067434,0,1067434,810939,1351565,"IDN",1081252
1,184.0,"Pakistan",1774635,1559271,215364,1431990,2386651,"PAK",1909321
1,184.0,"Southern Africa",99245,0,99245,76379,127298,"ZAF",101839
1,184.0,"Northern Europe",2251788,2162555,89233,1612846,2688077,"GBR",2150462
1,184.0,"Oceania",683840,683840,0,523109,871848,"NZL",697479
1,184.0,"Central America",500935,0,500935,381900,636501,"MEX",509201
1,184.0,"Eastern Africa",294572,0,294572,223113,371855,"ETH",297484
1,184.0,"China",8816412,8310483,505929,6851757,11419595,"CPR",9135676
1,184.0,"Eastern Europe",2913845,2882952,30893,2270412,3784021,"POL",3027217
1,184.0,"India",5525853,5385482,140371,4796362,7993937,"IND",6395150
1,184.0,"Middle Africa",117603,0,117603,89043,148406,"AGO",118725
1,184.0,"Western Asia",453354,0,453354,343455,572425,"IRQ",457940
1,184.0,"United States of America",2588052,2588052,0,1983710,3306183,"USA",2644947
1,184.0,"Western Europe",4375142,4179280,195862,3347390,5578983,"NLD",4463187
1,184.0,"Russian Federation",3041112,3041112,0,2363439,3939066,"RUS",3151253
1,184.0,"Northern Africa",1472278,0,1472278,1123390,1872317,"EGY",1497854
1,184.0,"Eastern Asia",788995,0,788995,609777,1016296,"JPN",813037
1,184.0,"Western Africa",474655,0,474655,359793,599655,"NGA",479724
1,184.0,"Southern Europe",1004359,0,1004359,758971,1264952,"ITA",1011962
1,185.0,"Northern America",672421,665043,7378,517487,862478,"CAN",689983
1,185.0,"Southern Asia",435183,0,435183,331722,552871,"IRN",442297
1,185.0,"South America",2059911,1911727,148184,1553353,2588922,"BRA",2071138
1,185.0,"Central Asia",1729463,1663932,65531,1286442,2144071,"UZB",1715257
1,185.0,"South-Eastern Asia",1070571,0,1070571,810939,1351565,"IDN",1081252
1,185.0,"Pakistan",1795857,1566162,229695,1431990,2386651,"PAK",1909321
1,185.0,"Southern Africa",99859,0,99859,76379,127298,"ZAF",101839
1,185.0,"Northern Europe",2243719,2155931,87788,1612846,2688077,"GBR",2150462
1,185.0,"Oceania",695529,695529,0,523109,871848,"NZL",697479
1,185.0,"Central America",501886,0,501886,381900,636501,"MEX",509201
1,185.0,"Eastern Africa",295260,0,295260,223113,371855,"ETH",297484
1,185.0,"China",8864082,8321980,542102,6851757,11419595,"CPR",9135676
1,185.0,"Eastern Europe",3006183,2982920,23263,2270412,3784021,"POL",3027217
1,185.0,"India",5562214,5389003,173211,4796362,7993937,"IND",6395150
1,185.0,"Middle Africa",117866,0,117866,89043,148406,"AGO",118725
1,185.0,"Western Asia",454440,0,454440,343455,572425,"IRQ",457940
1,185.0,"United States of America",2588051,2588051,0,1983710,3306183,"USA",2644947
1,185.0,"Western Europe",4397155,4185188,211967,3347390,5578983,"NLD",4463187
1,185.0,"Russian Federation",3031736,3031736,0,2363439,3939066,"RUS",3151253
1,185.0,"Northern Africa",1478334,0,1478334,1123390,1872317,"EGY",1497854
1,185.0,"Eastern Asia",794441,0,794441,609777,1016296,"JPN",813037
1,185.0,"Western Africa",475856,0,475856,359793,599655,"NGA",479724
1,185.0,"Southern Europe",1005673,0,1005673,758971,1264952,"ITA",1011962
1,186.0,"Northern America",678273,669785,8488,517487,862478,"CAN",689983
1,186.0,"Southern Asia",437006,0,437006,331722,552871,"IRN",442297
1,186.0,"South America",2071586,1931044,140542,1553353,2588922,"BRA",2071138
1,186.0,"Central Asia",1729578,1664411,65167,1286442,2144071,"UZB",1715257
1,186.0,"South-Eastern Asia",1073772,0,1073772,810939,1351565,"IDN",1081252
1,186.0,"Pakistan",1945448,1702278,243170,1431990,2386651,"PAK",1909321
1,186.0,"Southern Africa",100364,0,100364,76379,127298,"ZAF",101839
1,186.0,"Northern Europe",2235609,2150231,85378,1612846,2688077,"GBR",2150462
1,186.0,"Oceania",698452,698452,0,523109,871848,"NZL",697479
1,186.0,"Central America",503387,0,503387,381900,636501,"MEX",509201
1,186.0,"Eastern Africa",295831,0,295831,223113,371855,"ETH",297484
1,186.0,"China",8866110,8315800,550310,6851757,11419595,"CPR",9135676
1,186.0,"Eastern Europe",3034973,3020018,14955,2270412,3784021,"POL",3027217
1,186.0,"India",5623388,5416375,207013,4796362,7993937,"IND",6395150
1,186.0,"Middle Africa",118086,0,118086,89043,148406,"AGO",118725
1,186.0,"Western Asia",455334,0,455334,343455,572425,"IRQ",457940
1,186.0,"United States of America",2595163,2595163,0,1983710,3306183,"USA",2644947
1,186.0,"Western Europe",4411827,4184306,227521,3347390,5578983,"NLD",4463187
1,186.0,"Russian Federation",3031141,3029448,1693,2363439,3939066,"RUS",3151253
1,186.0,"Northern Africa",1483345,0,1483345,1123390,1872317,"EGY",1497854
1,186.0,"Eastern Asia",799004,0,799004,609777,1016296,"JPN",813037
1,186.0,"Western Africa",476845,0,476845,359793,599655,"NGA",479724
1,186.0,"Southern Europe",1007033,0,1007033,758971,1264952,"ITA",1011962
1,187.0,"Northern America",682175,672689,9486,517487,862478,"CAN",689983
1,187.0,"Southern Asia",437292,0,437292,331722,552871,"IRN",442297
1,187.0,"South America",2043069,1910786,132283,1553353,2588922,"BRA",2071138
1,187.0,"Central Asia",1726814,1662201,64613,1286442,2144071,"UZB",1715257
1,187.0,"South-Eastern Asia",1074279,0,1074279,810939,1351565,"IDN",1081252
1,187.0,"Pakistan",1942078,1701725,240353,1431990,2386651,"PAK",1909321
1,187.0,"Southern Africa",100445,0,100445,76379,127298,"ZAF",101839
1,187.0,"Northern Europe",2223448,2141725,81723,1612846,2688077,"GBR",2150462
1,187.0,"Oceania",689687,689687,0,523109,871848,"NZL",697479
1,187.0,"Central America",504914,0,504914,381900,636501,"MEX",509201
1,187.0,"Eastern Africa",295917,0,295917,223113,371855,"ETH",297484
1,187.0,"China",8863659,8307702,555957,6851757,11419595,"CPR",9135676
1,187.0,"Eastern Europe",2963307,2956871,6436,2270412,3784021,"POL",3027217
1,187.0,"India",5720605,5480070,240535,4796362,7993937,"IND",6395150
1,187.0,"Middle Africa",118119,0,118119,89043,148406,"AGO",118725
1,187.0,"Western Asia",455474,0,455474,343455,572425,"IRQ",457940
1,187.0,"United States of America",2602275,2602275,0,1983710,3306183,"USA",2644947
1,187.0,"Western Europe",4426501,4183808,242693,3347390,5578983,"NLD",4463187
1,187.0,"Russian Federation",3048418,3038280,10138,2363439,3939066,"RUS",3151253
1,187.0,"Northern Africa",1484122,0,1484122,1123390,1872317,"EGY",1497854
1,187.0,"Eastern Asia",799881,0,799881,609777,1016296,"JPN",813037
1,187.0,"Western Africa",477003,0,477003,359793,599655,"NGA",479724
1,187.0,"Southern Europe",1008182,0,1008182,758971,1264952,"ITA",1011962
1,188.0,"Northern America",682176,673147,9029,517487,862478,"CAN",689983
1,188.0,"Southern Asia",438556,0,438556,331722,552871,"IRN",442297
1,188.0,"South America",2071036,1944986,126050,1553353,2588922,"BRA",2071138
1,188.0,"Central Asia",1682446,1623250,59196,1286442,2144071,"UZB",1715257
1,188.0,"South-Eastern Asia",1076044,0,1076044,810939,1351565,"IDN",1081252
1,188.0,"Pakistan",1939062,1701011,238051,1431990,2386651,"PAK",1909321
1,188.0,"Southern Africa",100797,0,100797,76379,127298,"ZAF",101839
1,188.0,"Northern Europe",2109919,2036353,73566,1612846,2688077,"GBR",2150462
1,188.0,"Oceania",698452,698452,0,523109,871848,"NZL",697479
1,188.0,"Central America",505388,0,505388,381900,636501,"MEX",509201
1,188.0,"Eastern Africa",296314,0,296314,223113,371855,"ETH",297484
1,188.0,"China",8888017,8311257,576760,6851757,11419595,"CPR",9135676
1,188.0,"Eastern Europe",2796925,2796925,0,2270412,3784021,"POL",3027217
1,188.0,"India",5782564,5508982,273582,4796362,7993937,"IND",6395150
1,188.0,"Middle Africa",118271,0,118271,89043,148406,"AGO",118725
1,188.0,"Western Asia",456099,0,456099,343455,572425,"IRQ",457940
1,188.0,"United States of America",2609388,2609388,0,1983710,3306183,"USA",2644947
1,188.0,"Western Europe",4441175,4183750,257425,3347390,5578983,"NLD",4463187
1,188.0,"Russian Federation",3058170,3038240,19930,2363439,3939066,"RUS",3151253
1,188.0,"Northern Africa",1487594,0,1487594,1123390,1872317,"EGY",1497854
1,188.0,"Eastern Asia",804413,0,804413,609777,1016296,"JPN",813037
1,188.0,"Western Africa",477688,0,477688,359793,599655,"NGA",479724
1,188.0,"Southern Europe",1008461,0,1008461,758971,1264952,"ITA",1011962
1,189.0,"Northern America",812910,805693,7217,517487,862478,"CAN",689983
1,189.0,"Southern Asia",445713,0,445713,331722,552871,"IRN",442297
1,189.0,"South America",2123475,2013226,110249,1553353,2588922,"BRA",2071138
1,189.0,"Central Asia",1631537,1576369,55168,1286442,2144071,"UZB",1715257
1,189.0,"South-Eastern Asia",1086017,0,1086017,810939,1351565,"IDN",1081252
1,189.0,"Pakistan",1944432,1699823,244609,1431990,2386651,"PAK",1909321
1,189.0,"Southern Africa",102783,0,102783,76379,127298,"ZAF",101839
1,189.0,"Northern Europe",2081534,2013555,67979,1612846,2688077,"GBR",2150462
1,189.0,"Oceania",715989,715989,0,523109,871848,"NZL",697479
1,189.0,"Central America",510720,0,510720,381900,636501,"MEX",509201
1,189.0,"Eastern Africa",298546,0,298546,223113,371855,"ETH",297484
1,189.0,"China",9340228,8714893,625335,6851757,11419595,"CPR",9135676
1,189.0,"Eastern Europe",2788087,2785203,2884,2270412,3784021,"POL",3027217
1,189.0,"India",5846632,5537587,309045,4796362,7993937,"IND",6395150
1,189.0,"Middle Africa",119132,0,119132,89043,148406,"AGO",118725
1,189.0,"Western Asia",459617,0,459617,343455,572425,"IRQ",457940
1,189.0,"United States of America",2381804,2381804,0,1983710,3306183,"USA",2644947
1,189.0,"Western Europe",4558564,4286903,271661,3347390,5578983,"NLD",4463187
1,189.0,"Russian Federation",2850533,2815269,35264,2363439,3939066,"RUS",3151253
1,189.0,"Northern Africa",1507239,0,1507239,1123390,1872317,"EGY",1497854
1,189.0,"Eastern Asia",822116,0,822116,609777,1016296,"JPN",813037
1,189.0,"Western Africa",481580,0,481580,359793,599655,"NGA",479724
1,189.0,"Southern Europe",1013921,0,1013921,758971,1264952,"ITA",1011962
1,190.0,"Northern America",707549,702905,4644,517487,862478,"CAN",689983
1,190.0,"Southern Asia",438150,0,438150,331722,552871,"IRN",442297
1,190.0,"South America",2096157,2002461,93696,1553353,2588922,"BRA",2071138
1,190.0,"Central Asia",1893488,1835300,58188,1286442,2144071,"UZB",1715257
1,190.0,"South-Eastern Asia",1075582,0,1075582,810939,1351565,"IDN",1081252
1,190.0,"Pakistan",1943206,1700173,243033,1431990,2386651,"PAK",1909321
1,190.0,"Southern Africa",100690,0,100690,76379,127298,"ZAF",101839
1,190.0,"Northern Europe",2081532,2015288,66244,1612846,2688077,"GBR",2150462
1,190.0,"Oceania",693584,693584,0,523109,871848,"NZL",697479
1,190.0,"Central America",506030,0,506030,381900,636501,"MEX",509201
1,190.0,"Eastern Africa",296194,0,296194,223113,371855,"ETH",297484
1,190.0,"China",9362623,8713864,648759,6851757,11419595,"CPR",9135676
1,190.0,"Eastern Europe",2793031,2783674,9357,2270412,3784021,"POL",3027217
1,190.0,"India",5894755,5551917,342838,4796362,7993937,"IND",6395150
1,190.0,"Middle Africa",118232,0,118232,89043,148406,"AGO",118725
1,190.0,"Western Asia",455902,0,455902,343455,572425,"IRQ",457940
1,190.0,"United States of America",2509819,2501434,8385,1983710,3306183,"USA",2644947
1,190.0,"Western Europe",4536559,4268573,267986,3347390,5578983,"NLD",4463187
1,190.0,"Russian Federation",2897875,2843303,54572,2363439,3939066,"RUS",3151253
1,190.0,"Northern Africa",1486460,0,1486460,1123390,1872317,"EGY",1497854
1,190.0,"Eastern Asia",803969,0,803969,609777,1016296,"JPN",813037
1,190.0,"Western Africa",477469,0,477469,359793,599655,"NGA",479724
1,190.0,"Southern Europe",1008262,0,1008262,758971,1264952,"ITA",1011962
1,191.0,"Northern America",688033,685497,2536,517488,862480,"CAN",689984
1,191.0,"Southern Asia",438581,0,438581,331728,552881,"IRN",442305
1,191.0,"South America",2064326,1983223,81103,1553359,2588932,"BRA",2071146
1,191.0,"Central Asia",1763584,1716041,47543,1286448,2144081,"UZB",1715265
1,191.0,"South-Eastern Asia",1076526,0,1076526,810943,1351572,"IDN",1081258
1,191.0,"Pakistan",1941411,1701612,239799,1431996,2386661,"PAK",1909329
1,191.0,"Southern Africa",100802,0,100802,76385,127308,"ZAF",101847
1,191.0,"Northern Europe",2085586,2017941,67645,1612849,2688082,"GBR",2150466
1,191.0,"Oceania",692607,692607,0,523117,871862,"NZL",697490
1,191.0,"Central America",506405,0,506405,381902,636503,"MEX",509203
1,191.0,"Eastern Africa",296321,0,296321,223120,371867,"ETH",297494
1,191.0,"China",9379170,8713933,665237,6851760,11419601,"CPR",9135681
1,191.0,"Eastern Europe",2798666,2777092,21574,2270421,3784035,"POL",3027228
1,191.0,"India",5942237,5567567,374670,4796367,7993945,"IND",6395156
1,191.0,"Middle Africa",118274,0,118274,89048,148413,"AGO",118731
1,191.0,"Western Asia",456107,0,456107,343459,572432,"IRQ",457946
1,191.0,"United States of America",2573826,2557056,16770,1983714,3306191,"USA",2644953
1,191.0,"Western Europe",4507211,4242052,265159,3347397,5578995,"NLD",4463196
1,191.0,"Russian Federation",2948460,2878845,69615,2363441,3939068,"RUS",3151255
1,191.0,"Northern Africa",1487660,0,1487660,1123397,1872328,"EGY",1497863
1,191.0,"Eastern Asia",804820,0,804820,609784,1016307,"JPN",813046
1,191.0,"Western Africa",477701,0,477701,359796,599661,"NGA",479729
1,191.0,"Southern Europe",1008674,0,1008674,758976,1264960,"ITA",1011968
1,192.0,"Northern America",680226,679759,467,437985,729976,"CAN",583981
1,192.0,"Southern Asia",438633,0,438633,286347,477245,"IRN",381796
1,192.0,"South America",2051209,1979193,72016,1673476,2789127,"BRA",2231302
1,192.0,"Central Asia",1699498,1658746,40752,1395879,2326466,"UZB",1861173
1,192.0,"South-Eastern Asia",1076577,0,1076577,806738,1344563,"IDN",1075651
1,192.0,"Pakistan",1937527,1701491,236036,1461924,2436541,"PAK",1949233
1,192.0,"Southern Africa",100816,0,100816,92132,153553,"ZAF",122843
1,192.0,"Northern Europe",2089641,2020677,68964,1703042,2838403,"GBR",2270723
1,192.0,"Oceania",692608,692608,0,499062,831770,"NZL",665416
1,192.0,"Central America",506448,0,506448,386002,643337,"MEX",514670
1,192.0,"Eastern Africa",296337,0,296337,223472,372453,"ETH",297963
1,192.0,"China",9399190,8720655,678535,7272231,12120386,"CPR",9696309
1,192.0,"Eastern Europe",2805725,2772944,32781,2555124,4258541,"POL",3406833
1,192.0,"India",5990677,5585295,405382,5295224,8825373,"IND",7060299
1,192.0,"Middle Africa",118348,0,118348,76498,127497,"AGO",101998
1,192.0,"Western Asia",456136,0,456136,587505,979175,"IRQ",783340
1,192.0,"United States of America",2602275,2577222,25053,1958160,3263601,"USA",2610881
1,192.0,"Western Europe",4485201,4221736,263465,3249662,5416103,"NLD",4332883
1,192.0,"Russian Federation",2992648,2910380,82268,2365446,3942411,"RUS",3153929
1,192.0,"Northern Africa",1487808,0,1487808,1325352,2208921,"EGY",1767137
1,192.0,"Eastern Asia",804949,0,804949,618789,1031316,"JPN",825053
1,192.0,"Western Africa",477732,0,477732,359637,599395,"NGA",479516
1,192.0,"Southern Europe",1009122,0,1009122,615924,1026540,"ITA",821232
1,193.0,"Northern America",678276,678276,0,437985,729976,"CAN",583981
1,193.0,"Southern Asia",443444,0,443444,286347,477245,"IRN",381796
1,193.0,"South America",1712838,1648331,64507,1673476,2789127,"BRA",2231302
1,193.0,"Central Asia",1590487,1554799,35688,1395879,2326466,"UZB",1861173
1,193.0,"South-Eastern Asia",1083245,0,1083245,806738,1344563,"IDN",1075651
1,193.0,"Pakistan",1943502,1707984,235518,1461924,2436541,"PAK",1949233
1,193.0,"Southern Africa",102158,0,102158,92132,153553,"ZAF",122843
1,193.0,"Northern Europe",2093700,2023499,70201,1703042,2838403,"GBR",2270723
1,193.0,"Oceania",728661,728661,0,499062,831770,"NZL",665416
1,193.0,"Central America",507176,0,507176,386002,643337,"MEX",514670
1,193.0,"Eastern Africa",297846,0,297846,223472,372453,"ETH",297963
1,193.0,"China",9409306,8707242,702064,7272231,12120386,"CPR",9696309
1,193.0,"Eastern Europe",2830335,2784967,45368,2555124,4258541,"POL",3406833
1,193.0,"India",6041821,5602266,439555,5295224,8825373,"IND",7060299
1,193.0,"Middle Africa",118785,0,118785,76498,127497,"AGO",101998
1,193.0,"Western Asia",458507,0,458507,587505,979175,"IRQ",783340
1,193.0,"United States of America",2623616,2590456,33160,1958160,3263601,"USA",2610881
1,193.0,"Western Europe",4477873,4215254,262619,3249662,5416103,"NLD",4332883
1,193.0,"Russian Federation",3027245,2936341,90904,2365446,3942411,"RUS",3153929
1,193.0,"Northern Africa",1501001,0,1501001,1325352,2208921,"EGY",1767137
1,193.0,"Eastern Asia",816473,0,816473,618789,1031316,"JPN",825053
1,193.0,"Western Africa",480345,0,480345,359637,599395,"NGA",479516
1,193.0,"Southern Europe",1012532,0,1012532,615924,1026540,"ITA",821232
1,194.0,"Northern America",568374,568374,0,437985,729976,"CAN",583981
1,194.0,"Southern Asia",375358,0,375358,286347,477245,"IRN",381796
1,194.0,"South America",1751949,1647509,104440,1673476,2789127,"BRA",2231302
1,194.0,"Central Asia",1571769,1534664,37105,1395879,2326466,"UZB",1861173
1,194.0,"South-Eastern Asia",1067953,0,1067953,806738,1344563,"IDN",1075651
1,194.0,"Pakistan",1950103,1716231,233872,1461924,2436541,"PAK",1949233
1,194.0,"Southern Africa",121050,0,121050,92132,153553,"ZAF",122843
1,194.0,"Northern Europe",2104483,2030680,73803,1703042,2838403,"GBR",2270723
1,194.0,"Oceania",656654,656654,0,499062,831770,"NZL",665416
1,194.0,"Central America",510062,0,510062,386002,643337,"MEX",514670
1,194.0,"Eastern Africa",295950,0,295950,223472,372453,"ETH",297963
1,194.0,"China",9464734,8727975,736759,7272231,12120386,"CPR",9696309
1,194.0,"Eastern Europe",2807175,2741394,65781,2555124,4258541,"POL",3406833
1,194.0,"India",6096348,5603365,492983,5295224,8825373,"IND",7060299
1,194.0,"Middle Africa",101239,0,101239,76498,127497,"AGO",101998
1,194.0,"Western Asia",780165,0,780165,587505,979175,"IRQ",783340
1,194.0,"United States of America",2539762,2498871,40891,1958160,3263601,"USA",2610881
1,194.0,"Western Europe",4369570,4112539,257031,3249662,5416103,"NLD",4332883
1,194.0,"Russian Federation",3022419,2932658,89761,2365446,3942411,"RUS",3153929
1,194.0,"Northern Africa",1749447,0,1749447,1325352,2208921,"EGY",1767137
1,194.0,"Eastern Asia",811542,0,811542,618789,1031316,"JPN",825053
1,194.0,"Western Africa",476017,0,476017,359637,599395,"NGA",479516
1,194.0,"Southern Europe",817065,0,817065,615924,1026540,"ITA",821232
1,195.0,"Northern America",543004,543004,0,437985,729976,"CAN",583981
1,195.0,"Southern Asia",369980,0,369980,286347,477245,"IRN",381796
1,195.0,"South America",1793839,1649879,143960,1673476,2789127,"BRA",2231302
1,195.0,"Central Asia",1563762,1522568,41194,1395879,2326466,"UZB",1861173
1,195.0,"South-Eastern Asia",1060316,0,1060316,806738,1344563,"IDN",1075651
1,195.0,"Pakistan",1949547,1721768,227779,1461924,2436541,"PAK",1949233
1,195.0,"Southern Africa",119558,0,119558,92132,153553,"ZAF",122843
1,195.0,"Northern Europe",2112593,2035407,77186,1703042,2838403,"GBR",2270723
1,195.0,"Oceania",636191,636191,0,499062,831770,"NZL",665416
1,195.0,"Central America",507168,0,507168,386002,643337,"MEX",514670
1,195.0,"Eastern Africa",294272,0,294272,223472,372453,"ETH",297963
1,195.0,"China",9474687,8718356,756331,7272231,12120386,"CPR",9696309
1,195.0,"Eastern Europe",2839432,2759284,80148,2555124,4258541,"POL",3406833
1,195.0,"India",6154132,5611463,542669,5295224,8825373,"IND",7060299
1,195.0,"Middle Africa",100576,0,100576,76498,127497,"AGO",101998
1,195.0,"Western Asia",777526,0,777526,587505,979175,"IRQ",783340
1,195.0,"United States of America",2546872,2497473,49399,1958160,3263601,"USA",2610881
1,195.0,"Western Europe",4347560,4091941,255619,3249662,5416103,"NLD",4332883
1,195.0,"Russian Federation",3004627,2915186,89441,2365446,3942411,"RUS",3153929
1,195.0,"Northern Africa",1734708,0,1734708,1325352,2208921,"EGY",1767137
1,195.0,"Eastern Asia",798415,0,798415,618789,1031316,"JPN",825053
1,195.0,"Western Africa",473093,0,473093,359637,599395,"NGA",479516
1,195.0,"Southern Europe",813524,0,813524,615924,1026540,"ITA",821232
1,196.0,"Northern America",531296,531296,0,437985,729976,"CAN",583981
1,196.0,"Southern Asia",365391,0,365391,286347,477245,"IRN",381796
1,196.0,"South America",1831362,1653389,177973,1673476,2789127,"BRA",2231302
1,196.0,"Central Asia",1565298,1520866,44432,1395879,2326466,"UZB",1861173
1,196.0,"South-Eastern Asia",1053820,0,1053820,806738,1344563,"IDN",1075651
1,196.0,"Pakistan",1942252,1718334,223918,1461924,2436541,"PAK",1949233
1,196.0,"Southern Africa",118193,0,118193,92132,153553,"ZAF",122843
1,196.0,"Northern Europe",2120702,2040298,80404,1703042,2838403,"GBR",2270723
1,196.0,"Oceania",624500,624500,0,499062,831770,"NZL",665416
1,196.0,"Central America",503901,0,503901,386002,643337,"MEX",514670
1,196.0,"Eastern Africa",292840,0,292840,223472,372453,"ETH",297963
1,196.0,"China",9468226,8728509,739717,7272231,12120386,"CPR",9696309
1,196.0,"Eastern Europe",2899398,2802875,96523,2555124,4258541,"POL",3406833
1,196.0,"India",6758464,6169338,589126,5295224,8825373,"IND",7060299
1,196.0,"Middle Africa",99968,0,99968,76498,127497,"AGO",101998
1,196.0,"Western Asia",775266,0,775266,587505,979175,"IRQ",783340
1,196.0,"United States of America",2532649,2474713,57936,1958160,3263601,"USA",2610881
1,196.0,"Western Europe",4310875,4063558,247317,3249662,5416103,"NLD",4332883
1,196.0,"Russian Federation",2973236,2897688,75548,2365446,3942411,"RUS",3153929
1,196.0,"Northern Africa",1722116,0,1722116,1325352,2208921,"EGY",1767137
1,196.0,"Eastern Asia",787109,0,787109,618789,1031316,"JPN",825053
1,196.0,"Western Africa",470975,0,470975,359637,599395,"NGA",479516
1,196.0,"Southern Europe",810530,0,810530,615924,1026540,"ITA",821232
1,197.0,"Northern America",525442,525442,0,437985,729976,"CAN",583981
1,197.0,"Southern Asia",362790,0,362790,286347,477245,"IRN",381796
1,197.0,"South America",1867325,1655592,211733,1673476,2789127,"BRA",2231302
1,197.0,"Central Asia",1573153,1526003,47150,1395879,2326466,"UZB",1861173
1,197.0,"South-Eastern Asia",1049521,0,1049521,806738,1344563,"IDN",1075651
1,197.0,"Pakistan",1938662,1718227,220435,1461924,2436541,"PAK",1949233
1,197.0,"Southern Africa",117591,0,117591,92132,153553,"ZAF",122843
1,197.0,"Northern Europe",2124758,2041301,83457,1703042,2838403,"GBR",2270723
1,197.0,"Oceania",619628,619628,0,499062,831770,"NZL",665416
1,197.0,"Central America",501397,0,501397,386002,643337,"MEX",514670
1,197.0,"Eastern Africa",291893,0,291893,223472,372453,"ETH",297963
1,197.0,"China",9443138,8722790,720348,7272231,12120386,"CPR",9696309
1,197.0,"Eastern Europe",2975492,2862562,112930,2555124,4258541,"POL",3406833
1,197.0,"India",6796000,6182986,613014,5295224,8825373,"IND",7060299
1,197.0,"Middle Africa",99737,0,99737,76498,127497,"AGO",101998
1,197.0,"Western Asia",773779,0,773779,587505,979175,"IRQ",783340
1,197.0,"United States of America",2525536,2458790,66746,1958160,3263601,"USA",2610881
1,197.0,"Western Europe",4266849,4031753,235096,3249662,5416103,"NLD",4332883
1,197.0,"Russian Federation",2955155,2891961,63194,2365446,3942411,"RUS",3153929
1,197.0,"Northern Africa",1713778,0,1713778,1325352,2208921,"EGY",1767137
1,197.0,"Eastern Asia",779621,0,779621,618789,1031316,"JPN",825053
1,197.0,"Western Africa",471508,0,471508,359637,599395,"NGA",479516
1,197.0,"Southern Europe",808251,0,808251,615924,1026540,"ITA",821232
1,198.0,"Northern America",527393,527393,0,437985,729976,"CAN",583981
1,198.0,"Southern Asia",361384,0,361384,286347,477245,"IRN",381796
1,198.0,"South America",1902319,1661284,241035,1673476,2789127,"BRA",2231302
1,198.0,"Central Asia",1654828,1600638,54190,1395879,2326466,"UZB",1861173
1,198.0,"South-Eastern Asia",1047427,0,1047427,806738,1344563,"IDN",1075651
1,198.0,"Pakistan",1965195,1752861,212334,1461924,2436541,"PAK",1949233
1,198.0,"Southern Africa",117174,0,117174,92132,153553,"ZAF",122843
1,198.0,"Northern Europe",2128811,2042384,86427,1703042,2838403,"GBR",2270723
1,198.0,"Oceania",631318,631318,0,499062,831770,"NZL",665416
1,198.0,"Central America",498657,0,498657,386002,643337,"MEX",514670
1,198.0,"Eastern Africa",291437,0,291437,223472,372453,"ETH",297963
1,198.0,"China",9416324,8718632,697692,7272231,12120386,"CPR",9696309
1,198.0,"Eastern Europe",2958112,2844965,113147,2555124,4258541,"POL",3406833
1,198.0,"India",6820024,6184605,635419,5295224,8825373,"IND",7060299
1,198.0,"Middle Africa",99555,0,99555,76498,127497,"AGO",101998
1,198.0,"Western Asia",773057,0,773057,587505,979175,"IRQ",783340
1,198.0,"United States of America",2511313,2435542,75771,1958160,3263601,"USA",2610881
1,198.0,"Western Europe",4200816,3976511,224305,3249662,5416103,"NLD",4332883
1,198.0,"Russian Federation",2933739,2877015,56724,2365446,3942411,"RUS",3153929
1,198.0,"Northern Africa",1709764,0,1709764,1325352,2208921,"EGY",1767137
1,198.0,"Eastern Asia",775967,0,775967,618789,1031316,"JPN",825053
1,198.0,"Western Africa",470017,0,470017,359637,599395,"NGA",479516
1,198.0,"Southern Europe",805743,0,805743,615924,1026540,"ITA",821232
1,199.0,"Northern America",537149,537149,0,437985,729976,"CAN",583981
1,199.0,"Southern Asia",360880,0,360880,286347,477245,"IRN",381796
1,199.0,"South America",1927702,1661672,266030,1673476,2789127,"BRA",2231302
1,199.0,"Central Asia",1741678,1680424,61254,1395879,2326466,"UZB",1861173
1,199.0,"South-Eastern Asia",1046736,0,1046736,806738,1344563,"IDN",1075651
1,199.0,"Pakistan",1954255,1751297,202958,1461924,2436541,"PAK",1949233
1,199.0,"Southern Africa",117035,0,117035,92132,153553,"ZAF",122843
1,199.0,"Northern Europe",2136920,2047606,89314,1703042,2838403,"GBR",2270723
1,199.0,"Oceania",636190,636190,0,499062,831770,"NZL",665416
1,199.0,"Central America",497586,0,497586,386002,643337,"MEX",514670
1,199.0,"Eastern Africa",291298,0,291298,223472,372453,"ETH",297963
1,199.0,"China",9376791,8717653,659138,7272231,12120386,"CPR",9696309
1,199.0,"Eastern Europe",2948733,2835540,113193,2555124,4258541,"POL",3406833
1,199.0,"India",6844340,6187210,657130,5295224,8825373,"IND",7060299
1,199.0,"Middle Africa",99497,0,99497,76498,127497,"AGO",101998
1,199.0,"Western Asia",772837,0,772837,587505,979175,"IRQ",783340
1,199.0,"United States of America",2504200,2419062,85138,1958160,3263601,"USA",2610881
1,199.0,"Western Europe",4149459,3933991,215468,3249662,5416103,"NLD",4332883
1,199.0,"Russian Federation",2907593,2864596,42997,2365446,3942411,"RUS",3153929
1,199.0,"Northern Africa",1708544,0,1708544,1325352,2208921,"EGY",1767137
1,199.0,"Eastern Asia",774761,0,774761,618789,1031316,"JPN",825053
1,199.0,"Western Africa",469442,0,469442,359637,599395,"NGA",479516
1,199.0,"Southern Europe",804820,0,804820,615924,1026540,"ITA",821232
1,200.0,"Northern America",541053,541053,0,437985,729976,"CAN",583981
1,200.0,"Southern Asia",359679,0,359679,286347,477245,"IRN",381796
1,200.0,"South America",1949579,1662087,287492,1673476,2789127,"BRA",2231302
1,200.0,"Central Asia",1800706,1735576,65130,1395879,2326466,"UZB",1861173
1,200.0,"South-Eastern Asia",1045070,0,1045070,806738,1344563,"IDN",1075651
1,200.0,"Pakistan",1944272,1749990,194282,1461924,2436541,"PAK",1949233
1,200.0,"Southern Africa",116700,0,116700,92132,153553,"ZAF",122843
1,200.0,"Northern Europe",2136921,2044885,92036,1703042,2838403,"GBR",2270723
1,200.0,"Oceania",636189,636189,0,499062,831770,"NZL",665416
1,200.0,"Central America",496417,0,496417,386002,643337,"MEX",514670
1,200.0,"Eastern Africa",290926,0,290926,223472,372453,"ETH",297963
1,200.0,"China",9332822,8709835,622987,7272231,12120386,"CPR",9696309
1,200.0,"Eastern Europe",2477002,2364563,112439,2555124,4258541,"POL",3406833
1,200.0,"India",6868231,6190573,677658,5295224,8825373,"IND",7060299
1,200.0,"Middle Africa",99256,0,99256,76498,127497,"AGO",101998
1,200.0,"Western Asia",772252,0,772252,587505,979175,"IRQ",783340
1,200.0,"United States of America",2497089,2402323,94766,1958160,3263601,"USA",2610881
1,200.0,"Western Europe",4112775,3904873,207902,3249662,5416103,"NLD",4332883
1,200.0,"Russian Federation",2889452,2853157,36295,2365446,3942411,"RUS",3153929
1,200.0,"Northern Africa",1710350,0,1710350,1325352,2208921,"EGY",1767137
1,200.0,"Eastern Asia",771868,0,771868,618789,1031316,"JPN",825053
1,200.0,"Western Africa",468784,0,468784,359637,599395,"NGA",479516
1,200.0,"Southern Europe",803738,0,803738,615924,1026540,"ITA",821232
1,201.0,"Northern America",457150,457150,0,437985,729976,"CAN",583981
1,201.0,"Southern Asia",350694,0,350694,286347,477245,"IRN",381796
1,201.0,"South America",1964811,1665697,299114,1673476,2789127,"BRA",2231302
1,201.0,"Central Asia",1781734,1732036,49698,1395879,2326466,"UZB",1861173
1,201.0,"South-Eastern Asia",1032564,0,1032564,806738,1344563,"IDN",1075651
1,201.0,"Pakistan",1934133,1748088,186045,1461924,2436541,"PAK",1949233
1,201.0,"Southern Africa",114203,0,114203,92132,153553,"ZAF",122843
1,201.0,"Northern Europe",2140975,2046216,94759,1703042,2838403,"GBR",2270723
1,201.0,"Oceania",634241,634241,0,499062,831770,"NZL",665416
1,201.0,"Central America",503684,0,503684,386002,643337,"MEX",514670
1,201.0,"Eastern Africa",288136,0,288136,223472,372453,"ETH",297963
1,201.0,"China",9465548,8896610,568938,7272231,12120386,"CPR",9696309
1,201.0,"Eastern Europe",2513028,2413546,99482,2555124,4258541,"POL",3406833
1,201.0,"India",6891247,6207281,683966,5295224,8825373,"IND",7060299
1,201.0,"Middle Africa",98273,0,98273,76498,127497,"AGO",101998
1,201.0,"Western Asia",767852,0,767852,587505,979175,"IRQ",783340
1,201.0,"United States of America",2838463,2733790,104673,1958160,3263601,"USA",2610881
1,201.0,"Western Europe",3540500,3339485,201015,3249662,5416103,"NLD",4332883
1,201.0,"Russian Federation",3184222,3157505,26717,2365446,3942411,"RUS",3153929
1,201.0,"Northern Africa",1687811,0,1687811,1325352,2208921,"EGY",1767137
1,201.0,"Eastern Asia",774942,0,774942,618789,1031316,"JPN",825053
1,201.0,"Western Africa",464018,0,464018,359637,599395,"NGA",479516
1,201.0,"Southern Europe",795930,0,795930,615924,1026540,"ITA",821232
1,202.0,"Northern America",509830,507914,1916,437985,729976,"CAN",583981
1,202.0,"Southern Asia",349390,0,349390,286347,477245,"IRN",381796
1,202.0,"South America",1988706,1665374,323332,1673476,2789127,"BRA",2231302
1,202.0,"Central Asia",1799438,1765856,33582,1395879,2326466,"UZB",1861173
1,202.0,"South-Eastern Asia",1035170,0,1035170,806738,1344563,"IDN",1075651
1,202.0,"Pakistan",1920718,1742575,178143,1461924,2436541,"PAK",1949233
1,202.0,"Southern Africa",113845,0,113845,92132,153553,"ZAF",122843
1,202.0,"Northern Europe",2140975,2043577,97398,1703042,2838403,"GBR",2270723
1,202.0,"Oceania",631318,630791,527,499062,831770,"NZL",665416
1,202.0,"Central America",506394,0,506394,386002,643337,"MEX",514670
1,202.0,"Eastern Africa",287768,0,287768,223472,372453,"ETH",297963
1,202.0,"China",9430184,8893397,536787,7272231,12120386,"CPR",9696309
1,202.0,"Eastern Europe",2559726,2468529,91197,2555124,4258541,"POL",3406833
1,202.0,"India",6901973,6213965,688008,5295224,8825373,"IND",7060299
1,202.0,"Middle Africa",98224,0,98224,76498,127497,"AGO",101998
1,202.0,"Western Asia",767271,0,767271,587505,979175,"IRQ",783340
1,202.0,"United States of America",2632218,2539216,93002,1958160,3263601,"USA",2610881
1,202.0,"Western Europe",3694572,3471555,223017,3249662,5416103,"NLD",4332883
1,202.0,"Russian Federation",3157230,3146038,11192,2365446,3942411,"RUS",3153929
1,202.0,"Northern Africa",1684499,0,1684499,1325352,2208921,"EGY",1767137
1,202.0,"Eastern Asia",791060,0,791060,618789,1031316,"JPN",825053
1,202.0,"Western Africa",463436,0,463436,359637,599395,"NGA",479516
1,202.0,"Southern Europe",795032,0,795032,615924,1026540,"ITA",821232
1,203.0,"Northern America",531295,527444,3851,437985,729976,"CAN",583981
1,203.0,"Southern Asia",347972,0,347972,286354,477257,"IRN",381806
1,203.0,"South America",2007748,1666586,341162,1673484,2789141,"BRA",2231313
1,203.0,"Central Asia",1794832,1769052,25780,1395881,2326468,"UZB",1861175
1,203.0,"South-Eastern Asia",1049667,0,1049667,806738,1344563,"IDN",1075651
1,203.0,"Pakistan",1910674,1739519,171155,1461925,2436542,"PAK",1949234
1,203.0,"Southern Africa",113449,0,113449,92135,153558,"ZAF",122847
1,203.0,"Northern Europe",2140976,2040860,100116,1703042,2838403,"GBR",2270723
1,203.0,"Oceania",633267,630667,2600,499070,831783,"NZL",665427
1,203.0,"Central America",502461,0,502461,386009,643348,"MEX",514679
1,203.0,"Eastern Africa",287330,0,287330,223479,372465,"ETH",297972
1,203.0,"China",9407248,8893924,513324,7272233,12120388,"CPR",9696311
1,203.0,"Eastern Europe",2598097,2503452,94645,2555124,4258541,"POL",3406833
1,203.0,"India",6909939,6210258,699681,5295231,8825385,"IND",7060308
1,203.0,"Middle Africa",97956,0,97956,76498,127497,"AGO",101998
1,203.0,"Western Asia",766585,0,766585,587507,979178,"IRQ",783343
1,203.0,"United States of America",2511314,2426473,84841,1958166,3263611,"USA",2610889
1,203.0,"Western Europe",3782616,3541875,240741,3249668,5416113,"NLD",4332891
1,203.0,"Russian Federation",3134126,3133532,594,2365451,3942418,"RUS",3153935
1,203.0,"Northern Africa",1679917,0,1679917,1325358,2208931,"EGY",1767145
1,203.0,"Eastern Asia",783158,0,783158,618789,1031316,"JPN",825053
1,203.0,"Western Africa",462542,0,462542,359642,599403,"NGA",479523
1,203.0,"Southern Europe",793574,0,793574,615925,1026542,"ITA",821234
1,204.0,"Northern America",535198,529405,5793,363744,606240,"CAN",484992
1,204.0,"Southern Asia",346427,0,346427,459985,766642,"IRN",613314
1,204.0,"South America",2023883,1670392,353491,1385751,2309586,"BRA",1847669
1,204.0,"Central Asia",1786191,1765266,20925,1086594,1810991,"UZB",1448793
1,204.0,"South-Eastern Asia",1046252,0,1046252,529293,882156,"IDN",705725
1,204.0,"Pakistan",1900856,1735923,164933,1222523,2037538,"PAK",1630031
1,204.0,"Southern Africa",113021,0,113021,88366,147277,"ZAF",117822
1,204.0,"Northern Europe",2145030,2035280,109750,1404288,2340480,"GBR",1872384
1,204.0,"Oceania",636189,631465,4724,457577,762628,"NZL",610103
1,204.0,"Central America",498030,0,498030,268749,447915,"MEX",358332
1,204.0,"Eastern Africa",286850,0,286850,200997,334996,"ETH",267997
1,204.0,"China",9406890,8893824,513066,5876297,9793828,"CPR",7835063
1,204.0,"Eastern Europe",2660097,2550541,109556,2328807,3881345,"POL",3105076
1,204.0,"India",6896661,6208013,688648,4473415,7455692,"IND",5964554
1,204.0,"Middle Africa",97771,0,97771,75159,125266,"AGO",100213
1,204.0,"Western Asia",765842,0,765842,706593,1177656,"IRQ",942125
1,204.0,"United States of America",2433081,2354676,78405,1873728,3122880,"USA",2498304
1,204.0,"Western Europe",3848646,3592627,256019,2939467,4899112,"NLD",3919290
1,204.0,"Russian Federation",3116941,3116941,0,2870600,4784333,"RUS",3827467
1,204.0,"Northern Africa",1674697,0,1674697,1205562,2009271,"EGY",1607417
1,204.0,"Eastern Asia",772926,0,772926,502415,837358,"JPN",669887
1,204.0,"Western Africa",461522,0,461522,284388,473981,"NGA",379185
1,204.0,"Southern Europe",791914,0,791914,541157,901928,"ITA",721543
1,205.0,"Northern America",535198,527730,7468,363744,606240,"CAN",484992
1,205.0,"Southern Asia",317993,0,317993,459985,766642,"IRN",613314
1,205.0,"South America",2018698,1657763,360935,1385751,2309586,"BRA",1847669
1,205.0,"Central Asia",1769527,1762767,6760,1086594,1810991,"UZB",1448793
1,205.0,"South-Eastern Asia",979751,0,979751,529293,882156,"IDN",705725
1,205.0,"Pakistan",1880875,1730270,150605,1222523,2037538,"PAK",1630031
1,205.0,"Southern Africa",100319,0,100319,88366,147277,"ZAF",117822
1,205.0,"Northern Europe",2145030,2032546,112484,1404288,2340480,"GBR",1872384
1,205.0,"Oceania",232915,226199,6716,457577,762628,"NZL",610103
1,205.0,"Central America",495061,0,495061,268749,447915,"MEX",358332
1,205.0,"Eastern Africa",272698,0,272698,200997,334996,"ETH",267997
1,205.0,"China",9363833,8899360,464473,5876297,9793828,"CPR",7835063
1,205.0,"Eastern Europe",2704156,2580709,123447,2328807,3881345,"POL",3105076
1,205.0,"India",6869237,6218428,650809,4473415,7455692,"IND",5964554
1,205.0,"Middle Africa",92286,0,92286,75159,125266,"AGO",100213
1,205.0,"Western Asia",743363,0,743363,706593,1177656,"IRQ",942125
1,205.0,"United States of America",2390418,2317252,73166,1873728,3122880,"USA",2498304
1,205.0,"Western Europe",3900012,3629975,270037,2939467,4899112,"NLD",3919290
1,205.0,"Russian Federation",3096210,3096210,0,2870600,4784333,"RUS",3827467
1,205.0,"Northern Africa",1672456,0,1672456,1205562,2009271,"EGY",1607417
1,205.0,"Eastern Asia",656674,0,656674,502415,837358,"JPN",669887
1,205.0,"Western Africa",461105,0,461105,284388,473981,"NGA",379185
1,205.0,"Southern Europe",791230,0,791230,541157,901928,"ITA",721543
1,206.0,"Northern America",516214,507564,8650,363744,606240,"CAN",484992
1,206.0,"Southern Asia",581498,0,581498,459985,766642,"IRN",613314
1,206.0,"South America",2009588,1658777,350811,1385751,2309586,"BRA",1847669
1,206.0,"Central Asia",1758768,1756545,2223,1086594,1810991,"UZB",1448793
1,206.0,"South-Eastern Asia",716117,0,716117,529293,882156,"IDN",705725
1,206.0,"Pakistan",1824729,1688494,136235,1222523,2037538,"PAK",1630031
1,206.0,"Southern Africa",112544,0,112544,88366,147277,"ZAF",117822
1,206.0,"Northern Europe",2131878,2025324,106554,1404288,2340480,"GBR",1872384
1,206.0,"Oceania",457253,445930,11323,457577,762628,"NZL",610103
1,206.0,"Central America",378941,0,378941,268749,447915,"MEX",358332
1,206.0,"Eastern Africa",262684,0,262684,200997,334996,"ETH",267997
1,206.0,"China",9332168,8897024,435144,5876297,9793828,"CPR",7835063
1,206.0,"Eastern Europe",2774086,2620621,153465,2328807,3881345,"POL",3105076
1,206.0,"India",6815261,6217367,597894,4473415,7455692,"IND",5964554
1,206.0,"Middle Africa",97961,0,97961,75159,125266,"AGO",100213
1,206.0,"Western Asia",933872,0,933872,706593,1177656,"IRQ",942125
1,206.0,"United States of America",2448519,2381619,66900,1873728,3122880,"USA",2498304
1,206.0,"Western Europe",3867929,3591793,276136,2939467,4899112,"NLD",3919290
1,206.0,"Russian Federation",3138675,3133245,5430,2870600,4784333,"RUS",3827467
1,206.0,"Northern Africa",1611023,0,1611023,1205562,2009271,"EGY",1607417
1,206.0,"Eastern Asia",628034,0,628034,502415,837358,"JPN",669887
1,206.0,"Western Africa",381433,0,381433,284388,473981,"NGA",379185
1,206.0,"Southern Europe",723044,0,723044,541157,901928,"ITA",721543
1,207.0,"Northern America",490848,480941,9907,363744,606240,"CAN",484992
1,207.0,"Southern Asia",608870,0,608870,459985,766642,"IRN",613314
1,207.0,"South America",1997593,1658126,339467,1385751,2309586,"BRA",1847669
1,207.0,"Central Asia",1767619,1763592,4027,1086594,1810991,"UZB",1448793
1,207.0,"South-Eastern Asia",691283,0,691283,529293,882156,"IDN",705725
1,207.0,"Pakistan",1722892,1598640,124252,1222523,2037538,"PAK",1630031
1,207.0,"Southern Africa",114490,0,114490,88366,147277,"ZAF",117822
1,207.0,"Northern Europe",2115659,2014749,100910,1404288,2340480,"GBR",1872384
1,207.0,"Oceania",521457,507039,14418,457577,762628,"NZL",610103
1,207.0,"Central America",360031,0,360031,268749,447915,"MEX",358332
1,207.0,"Eastern Africa",264500,0,264500,200997,334996,"ETH",267997
1,207.0,"China",9283604,8890063,393541,5876297,9793828,"CPR",7835063
1,207.0,"Eastern Europe",2837520,2660032,177488,2328807,3881345,"POL",3105076
1,207.0,"India",6771671,6219233,552438,4473415,7455692,"IND",5964554
1,207.0,"Middle Africa",98774,0,98774,75159,125266,"AGO",100213
1,207.0,"Western Asia",936614,0,936614,706593,1177656,"IRQ",942125
1,207.0,"United States of America",2462743,2402834,59909,1873728,3122880,"USA",2498304
1,207.0,"Western Europe",3882604,3593192,289412,2939467,4899112,"NLD",3919290
1,207.0,"Russian Federation",3226274,3191018,35256,2870600,4784333,"RUS",3827467
1,207.0,"Northern Africa",1603992,0,1603992,1205562,2009271,"EGY",1607417
1,207.0,"Eastern Asia",636032,0,636032,502415,837358,"JPN",669887
1,207.0,"Western Africa",378539,0,378539,284388,473981,"NGA",379185
1,207.0,"Southern Europe",720407,0,720407,541157,901928,"ITA",721543
1,208.0,"Northern America",481090,469771,11319,363744,606240,"CAN",484992
1,208.0,"Southern Asia",611133,0,611133,459985,766642,"IRN",613314
1,208.0,"South America",1986413,1658322,328091,1385751,2309586,"BRA",1847669
1,208.0,"Central Asia",1775851,1768163,7688,1086594,1810991,"UZB",1448793
1,208.0,"South-Eastern Asia",691899,0,691899,529293,882156,"IDN",705725
1,208.0,"Pakistan",1630393,1514280,116113,1222523,2037538,"PAK",1630031
1,208.0,"Southern Africa",115613,0,115613,88366,147277,"ZAF",117822
1,208.0,"Northern Europe",2099442,2003823,95619,1404288,2340480,"GBR",1872384
1,208.0,"Oceania",554576,537502,17074,457577,762628,"NZL",610103
1,208.0,"Central America",356229,0,356229,268749,447915,"MEX",358332
1,208.0,"Eastern Africa",265514,0,265514,200997,334996,"ETH",267997
1,208.0,"China",9242523,8894537,347986,5876297,9793828,"CPR",7835063
1,208.0,"Eastern Europe",2894059,2696970,197089,2328807,3881345,"POL",3105076
1,208.0,"India",7210770,6699211,511559,4473415,7455692,"IND",5964554
1,208.0,"Middle Africa",99099,0,99099,75159,125266,"AGO",100213
1,208.0,"Western Asia",938218,0,938218,706593,1177656,"IRQ",942125
1,208.0,"United States of America",2462743,2410014,52729,1873728,3122880,"USA",2498304
1,208.0,"Western Europe",3904613,3602316,302297,2939467,4899112,"NLD",3919290
1,208.0,"Russian Federation",3307282,3245642,61640,2870600,4784333,"RUS",3827467
1,208.0,"Northern Africa",1602483,0,1602483,1205562,2009271,"EGY",1607417
1,208.0,"Eastern Asia",643615,0,643615,502415,837358,"JPN",669887
1,208.0,"Western Africa",378218,0,378218,284388,473981,"NGA",379185
1,208.0,"Southern Europe",719967,0,719967,541157,901928,"ITA",721543
1,209.0,"Northern America",479136,466332,12804,363744,606240,"CAN",484992
1,209.0,"Southern Asia",612180,0,612180,459985,766642,"IRN",613314
1,209.0,"South America",1977347,1658637,318710,1385751,2309586,"BRA",1847669
1,209.0,"Central Asia",1784595,1773661,10934,1086594,1810991,"UZB",1448793
1,209.0,"South-Eastern Asia",695874,0,695874,529293,882156,"IDN",705725
1,209.0,"Pakistan",1633215,1518406,114809,1222523,2037538,"PAK",1630031
1,209.0,"Southern Africa",116570,0,116570,88366,147277,"ZAF",117822
1,209.0,"Northern Europe",2083223,1992542,90681,1404288,2340480,"GBR",1872384
1,209.0,"Oceania",577955,558479,19476,457577,762628,"NZL",610103
1,209.0,"Central America",355852,0,355852,268749,447915,"MEX",358332
1,209.0,"Eastern Africa",266591,0,266591,200997,334996,"ETH",267997
1,209.0,"China",9109009,8807667,301342,5876297,9793828,"CPR",7835063
1,209.0,"Eastern Europe",2952333,2737930,214403,2328807,3881345,"POL",3105076
1,209.0,"India",7153654,6700131,453523,4473415,7455692,"IND",5964554
1,209.0,"Middle Africa",99766,0,99766,75159,125266,"AGO",100213
1,209.0,"Western Asia",939909,0,939909,706593,1177656,"IRQ",942125
1,209.0,"United States of America",2469855,2424351,45504,1873728,3122880,"USA",2498304
1,209.0,"Western Europe",3926624,3612103,314521,2939467,4899112,"NLD",3919290
1,209.0,"Russian Federation",3390372,3303386,86986,2870600,4784333,"RUS",3827467
1,209.0,"Northern Africa",1604708,0,1604708,1205562,2009271,"EGY",1607417
1,209.0,"Eastern Asia",651573,0,651573,502415,837358,"JPN",669887
1,209.0,"Western Africa",378663,0,378663,284388,473981,"NGA",379185
1,209.0,"Southern Europe",720699,0,720699,541157,901928,"ITA",721543
1,210.0,"Northern America",483039,468729,14310,363744,606240,"CAN",484992
1,210.0,"Southern Asia",613694,0,613694,459985,766642,"IRN",613314
1,210.0,"South America",1968474,1657207,311267,1385751,2309586,"BRA",1847669
1,210.0,"Central Asia",1751859,1738158,13701,1086594,1810991,"UZB",1448793
1,210.0,"South-Eastern Asia",700668,0,700668,529293,882156,"IDN",705725
1,210.0,"Pakistan",1485131,1370430,114701,1222523,2037538,"PAK",1630031
1,210.0,"Southern Africa",117469,0,117469,88366,147277,"ZAF",117822
1,210.0,"Northern Europe",2067006,1980910,86096,1404288,2340480,"GBR",1872384
1,210.0,"Oceania",594515,572848,21667,457577,762628,"NZL",610103
1,210.0,"Central America",356985,0,356985,268749,447915,"MEX",358332
1,210.0,"Eastern Africa",267604,0,267604,200997,334996,"ETH",267997
1,210.0,"China",8269570,8011043,258527,5876297,9793828,"CPR",7835063
1,210.0,"Eastern Europe",3012226,2781368,230858,2328807,3881345,"POL",3105076
1,210.0,"India",7097506,6694843,402663,4473415,7455692,"IND",5964554
1,210.0,"Middle Africa",100059,0,100059,75159,125266,"AGO",100213
1,210.0,"Western Asia",941508,0,941508,706593,1177656,"IRQ",942125
1,210.0,"United States of America",2484079,2438360,45719,1873728,3122880,"USA",2498304
1,210.0,"Western Europe",3933967,3619678,314289,2939467,4899112,"NLD",3919290
1,210.0,"Russian Federation",3475639,3362543,113096,2870600,4784333,"RUS",3827467
1,210.0,"Northern Africa",1608653,0,1608653,1205562,2009271,"EGY",1607417
1,210.0,"Eastern Asia",660305,0,660305,502415,837358,"JPN",669887
1,210.0,"Western Africa",379437,0,379437,284388,473981,"NGA",379185
1,210.0,"Southern Europe",721966,0,721966,541157,901928,"ITA",721543
1,211.0,"Northern America",486941,471159,15782,363744,606240,"CAN",484992
1,211.0,"Southern Asia",614764,0,614764,459985,766642,"IRN",613314
1,211.0,"South America",1962855,1657111,305744,1385751,2309586,"BRA",1847669
1,211.0,"Central Asia",1456786,1448403,8383,1086594,1810991,"UZB",1448793
1,211.0,"South-Eastern Asia",704954,0,704954,529293,882156,"IDN",705725
1,211.0,"Pakistan",1496575,1376861,119714,1222523,2037538,"PAK",1630031
1,211.0,"Southern Africa",118119,0,118119,88366,147277,"ZAF",117822
1,211.0,"Northern Europe",2050787,1968924,81863,1404288,2340480,"GBR",1872384
1,211.0,"Oceania",607177,583491,23686,457577,762628,"NZL",610103
1,211.0,"Central America",358338,0,358338,268749,447915,"MEX",358332
1,211.0,"Eastern Africa",268331,0,268331,200997,334996,"ETH",267997
1,211.0,"China",7790407,7561372,229035,5876297,9793828,"CPR",7835063
1,211.0,"Eastern Europe",3057238,2809634,247604,2328807,3881345,"POL",3105076
1,211.0,"India",7054821,6694549,360272,4473415,7455692,"IND",5964554
1,211.0,"Middle Africa",100338,0,100338,75159,125266,"AGO",100213
1,211.0,"Western Asia",942654,0,942654,706593,1177656,"IRQ",942125
1,211.0,"United States of America",2498302,2452477,45825,1873728,3122880,"USA",2498304
1,211.0,"Western Europe",3926630,3612808,313822,2939467,4899112,"NLD",3919290
1,211.0,"Russian Federation",3550268,3412653,137615,2870600,4784333,"RUS",3827467
1,211.0,"Northern Africa",1611347,0,1611347,1205562,2009271,"EGY",1607417
1,211.0,"Eastern Asia",668107,0,668107,502415,837358,"JPN",669887
1,211.0,"Western Africa",379962,0,379962,284388,473981,"NGA",379185
1,211.0,"Southern Europe",722812,0,722812,541157,901928,"ITA",721543
1,212.0,"Northern America",490848,473632,17216,363744,606240,"CAN",484992
1,212.0,"Southern Asia",616316,0,616316,459985,766642,"IRN",613314
1,212.0,"South America",1960865,1658760,302105,1385751,2309586,"BRA",1847669
1,212.0,"Central Asia",1548841,1544816,4025,1086594,1810991,"UZB",1448793
1,212.0,"South-Eastern Asia",708159,0,708159,529293,882156,"IDN",705725
1,212.0,"Pakistan",1506862,1382530,124332,1222523,2037538,"PAK",1630031
1,212.0,"Southern Africa",118831,0,118831,88366,147277,"ZAF",117822
1,212.0,"Northern Europe",2164314,2086331,77983,1404288,2340480,"GBR",1872384
1,212.0,"Oceania",616921,591367,25554,457577,762628,"NZL",610103
1,212.0,"Central America",359340,0,359340,268749,447915,"MEX",358332
1,212.0,"Eastern Africa",269128,0,269128,200997,334996,"ETH",267997
1,212.0,"China",8622008,8415927,206081,5876297,9793828,"CPR",7835063
1,212.0,"Eastern Europe",4406581,4142211,264370,2328807,3881345,"POL",3105076
1,212.0,"India",7023984,6698551,325433,4473415,7455692,"IND",5964554
1,212.0,"Middle Africa",100653,0,100653,75159,125266,"AGO",100213
1,212.0,"Western Asia",943908,0,943908,706593,1177656,"IRQ",942125
1,212.0,"United States of America",2505415,2459590,45825,1873728,3122880,"USA",2498304
1,212.0,"Western Europe",3926630,3613040,313590,2939467,4899112,"NLD",3919290
1,212.0,"Russian Federation",3616893,3454941,161952,2870600,4784333,"RUS",3827467
1,212.0,"Northern Africa",1615429,0,1615429,1205562,2009271,"EGY",1607417
1,212.0,"Eastern Asia",673992,0,673992,502415,837358,"JPN",669887
1,212.0,"Western Africa",380762,0,380762,284388,473981,"NGA",379185
1,212.0,"Southern Europe",724119,0,724119,541157,901928,"ITA",721543
1,213.0,"Northern America",447920,429318,18602,363744,606240,"CAN",484992
1,213.0,"Southern Asia",632495,0,632495,459985,766642,"IRN",613314
1,213.0,"South America",1948765,1655726,293039,1385751,2309586,"BRA",1847669
1,213.0,"Central Asia",1537186,1537186,0,1086594,1810991,"UZB",1448793
1,213.0,"South-Eastern Asia",703485,0,703485,529293,882156,"IDN",705725
1,213.0,"Pakistan",1520221,1391627,128594,1222523,2037538,"PAK",1630031
1,213.0,"Southern Africa",123706,0,123706,88366,147277,"ZAF",117822
1,213.0,"Northern Europe",2075115,2008643,66472,1404288,2340480,"GBR",1872384
1,213.0,"Oceania",630563,603273,27290,457577,762628,"NZL",610103
1,213.0,"Central America",353668,0,353668,268749,447915,"MEX",358332
1,213.0,"Eastern Africa",274605,0,274605,200997,334996,"ETH",267997
1,213.0,"China",8530878,8356922,173956,5876297,9793828,"CPR",7835063
1,213.0,"Eastern Europe",4372813,4158231,214582,2328807,3881345,"POL",3105076
1,213.0,"India",6996746,6695556,301190,4473415,7455692,"IND",5964554
1,213.0,"Middle Africa",102758,0,102758,75159,125266,"AGO",100213
1,213.0,"Western Asia",952540,0,952540,706593,1177656,"IRQ",942125
1,213.0,"United States of America",2498306,2452533,45773,1873728,3122880,"USA",2498304
1,213.0,"Western Europe",4579611,4266252,313359,2939467,4899112,"NLD",3919290
1,213.0,"Russian Federation",4927057,4752134,174923,2870600,4784333,"RUS",3827467
1,213.0,"Northern Africa",1659600,0,1659600,1205562,2009271,"EGY",1607417
1,213.0,"Eastern Asia",668653,0,668653,502415,837358,"JPN",669887
1,213.0,"Western Africa",389493,0,389493,284388,473981,"NGA",379185
1,213.0,"Southern Europe",738440,0,738440,541157,901928,"ITA",721543
1,214.0,"Northern America",506454,485923,20531,363744,606240,"CAN",484992
1,214.0,"Southern Asia",639171,0,639171,459985,766642,"IRN",613314
1,214.0,"South America",1950256,1656800,293456,1385751,2309586,"BRA",1847669
1,214.0,"Central Asia",1439710,1439710,0,1086594,1810991,"UZB",1448793
1,214.0,"South-Eastern Asia",716172,0,716172,529293,882156,"IDN",705725
1,214.0,"Pakistan",1540279,1407718,132561,1222523,2037538,"PAK",1630031
1,214.0,"Southern Africa",125118,0,125118,88366,147277,"ZAF",117822
1,214.0,"Northern Europe",2071059,2013950,57109,1404288,2340480,"GBR",1872384
1,214.0,"Oceania",630562,601748,28814,457577,762628,"NZL",610103
1,214.0,"Central America",362893,0,362893,268749,447915,"MEX",358332
1,214.0,"Eastern Africa",276194,0,276194,200997,334996,"ETH",267997
1,214.0,"China",8504531,8360672,143859,5876297,9793828,"CPR",7835063
1,214.0,"Eastern Europe",4351847,4165846,186001,2328807,3881345,"POL",3105076
1,214.0,"India",6971832,6694263,277569,4473415,7455692,"IND",5964554
1,214.0,"Middle Africa",103364,0,103364,75159,125266,"AGO",100213
1,214.0,"Western Asia",955040,0,955040,706593,1177656,"IRQ",942125
1,214.0,"United States of America",2533865,2488092,45773,1873728,3122880,"USA",2498304
1,214.0,"Western Europe",4476895,4181836,295059,2939467,4899112,"NLD",3919290
1,214.0,"Russian Federation",4985686,4830362,155324,2870600,4784333,"RUS",3827467
1,214.0,"Northern Africa",1675466,0,1675466,1205562,2009271,"EGY",1607417
1,214.0,"Eastern Asia",688437,0,688437,502415,837358,"JPN",669887
1,214.0,"Western Africa",392477,0,392477,284388,473981,"NGA",379185
1,214.0,"Southern Europe",743232,0,743232,541157,901928,"ITA",721543
1,215.0,"Northern America",535728,514035,21693,363749,606248,"CAN",484999
1,215.0,"Southern Asia",642525,0,642525,459987,766645,"IRN",613316
1,215.0,"South America",1955085,1656673,298412,1385754,2309590,"BRA",1847672
1,215.0,"Central Asia",1461906,1457778,4128,1086597,1810995,"UZB",1448796
1,215.0,"South-Eastern Asia",725152,0,725152,529296,882161,"IDN",705729
1,215.0,"Pakistan",1586344,1450057,136287,1222523,2037538,"PAK",1630031
1,215.0,"Southern Africa",125990,0,125990,88371,147285,"ZAF",117828
1,215.0,"Northern Europe",1998078,1949897,48181,1404288,2340480,"GBR",1872384
1,215.0,"Oceania",634459,604141,30318,457581,762635,"NZL",610108
1,215.0,"Central America",368848,0,368848,268754,447923,"MEX",358339
1,215.0,"Eastern Africa",277168,0,277168,201002,335003,"ETH",268003
1,215.0,"China",8481333,8366286,115047,5876304,9793840,"CPR",7835072
1,215.0,"Eastern Europe",4356591,4185667,170924,2328809,3881348,"POL",3105079
1,215.0,"India",6946975,6692457,254518,4473419,7455698,"IND",5964559
1,215.0,"Middle Africa",103743,0,103743,75161,125268,"AGO",100215
1,215.0,"Western Asia",956578,0,956578,706602,1177670,"IRQ",942136
1,215.0,"United States of America",2569426,2523921,45505,1873730,3122883,"USA",2498307
1,215.0,"Western Europe",4410864,4133825,277039,2939471,4899118,"NLD",3919295
1,215.0,"Russian Federation",5002751,4875354,127397,2870605,4784342,"RUS",3827474
1,215.0,"Northern Africa",1683545,0,1683545,1205568,2009280,"EGY",1607424
1,215.0,"Eastern Asia",704254,0,704254,502417,837362,"JPN",669890
1,215.0,"Western Africa",394018,0,394018,284388,473981,"NGA",379185
1,215.0,"Southern Europe",745722,0,745722,541160,901933,"ITA",721547
1,216.0,"Northern America",545484,523080,22404,403005,671675,"CAN",537340
1,216.0,"Southern Asia",643024,0,643024,658519,1097532,"IRN",878026
1,216.0,"South America",1964048,1658973,305075,1397424,2329041,"BRA",1863233
1,216.0,"Central Asia",1485593,1477044,8549,1190692,1984487,"UZB",1587590
1,216.0,"South-Eastern Asia",733962,0,733962,686656,1144427,"IDN",915542
1,216.0,"Pakistan",1639811,1496769,143042,1284760,2141267,"PAK",1713014
1,216.0,"Southern Africa",126277,0,126277,81283,135472,"ZAF",108378
1,216.0,"Northern Europe",1933206,1892491,40715,1395422,2325703,"GBR",1860563
1,216.0,"Oceania",642252,610516,31736,342706,571177,"NZL",456942
1,216.0,"Central America",371932,0,371932,258873,431455,"MEX",345164
1,216.0,"Eastern Africa",277495,0,277495,323487,539146,"ETH",431317
1,216.0,"China",8436366,8348900,87466,5931314,9885523,"CPR",7908419
1,216.0,"Eastern Europe",4354541,4202071,152470,1995329,3325548,"POL",2660439
1,216.0,"India",6922120,6690084,232036,4381509,7302516,"IND",5842013
1,216.0,"Middle Africa",103868,0,103868,81811,136352,"AGO",109082
1,216.0,"Western Asia",957092,0,957092,647355,1078925,"IRQ",863140
1,216.0,"United States of America",2597874,2546262,51612,1761601,2936002,"USA",2348802
1,216.0,"Western Europe",4344831,4081681,263150,2898592,4830987,"NLD",3864790
1,216.0,"Russian Federation",5013685,4913467,100218,2457128,4095213,"RUS",3276171
1,216.0,"Northern Africa",1684362,0,1684362,1103401,1839002,"EGY",1471202
1,216.0,"Eastern Asia",726566,0,726566,514272,857120,"JPN",685696
1,216.0,"Western Africa",394150,0,394150,350869,584782,"NGA",467826
1,216.0,"Southern Europe",745916,0,745916,656247,1093746,"ITA",874997
1,217.0,"Northern America",557199,534132,23067,403005,671675,"CAN",537340
1,217.0,"Southern Asia",643592,0,643592,658519,1097532,"IRN",878026
1,217.0,"South America",2869922,2556542,313380,1397424,2329041,"BRA",1863233
1,217.0,"Central Asia",1508904,1495779,13125,1190692,1984487,"UZB",1587590
1,217.0,"South-Eastern Asia",771099,0,771099,686656,1144427,"IDN",915542
1,217.0,"Pakistan",1665515,1517621,147894,1284760,2141267,"PAK",1713014
1,217.0,"Southern Africa",130863,0,130863,81283,135472,"ZAF",108378
1,217.0,"Northern Europe",1892660,1858297,34363,1395422,2325703,"GBR",1860563
1,217.0,"Oceania",785453,752915,32538,342706,571177,"NZL",456942
1,217.0,"Central America",374952,0,374952,258873,431455,"MEX",345164
1,217.0,"Eastern Africa",282644,0,282644,323487,539146,"ETH",431317
1,217.0,"China",8412270,8351293,60977,5931314,9885523,"CPR",7908419
1,217.0,"Eastern Europe",4352826,4222643,130183,1995329,3325548,"POL",2660439
1,217.0,"India",6678981,6474511,204470,4381509,7302516,"IND",5842013
1,217.0,"Middle Africa",105845,0,105845,81811,136352,"AGO",109082
1,217.0,"Western Asia",965211,0,965211,647355,1078925,"IRQ",863140
1,217.0,"United States of America",2626325,2568651,57674,1761601,2936002,"USA",2348802
1,217.0,"Western Europe",4278804,4029512,249292,2898592,4830987,"NLD",3864790
1,217.0,"Russian Federation",5037280,4958946,78334,2457128,4095213,"RUS",3276171
1,217.0,"Northern Africa",1685820,0,1685820,1103401,1839002,"EGY",1471202
1,217.0,"Eastern Asia",783289,0,783289,514272,857120,"JPN",685696
1,217.0,"Western Africa",394435,0,394435,350869,584782,"NGA",467826
1,217.0,"Southern Europe",746388,0,746388,656247,1093746,"ITA",874997
1,218.0,"Northern America",558805,534459,24346,403005,671675,"CAN",537340
1,218.0,"Southern Asia",913647,0,913647,658519,1097532,"IRN",878026
1,218.0,"South America",2779192,2556273,222919,1397424,2329041,"BRA",1863233
1,218.0,"Central Asia",1552991,1534437,18554,1190692,1984487,"UZB",1587590
1,218.0,"South-Eastern Asia",968838,0,968838,686656,1144427,"IDN",915542
1,218.0,"Pakistan",1665518,1510572,154946,1284760,2141267,"PAK",1713014
1,218.0,"Southern Africa",119007,0,119007,81283,135472,"ZAF",108378
1,218.0,"Northern Europe",1868676,1840233,28443,1395422,2325703,"GBR",1860563
1,218.0,"Oceania",612804,584975,27829,342706,571177,"NZL",456942
1,218.0,"Central America",361333,0,361333,258873,431455,"MEX",345164
1,218.0,"Eastern Africa",443248,0,443248,323487,539146,"ETH",431317
1,218.0,"China",8108249,8072411,35838,5931314,9885523,"CPR",7908419
1,218.0,"Eastern Europe",4323033,4247079,75954,1995329,3325548,"POL",2660439
1,218.0,"India",5910781,5740877,169904,4381509,7302516,"IND",5842013
1,218.0,"Middle Africa",113663,0,113663,81811,136352,"AGO",109082
1,218.0,"Western Asia",881957,0,881957,647355,1078925,"IRQ",863140
1,218.0,"United States of America",2526604,2464964,61640,1761601,2936002,"USA",2348802
1,218.0,"Western Europe",4114246,3878436,235810,2898592,4830987,"NLD",3864790
1,218.0,"Russian Federation",3951274,3892343,58931,2457128,4095213,"RUS",3276171
1,218.0,"Northern Africa",1537738,0,1537738,1103401,1839002,"EGY",1471202
1,218.0,"Eastern Asia",778163,0,778163,514272,857120,"JPN",685696
1,218.0,"Western Africa",477289,0,477289,350869,584782,"NGA",467826
1,218.0,"Southern Europe",891321,0,891321,656247,1093746,"ITA",874997
1,219.0,"Northern America",591979,566403,25576,403005,671675,"CAN",537340
1,219.0,"Southern Asia",918481,0,918481,658519,1097532,"IRN",878026
1,219.0,"South America",2681703,2539092,142611,1397424,2329041,"BRA",1863233
1,219.0,"Central Asia",1596830,1573153,23677,1190692,1984487,"UZB",1587590
1,219.0,"South-Eastern Asia",971926,0,971926,686656,1144427,"IDN",915542
1,219.0,"Pakistan",1690391,1522388,168003,1284760,2141267,"PAK",1713014
1,219.0,"Southern Africa",119623,0,119623,81283,135472,"ZAF",108378
1,219.0,"Northern Europe",1864619,1841825,22794,1395422,2325703,"GBR",1860563
1,219.0,"Oceania",584555,558381,26174,342706,571177,"NZL",456942
1,219.0,"Central America",365265,0,365265,258873,431455,"MEX",345164
1,219.0,"Eastern Africa",443945,0,443945,323487,539146,"ETH",431317
1,219.0,"China",7698927,7687003,11924,5931314,9885523,"CPR",7908419
1,219.0,"Eastern Europe",4105977,4043915,62062,1995329,3325548,"POL",2660439
1,219.0,"India",5722734,5571285,151449,4381509,7302516,"IND",5842013
1,219.0,"Middle Africa",113941,0,113941,81811,136352,"AGO",109082
1,219.0,"Western Asia",883043,0,883043,647355,1078925,"IRQ",863140
1,219.0,"United States of America",2569274,2502787,66487,1761601,2936002,"USA",2348802
1,219.0,"Western Europe",4092236,3864549,227687,2898592,4830987,"NLD",3864790
1,219.0,"Russian Federation",3242650,3199873,42777,2457128,4095213,"RUS",3276171
1,219.0,"Northern Africa",1546065,0,1546065,1103401,1839002,"EGY",1471202
1,219.0,"Eastern Asia",783505,0,783505,514272,857120,"JPN",685696
1,219.0,"Western Africa",482325,0,482325,350869,584782,"NGA",467826
1,219.0,"Southern Europe",898689,0,898689,656247,1093746,"ITA",874997
1,220.0,"Northern America",605638,579489,26149,403005,671675,"CAN",537340
1,220.0,"Southern Asia",918431,0,918431,658519,1097532,"IRN",878026
1,220.0,"South America",1896229,1811995,84234,1397424,2329041,"BRA",1863233
1,220.0,"Central Asia",1640623,1612329,28294,1190692,1984487,"UZB",1587590
1,220.0,"South-Eastern Asia",971839,0,971839,686656,1144427,"IDN",915542
1,220.0,"Pakistan",1713341,1527854,185487,1284760,2141267,"PAK",1713014
1,220.0,"Southern Africa",119605,0,119605,81283,135472,"ZAF",108378
1,220.0,"Northern Europe",1844347,1827159,17188,1395422,2325703,"GBR",1860563
1,220.0,"Oceania",561084,536237,24847,342706,571177,"NZL",456942
1,220.0,"Central America",368684,0,368684,258873,431455,"MEX",345164
1,220.0,"Eastern Africa",443927,0,443927,323487,539146,"ETH",431317
1,220.0,"China",7744805,7744805,0,5931314,9885523,"CPR",7908419
1,220.0,"Eastern Europe",2696984,2657408,39576,1995329,3325548,"POL",2660439
1,220.0,"India",5766791,5618387,148404,4381509,7302516,"IND",5842013
1,220.0,"Middle Africa",113933,0,113933,81811,136352,"AGO",109082
1,220.0,"Western Asia",883014,0,883014,647355,1078925,"IRQ",863140
1,220.0,"United States of America",2597724,2527207,70517,1761601,2936002,"USA",2348802
1,220.0,"Western Europe",4077562,3857281,220281,2898592,4830987,"NLD",3864790
1,220.0,"Russian Federation",3212781,3179735,33046,2457128,4095213,"RUS",3276171
1,220.0,"Northern Africa",1553404,0,1553404,1103401,1839002,"EGY",1471202
1,220.0,"Eastern Asia",783351,0,783351,514272,857120,"JPN",685696
1,220.0,"Western Africa",483834,0,483834,350869,584782,"NGA",467826
1,220.0,"Southern Europe",901090,0,901090,656247,1093746,"ITA",874997
1,221.0,"Northern America",609539,583160,26379,403005,671675,"CAN",537340
1,221.0,"Southern Asia",916911,0,916911,658519,1097532,"IRN",878026
1,221.0,"South America",1825594,1736744,88850,1397424,2329041,"BRA",1863233
1,221.0,"Central Asia",1662608,1630040,32568,1190692,1984487,"UZB",1587590
1,221.0,"South-Eastern Asia",969736,0,969736,686656,1144427,"IDN",915542
1,221.0,"Pakistan",1732843,1533874,198969,1284760,2141267,"PAK",1713014
1,221.0,"Southern Africa",119185,0,119185,81283,135472,"ZAF",108378
1,221.0,"Northern Europe",1795689,1784013,11676,1395422,2325703,"GBR",1860563
1,221.0,"Oceania",553390,530584,22806,342706,571177,"NZL",456942
1,221.0,"Central America",368549,0,368549,258873,431455,"MEX",345164
1,221.0,"Eastern Africa",443457,0,443457,323487,539146,"ETH",431317
1,221.0,"China",7549755,7549755,0,5931314,9885523,"CPR",7908419
1,221.0,"Eastern Europe",2532537,2501758,30779,1995329,3325548,"POL",2660439
1,221.0,"India",5657821,5514224,143597,4381509,7302516,"IND",5842013
1,221.0,"Middle Africa",113752,0,113752,81811,136352,"AGO",109082
1,221.0,"Western Asia",882269,0,882269,647355,1078925,"IRQ",863140
1,221.0,"United States of America",2583499,2509683,73816,1761601,2936002,"USA",2348802
1,221.0,"Western Europe",4077562,3864209,213353,2898592,4830987,"NLD",3864790
1,221.0,"Russian Federation",3132586,3109095,23491,2457128,4095213,"RUS",3276171
1,221.0,"Northern Africa",1551966,0,1551966,1103401,1839002,"EGY",1471202
1,221.0,"Eastern Asia",779703,0,779703,514272,857120,"JPN",685696
1,221.0,"Western Africa",483522,0,483522,350869,584782,"NGA",467826
1,221.0,"Southern Europe",900561,0,900561,656247,1093746,"ITA",874997
1,222.0,"Northern America",607590,581148,26442,403005,671675,"CAN",537340
1,222.0,"Southern Asia",914121,0,914121,658519,1097532,"IRN",878026
1,222.0,"South America",1804269,1703410,100859,1397424,2329041,"BRA",1863233
1,222.0,"Central Asia",1562757,1533595,29162,1190692,1984487,"UZB",1587590
1,222.0,"South-Eastern Asia",965849,0,965849,686656,1144427,"IDN",915542
1,222.0,"Pakistan",1751807,1533255,218552,1284760,2141267,"PAK",1713014
1,222.0,"Southern Africa",118408,0,118408,81283,135472,"ZAF",108378
1,222.0,"Northern Europe",1771362,1765120,6242,1395422,2325703,"GBR",1860563
1,222.0,"Oceania",538778,516690,22088,342706,571177,"NZL",456942
1,222.0,"Central America",369460,0,369460,258873,431455,"MEX",345164
1,222.0,"Eastern Africa",442587,0,442587,323487,539146,"ETH",431317
1,222.0,"China",7408763,7408763,0,5931314,9885523,"CPR",7908419
1,222.0,"Eastern Europe",2473053,2450138,22915,1995329,3325548,"POL",2660439
1,222.0,"India",5582874,5442480,140394,4381509,7302516,"IND",5842013
1,222.0,"Middle Africa",113417,0,113417,81811,136352,"AGO",109082
1,222.0,"Western Asia",880900,0,880900,647355,1078925,"IRQ",863140
1,222.0,"United States of America",2569274,2492282,76992,1761601,2936002,"USA",2348802
1,222.0,"Western Europe",4077562,3871137,206425,2898592,4830987,"NLD",3864790
1,222.0,"Russian Federation",3077631,3060207,17424,2457128,4095213,"RUS",3276171
1,222.0,"Northern Africa",1548719,0,1548719,1103401,1839002,"EGY",1471202
1,222.0,"Eastern Asia",772960,0,772960,514272,857120,"JPN",685696
1,222.0,"Western Africa",482886,0,482886,350869,584782,"NGA",467826
1,222.0,"Southern Europe",899517,0,899517,656247,1093746,"ITA",874997
1,223.0,"Northern America",599784,573330,26454,403005,671675,"CAN",537340
1,223.0,"Southern Asia",910623,0,910623,658519,1097532,"IRN",878026
1,223.0,"South America",1908618,1789825,118793,1397424,2329041,"BRA",1863233
1,223.0,"Central Asia",1619842,1586520,33322,1190692,1984487,"UZB",1587590
1,223.0,"South-Eastern Asia",960976,0,960976,686656,1144427,"IDN",915542
1,223.0,"Pakistan",1786960,1547434,239526,1284760,2141267,"PAK",1713014
1,223.0,"Southern Africa",117440,0,117440,81283,135472,"ZAF",108378
1,223.0,"Northern Europe",1872724,1872042,682,1395422,2325703,"GBR",1860563
1,223.0,"Oceania",527088,505511,21577,342706,571177,"NZL",456942
1,223.0,"Central America",369411,0,369411,258873,431455,"MEX",345164
1,223.0,"Eastern Africa",441495,0,441495,323487,539146,"ETH",431317
1,223.0,"China",8085391,8081432,3959,5931314,9885523,"CPR",7908419
1,223.0,"Eastern Europe",2721536,2705477,16059,1995329,3325548,"POL",2660439
1,223.0,"India",5964492,5819435,145057,4381509,7302516,"IND",5842013
1,223.0,"Middle Africa",112998,0,112998,81811,136352,"AGO",109082
1,223.0,"Western Asia",879178,0,879178,647355,1078925,"IRQ",863140
1,223.0,"United States of America",2540826,2467470,73356,1761601,2936002,"USA",2348802
1,223.0,"Western Europe",4070224,3870728,199496,2898592,4830987,"NLD",3864790
1,223.0,"Russian Federation",3355209,3330462,24747,2457128,4095213,"RUS",3276171
1,223.0,"Northern Africa",1542557,0,1542557,1103401,1839002,"EGY",1471202
1,223.0,"Eastern Asia",764503,0,764503,514272,857120,"JPN",685696
1,223.0,"Western Africa",481678,0,481678,350869,584782,"NGA",467826
1,223.0,"Southern Europe",897542,0,897542,656247,1093746,"ITA",874997
1,224.0,"Northern America",591979,565421,26558,403005,671675,"CAN",537340
1,224.0,"Southern Asia",906622,0,906622,658519,1097532,"IRN",878026
1,224.0,"South America",1834141,1710059,124082,1397424,2329041,"BRA",1863233
1,224.0,"Central Asia",1560405,1522271,38134,1190692,1984487,"UZB",1587590
1,224.0,"South-Eastern Asia",955393,0,955393,686656,1144427,"IDN",915542
1,224.0,"Pakistan",1815745,1559006,256739,1284760,2141267,"PAK",1713014
1,224.0,"Southern Africa",116326,0,116326,81283,135472,"ZAF",108378
1,224.0,"Northern Europe",1828128,1828128,0,1395422,2325703,"GBR",1860563
1,224.0,"Oceania",516370,495139,21231,342706,571177,"NZL",456942
1,224.0,"Central America",366731,0,366731,258873,431455,"MEX",345164
1,224.0,"Eastern Africa",440246,0,440246,323487,539146,"ETH",431317
1,224.0,"China",7627107,7610085,17022,5931314,9885523,"CPR",7908419
1,224.0,"Eastern Europe",2558494,2542975,15519,1995329,3325548,"POL",2660439
1,224.0,"India",5686206,5548646,137560,4381509,7302516,"IND",5842013
1,224.0,"Middle Africa",112517,0,112517,81811,136352,"AGO",109082
1,224.0,"Western Asia",877208,0,877208,647355,1078925,"IRQ",863140
1,224.0,"United States of America",2519491,2456043,63448,1761601,2936002,"USA",2348802
1,224.0,"Western Europe",4055550,3862744,192806,2898592,4830987,"NLD",3864790
1,224.0,"Russian Federation",3170397,3146299,24098,2457128,4095213,"RUS",3276171
1,224.0,"Northern Africa",1534581,0,1534581,1103401,1839002,"EGY",1471202
1,224.0,"Eastern Asia",755780,0,755780,514272,857120,"JPN",685696
1,224.0,"Western Africa",480119,0,480119,350869,584782,"NGA",467826
1,224.0,"Southern Europe",895000,0,895000,656247,1093746,"ITA",874997
1,225.0,"Northern America",580272,555119,25153,403005,671675,"CAN",537340
1,225.0,"Southern Asia",875559,0,875559,658519,1097532,"IRN",878026
1,225.0,"South America",1872931,1763982,108949,1397424,2329041,"BRA",1863233
1,225.0,"Central Asia",1608625,1571974,36651,1190692,1984487,"UZB",1587590
1,225.0,"South-Eastern Asia",912099,0,912099,686656,1144427,"IDN",915542
1,225.0,"Pakistan",1815223,1567372,247851,1284760,2141267,"PAK",1713014
1,225.0,"Southern Africa",107696,0,107696,81283,135472,"ZAF",108378
1,225.0,"Northern Europe",1888944,1888944,0,1395422,2325703,"GBR",1860563
1,225.0,"Oceania",510525,489472,21053,342706,571177,"NZL",456942
1,225.0,"Central America",337653,0,337653,258873,431455,"MEX",345164
1,225.0,"Eastern Africa",430549,0,430549,323487,539146,"ETH",431317
1,225.0,"China",8095013,8048628,46385,5931314,9885523,"CPR",7908419
1,225.0,"Eastern Europe",2725982,2702920,23062,1995329,3325548,"POL",2660439
1,225.0,"India",5931456,5802163,129293,4381509,7302516,"IND",5842013
1,225.0,"Middle Africa",108789,0,108789,81811,136352,"AGO",109082
1,225.0,"Western Asia",861930,0,861930,647355,1078925,"IRQ",863140
1,225.0,"United States of America",2042989,1988849,54140,1761601,2936002,"USA",2348802
1,225.0,"Western Europe",3989519,3810284,179235,2898592,4830987,"NLD",3864790
1,225.0,"Russian Federation",3344700,3314323,30377,2457128,4095213,"RUS",3276171
1,225.0,"Northern Africa",1453754,0,1453754,1103401,1839002,"EGY",1471202
1,225.0,"Eastern Asia",679951,0,679951,514272,857120,"JPN",685696
1,225.0,"Western Africa",463551,0,463551,350869,584782,"NGA",467826
1,225.0,"Southern Europe",867820,0,867820,656247,1093746,"ITA",874997
1,226.0,"Northern America",513929,491355,22574,403005,671675,"CAN",537340
1,226.0,"Southern Asia",866181,0,866181,658519,1097532,"IRN",878026
1,226.0,"South America",1812002,1721929,90073,1397424,2329041,"BRA",1863233
1,226.0,"Central Asia",1555159,1523702,31457,1190692,1984487,"UZB",1587590
1,226.0,"South-Eastern Asia",899115,0,899115,686656,1144427,"IDN",915542
1,226.0,"Pakistan",1813588,1573180,240408,1284760,2141267,"PAK",1713014
1,226.0,"Southern Africa",105083,0,105083,81283,135472,"ZAF",108378
1,226.0,"Northern Europe",1811910,1811910,0,1395422,2325703,"GBR",1860563
1,226.0,"Oceania",490068,470410,19658,342706,571177,"NZL",456942
1,226.0,"Central America",330154,0,330154,258873,431455,"MEX",345164
1,226.0,"Eastern Africa",427613,0,427613,323487,539146,"ETH",431317
1,226.0,"China",7644004,7631177,12827,5931314,9885523,"CPR",7908419
1,226.0,"Eastern Europe",2560283,2552278,8005,1995329,3325548,"POL",2660439
1,226.0,"India",5699915,5587248,112667,4381509,7302516,"IND",5842013
1,226.0,"Middle Africa",107657,0,107657,81811,136352,"AGO",109082
1,226.0,"Western Asia",857312,0,857312,647355,1078925,"IRQ",863140
1,226.0,"United States of America",2178113,2113340,64773,1761601,2936002,"USA",2348802
1,226.0,"Western Europe",3776751,3612531,164220,2898592,4830987,"NLD",3864790
1,226.0,"Russian Federation",3166124,3156918,9206,2457128,4095213,"RUS",3276171
1,226.0,"Northern Africa",1438695,0,1438695,1103401,1839002,"EGY",1471202
1,226.0,"Eastern Asia",657648,0,657648,514272,857120,"JPN",685696
1,226.0,"Western Africa",459272,0,459272,350869,584782,"NGA",467826
1,226.0,"Southern Europe",861007,0,861007,656247,1093746,"ITA",874997
1,227.0,"Northern America",523677,502227,21450,403010,671683,"CAN",537347
1,227.0,"Southern Asia",869749,0,869749,658526,1097543,"IRN",878035
1,227.0,"South America",1831436,1749831,81605,1397427,2329045,"BRA",1863236
1,227.0,"Central Asia",1567058,1539730,27328,1190693,1984488,"UZB",1587591
1,227.0,"South-Eastern Asia",904125,0,904125,686661,1144435,"IDN",915548
1,227.0,"Pakistan",1815333,1580566,234767,1284765,2141275,"PAK",1713020
1,227.0,"Southern Africa",106075,0,106075,81290,135483,"ZAF",108387
1,227.0,"Northern Europe",1832180,1832180,0,1395426,2325711,"GBR",1860569
1,227.0,"Oceania",467662,450175,17487,342706,571177,"NZL",456942
1,227.0,"Central America",335751,0,335751,258879,431465,"MEX",345172
1,227.0,"Eastern Africa",428730,0,428730,323494,539157,"ETH",431326
1,227.0,"China",7747751,7743243,4508,5931315,9885525,"CPR",7908420
1,227.0,"Eastern Europe",2597347,2597347,0,1995334,3325557,"POL",2660446
1,227.0,"India",5755916,5658249,97667,4381510,7302517,"IND",5842014
1,227.0,"Middle Africa",108084,0,108084,81814,136357,"AGO",109086
1,227.0,"Western Asia",859064,0,859064,647355,1078926,"IRQ",863141
1,227.0,"United States of America",2242122,2167511,74611,1761603,2936006,"USA",2348805
1,227.0,"Western Europe",3813430,3658173,155257,2898600,4831001,"NLD",3864801
1,227.0,"Russian Federation",3207425,3207425,0,2457136,4095227,"RUS",3276182
1,227.0,"Northern Africa",1448487,0,1448487,1103403,1839006,"EGY",1471205
1,227.0,"Eastern Asia",665821,0,665821,514278,857131,"JPN",685705
1,227.0,"Western Africa",462837,0,462837,350870,584783,"NGA",467827
1,227.0,"Southern Europe",866296,0,866296,656254,1093757,"ITA",875006
1,228.0,"Northern America",549045,528944,20101,375213,625356,"CAN",500285
1,228.0,"Southern Asia",877463,0,877463,414039,690065,"IRN",552052
1,228.0,"South America",1879755,1803052,76703,1521965,2536608,"BRA",2029287
1,228.0,"Central Asia",1604355,1580532,23823,1233222,2055371,"UZB",1644297
1,228.0,"South-Eastern Asia",914517,0,914517,784509,1307516,"IDN",1046013
1,228.0,"Pakistan",1819008,1586564,232444,1369593,2282655,"PAK",1826124
1,228.0,"Southern Africa",108218,0,108218,92154,153591,"ZAF",122873
1,228.0,"Northern Europe",1884889,1884889,0,1523699,2539498,"GBR",2031599
1,228.0,"Oceania",458893,443015,15878,476475,794125,"NZL",635300
1,228.0,"Central America",344186,0,344186,371225,618708,"MEX",494967
1,228.0,"Eastern Africa",431138,0,431138,332490,554150,"ETH",443320
1,228.0,"China",8042141,8032859,9282,6576264,10960441,"CPR",8768353
1,228.0,"Eastern Europe",2708049,2705125,2924,2250557,3750928,"POL",3000743
1,228.0,"India",5913739,5832541,81198,4866416,8110693,"IND",6488555
1,228.0,"Middle Africa",109013,0,109013,87425,145708,"AGO",116567
1,228.0,"Western Asia",862864,0,862864,588156,980260,"IRQ",784208
1,228.0,"United States of America",2284792,2201226,83566,1817139,3028565,"USA",2422852
1,228.0,"Western Europe",3908810,3763619,145191,2858886,4764810,"NLD",3811848
1,228.0,"Russian Federation",3327421,3323025,4396,1776954,2961591,"RUS",2369273
1,228.0,"Northern Africa",1469669,0,1469669,1316664,2194441,"EGY",1755553
1,228.0,"Eastern Asia",683864,0,683864,614727,1024545,"JPN",819636
1,228.0,"Western Africa",467518,0,467518,387831,646385,"NGA",517108
1,228.0,"Southern Europe",874149,0,874149,615844,1026407,"ITA",821126
1,229.0,"Northern America",527594,509200,18394,375213,625356,"CAN",500285
1,229.0,"Southern Asia",874731,0,874731,414039,690065,"IRN",552052
1,229.0,"South America",1756998,1690206,66792,1521965,2536608,"BRA",2029287
1,229.0,"Central Asia",1574487,1555724,18763,1233222,2055371,"UZB",1644297
1,229.0,"South-Eastern Asia",911090,0,911090,784509,1307516,"IDN",1046013
1,229.0,"Pakistan",1816975,1589166,227809,1369593,2282655,"PAK",1826124
1,229.0,"Southern Africa",107465,0,107465,92154,153591,"ZAF",122873
1,229.0,"Northern Europe",1840297,1840297,0,1523699,2539498,"GBR",2031599
1,229.0,"Oceania",459782,445930,13852,476475,794125,"NZL",635300
1,229.0,"Central America",341683,0,341683,371225,618708,"MEX",494967
1,229.0,"Eastern Africa",430289,0,430289,332490,554150,"ETH",443320
1,229.0,"China",7804780,7804625,155,6576264,10960441,"CPR",8768353
1,229.0,"Eastern Europe",2622867,2622867,0,2250557,3750928,"POL",3000743
1,229.0,"India",5782483,5721236,61247,4866416,8110693,"IND",6488555
1,229.0,"Middle Africa",108686,0,108686,87425,145708,"AGO",116567
1,229.0,"Western Asia",861513,0,861513,588156,980260,"IRQ",784208
1,229.0,"United States of America",2327467,2235389,92078,1817139,3028565,"USA",2422852
1,229.0,"Western Europe",3828118,3695156,132962,2858886,4764810,"NLD",3811848
1,229.0,"Russian Federation",3236651,3236651,0,1776954,2961591,"RUS",2369273
1,229.0,"Northern Africa",1462141,0,1462141,1316664,2194441,"EGY",1755553
1,229.0,"Eastern Asia",677971,0,677971,614727,1024545,"JPN",819636
1,229.0,"Western Africa",466028,0,466028,387831,646385,"NGA",517108
1,229.0,"Southern Europe",871752,0,871752,615844,1026407,"ITA",821126
1,230.0,"Northern America",510046,493599,16447,375213,625356,"CAN",500285
1,230.0,"Southern Asia",546761,0,546761,414039,690065,"IRN",552052
1,230.0,"South America",1770071,1690063,80008,1521965,2536608,"BRA",2029287
1,230.0,"Central Asia",1656245,1640867,15378,1233222,2055371,"UZB",1644297
1,230.0,"South-Eastern Asia",1038533,0,1038533,784509,1307516,"IDN",1046013
1,230.0,"Pakistan",1845768,1610620,235148,1369593,2282655,"PAK",1826124
1,230.0,"Southern Africa",121397,0,121397,92154,153591,"ZAF",122873
1,230.0,"Northern Europe",1954562,1954562,0,1523699,2539498,"GBR",2031599
1,230.0,"Oceania",640238,625228,15010,476475,794125,"NZL",635300
1,230.0,"Central America",485535,0,485535,371225,618708,"MEX",494967
1,230.0,"Eastern Africa",441662,0,441662,332490,554150,"ETH",443320
1,230.0,"China",8530854,8507341,23513,6576264,10960441,"CPR",8768353
1,230.0,"Eastern Europe",3027067,3017732,9335,2250557,3750928,"POL",3000743
1,230.0,"India",6541112,6493275,47837,4866416,8110693,"IND",6488555
1,230.0,"Middle Africa",115926,0,115926,87425,145708,"AGO",116567
1,230.0,"Western Asia",781608,0,781608,588156,980260,"IRQ",784208
1,230.0,"United States of America",2287724,2186376,101348,1817139,3028565,"USA",2422852
1,230.0,"Western Europe",3848534,3720100,128434,2858886,4764810,"NLD",3811848
1,230.0,"Russian Federation",2476114,2476114,0,1776954,2961591,"RUS",2369273
1,230.0,"Northern Africa",1741004,0,1741004,1316664,2194441,"EGY",1755553
1,230.0,"Eastern Asia",806615,0,806615,614727,1024545,"JPN",819636
1,230.0,"Western Africa",514225,0,514225,387831,646385,"NGA",517108
1,230.0,"Southern Europe",816818,0,816818,615844,1026407,"ITA",821126
1,231.0,"Northern America",482725,467923,14802,375213,625356,"CAN",500285
1,231.0,"Southern Asia",542135,0,542135,414039,690065,"IRN",552052
1,231.0,"South America",1790472,1691796,98676,1521965,2536608,"BRA",2029287
1,231.0,"Central Asia",1619909,1609511,10398,1233222,2055371,"UZB",1644297
1,231.0,"South-Eastern Asia",1032491,0,1032491,784509,1307516,"IDN",1046013
1,231.0,"Pakistan",1849364,1613231,236133,1369593,2282655,"PAK",1826124
1,231.0,"Southern Africa",120113,0,120113,92154,153591,"ZAF",122873
1,231.0,"Northern Europe",1970780,1964533,6247,1523699,2539498,"GBR",2031599
1,231.0,"Oceania",626534,613501,13033,476475,794125,"NZL",635300
1,231.0,"Central America",486205,0,486205,371225,618708,"MEX",494967
1,231.0,"Eastern Africa",440219,0,440219,332490,554150,"ETH",443320
1,231.0,"China",8517301,8517301,0,6576264,10960441,"CPR",8768353
1,231.0,"Eastern Europe",2929024,2929024,0,2250557,3750928,"POL",3000743
1,231.0,"India",6380205,6351986,28219,4866416,8110693,"IND",6488555
1,231.0,"Middle Africa",115374,0,115374,87425,145708,"AGO",116567
1,231.0,"Western Asia",779326,0,779326,588156,980260,"IRQ",784208
1,231.0,"United States of America",2344619,2232963,111656,1817139,3028565,"USA",2422852
1,231.0,"Western Europe",3745817,3629573,116244,2858886,4764810,"NLD",3811848
1,231.0,"Russian Federation",2299188,2299188,0,1776954,2961591,"RUS",2369273
1,231.0,"Northern Africa",1728340,0,1728340,1316664,2194441,"EGY",1755553
1,231.0,"Eastern Asia",796346,0,796346,614727,1024545,"JPN",819636
1,231.0,"Western Africa",511717,0,511717,387831,646385,"NGA",517108
1,231.0,"Southern Europe",813074,0,813074,615844,1026407,"ITA",821126
1,232.0,"Northern America",480771,467234,13537,375213,625356,"CAN",500285
1,232.0,"Southern Asia",542468,0,542468,414039,690065,"IRN",552052
1,232.0,"South America",1820390,1698268,122122,1521965,2536608,"BRA",2029287
1,232.0,"Central Asia",1615578,1610058,5520,1233222,2055371,"UZB",1644297
1,232.0,"South-Eastern Asia",1032913,0,1032913,784509,1307516,"IDN",1046013
1,232.0,"Pakistan",1852443,1615894,236549,1369593,2282655,"PAK",1826124
1,232.0,"Southern Africa",120208,0,120208,92154,153591,"ZAF",122873
1,232.0,"Northern Europe",1986998,1974419,12579,1523699,2539498,"GBR",2031599
1,232.0,"Oceania",625556,614319,11237,476475,794125,"NZL",635300
1,232.0,"Central America",486645,0,486645,371225,618708,"MEX",494967
1,232.0,"Eastern Africa",440326,0,440326,332490,554150,"ETH",443320
1,232.0,"China",8538653,8537463,1190,6576264,10960441,"CPR",8768353
1,232.0,"Eastern Europe",2915298,2915298,0,2250557,3750928,"POL",3000743
1,232.0,"India",6365648,6356796,8852,4866416,8110693,"IND",6488555
1,232.0,"Middle Africa",115412,0,115412,87425,145708,"AGO",116567
1,232.0,"Western Asia",779492,0,779492,588156,980260,"IRQ",784208
1,232.0,"United States of America",2358843,2238045,120798,1817139,3028565,"USA",2422852
1,232.0,"Western Europe",3738478,3632444,106034,2858886,4764810,"NLD",3811848
1,232.0,"Russian Federation",2277566,2277566,0,1776954,2961591,"RUS",2369273
1,232.0,"Northern Africa",1729254,0,1729254,1316664,2194441,"EGY",1755553
1,232.0,"Eastern Asia",796852,0,796852,614727,1024545,"JPN",819636
1,232.0,"Western Africa",511900,0,511900,387831,646385,"NGA",517108
1,232.0,"Southern Europe",813402,0,813402,615844,1026407,"ITA",821126
1,233.0,"Northern America",533454,521185,12269,375213,625356,"CAN",500285
1,233.0,"Southern Asia",554566,0,554566,414039,690065,"IRN",552052
1,233.0,"South America",1853728,1700732,152996,1521965,2536608,"BRA",2029287
1,233.0,"Central Asia",1690104,1689510,594,1233222,2055371,"UZB",1644297
1,233.0,"South-Eastern Asia",1049657,0,1049657,784509,1307516,"IDN",1046013
1,233.0,"Pakistan",1856768,1615916,240852,1369593,2282655,"PAK",1826124
1,233.0,"Southern Africa",123570,0,123570,92154,153591,"ZAF",122873
1,233.0,"Northern Europe",2003215,1984283,18932,1523699,2539498,"GBR",2031599
1,233.0,"Oceania",651858,642424,9434,476475,794125,"NZL",635300
1,233.0,"Central America",495394,0,495394,371225,618708,"MEX",494967
1,233.0,"Eastern Africa",444102,0,444102,332490,554150,"ETH",443320
1,233.0,"China",8569766,8559042,10724,6576264,10960441,"CPR",8768353
1,233.0,"Eastern Europe",3134734,3133417,1317,2250557,3750928,"POL",3000743
1,233.0,"India",6693026,6692859,167,4866416,8110693,"IND",6488555
1,233.0,"Middle Africa",116864,0,116864,87425,145708,"AGO",116567
1,233.0,"Western Asia",785443,0,785443,588156,980260,"IRQ",784208
1,233.0,"United States of America",2373066,2243375,129691,1817139,3028565,"USA",2422852
1,233.0,"Western Europe",3811847,3716033,95814,2858886,4764810,"NLD",3811848
1,233.0,"Russian Federation",2509724,2509724,0,1776954,2961591,"RUS",2369273
1,233.0,"Northern Africa",1762467,0,1762467,1316664,2194441,"EGY",1755553
1,233.0,"Eastern Asia",825898,0,825898,614727,1024545,"JPN",819636
1,233.0,"Western Africa",518471,0,518471,387831,646385,"NGA",517108
1,233.0,"Southern Europe",821586,0,821586,615844,1026407,"ITA",821126
1,234.0,"Northern America",504191,493769,10422,375213,625356,"CAN",500285
1,234.0,"Southern Asia",551990,0,551990,414039,690065,"IRN",552052
1,234.0,"South America",1882528,1702806,179722,1521965,2536608,"BRA",2029287
1,234.0,"Central Asia",1651798,1651798,0,1233222,2055371,"UZB",1644297
1,234.0,"South-Eastern Asia",1046037,0,1046037,784509,1307516,"IDN",1046013
1,234.0,"Pakistan",2085856,1842543,243313,1369593,2282655,"PAK",1826124
1,234.0,"Southern Africa",122860,0,122860,92154,153591,"ZAF",122873
1,234.0,"Northern Europe",2019434,1994190,25244,1523699,2539498,"GBR",2031599
1,234.0,"Oceania",637252,629861,7391,476475,794125,"NZL",635300
1,234.0,"Central America",494624,0,494624,371225,618708,"MEX",494967
1,234.0,"Eastern Africa",443307,0,443307,332490,554150,"ETH",443320
1,234.0,"China",8589102,8555702,33400,6576264,10960441,"CPR",8768353
1,234.0,"Eastern Europe",3025060,3025060,0,2250557,3750928,"POL",3000743
1,234.0,"India",6515893,6515893,0,4866416,8110693,"IND",6488555
1,234.0,"Middle Africa",116567,0,116567,87425,145708,"AGO",116567
1,234.0,"Western Asia",784181,0,784181,588156,980260,"IRQ",784208
1,234.0,"United States of America",2415739,2277445,138294,1817139,3028565,"USA",2422852
1,234.0,"Western Europe",3804510,3715311,89199,2858886,4764810,"NLD",3811848
1,234.0,"Russian Federation",2396879,2396879,0,1776954,2961591,"RUS",2369273
1,234.0,"Northern Africa",1755379,0,1755379,1316664,2194441,"EGY",1755553
1,234.0,"Eastern Asia",819691,0,819691,614727,1024545,"JPN",819636
1,234.0,"Western Africa",517079,0,517079,387831,646385,"NGA",517108
1,234.0,"Southern Europe",820886,0,820886,615844,1026407,"ITA",821126
1,235.0,"Northern America",500288,491399,8889,375213,625356,"CAN",500285
1,235.0,"Southern Asia",552275,0,552275,414039,690065,"IRN",552052
1,235.0,"South America",1905633,1702077,203556,1521965,2536608,"BRA",2029287
1,235.0,"Central Asia",1644620,1644620,0,1233222,2055371,"UZB",1644297
1,235.0,"South-Eastern Asia",1046245,0,1046245,784509,1307516,"IDN",1046013
1,235.0,"Pakistan",2062369,1844185,218184,1369593,2282655,"PAK",1826124
1,235.0,"Southern Africa",122933,0,122933,92154,153591,"ZAF",122873
1,235.0,"Northern Europe",2043761,2012308,31453,1523699,2539498,"GBR",2031599
1,235.0,"Oceania",635302,629827,5475,476475,794125,"NZL",635300
1,235.0,"Central America",495173,0,495173,371225,618708,"MEX",494967
1,235.0,"Eastern Africa",443388,0,443388,332490,554150,"ETH",443320
1,235.0,"China",8609901,8550081,59820,6576264,10960441,"CPR",8768353
1,235.0,"Eastern Europe",3002213,3002213,0,2250557,3750928,"POL",3000743
1,235.0,"India",6488968,6488968,0,4866416,8110693,"IND",6488555
1,235.0,"Middle Africa",116592,0,116592,87425,145708,"AGO",116567
1,235.0,"Western Asia",784316,0,784316,588156,980260,"IRQ",784208
1,235.0,"United States of America",2429963,2284201,145762,1817139,3028565,"USA",2422852
1,235.0,"Western Europe",3804510,3720388,84122,2858886,4764810,"NLD",3811848
1,235.0,"Russian Federation",2371296,2371296,0,1776954,2961591,"RUS",2369273
1,235.0,"Northern Africa",1756174,0,1756174,1316664,2194441,"EGY",1755553
1,235.0,"Eastern Asia",820034,0,820034,614727,1024545,"JPN",819636
1,235.0,"Western Africa",517228,0,517228,387831,646385,"NGA",517108
1,235.0,"Southern Europe",821318,0,821318,615844,1026407,"ITA",821126
1,236.0,"Northern America",496383,488994,7389,375213,625356,"CAN",500285
1,236.0,"Southern Asia",552801,0,552801,414039,690065,"IRN",552052
1,236.0,"South America",1928956,1703644,225312,1521965,2536608,"BRA",2029287
1,236.0,"Central Asia",1638777,1638777,0,1233222,2055371,"UZB",1644297
1,236.0,"South-Eastern Asia",1046345,0,1046345,784509,1307516,"IDN",1046013
1,236.0,"Pakistan",1860033,1667457,192576,1369593,2282655,"PAK",1826124
1,236.0,"Southern Africa",123083,0,123083,92154,153591,"ZAF",122873
1,236.0,"Northern Europe",2185672,2148262,37410,1523699,2539498,"GBR",2031599
1,236.0,"Oceania",633352,629782,3570,476475,794125,"NZL",635300
1,236.0,"Central America",495889,0,495889,371225,618708,"MEX",494967
1,236.0,"Eastern Africa",443556,0,443556,332490,554150,"ETH",443320
1,236.0,"China",8652661,8565302,87359,6576264,10960441,"CPR",8768353
1,236.0,"Eastern Europe",2984613,2984613,0,2250557,3750928,"POL",3000743
1,236.0,"India",6464307,6464307,0,4866416,8110693,"IND",6488555
1,236.0,"Middle Africa",116661,0,116661,87425,145708,"AGO",116567
1,236.0,"Western Asia",784577,0,784577,588156,980260,"IRQ",784208
1,236.0,"United States of America",2437077,2284257,152820,1817139,3028565,"USA",2422852
1,236.0,"Western Europe",3804511,3724997,79514,2858886,4764810,"NLD",3811848
1,236.0,"Russian Federation",2352108,2352108,0,1776954,2961591,"RUS",2369273
1,236.0,"Northern Africa",1757596,0,1757596,1316664,2194441,"EGY",1755553
1,236.0,"Eastern Asia",819451,0,819451,614727,1024545,"JPN",819636
1,236.0,"Western Africa",517514,0,517514,387831,646385,"NGA",517108
1,236.0,"Southern Europe",821989,0,821989,615844,1026407,"ITA",821126
1,237.0,"Northern America",498331,492421,5910,375213,625356,"CAN",500285
1,237.0,"Southern Asia",563555,0,563555,414039,690065,"IRN",552052
1,237.0,"South America",1959067,1704127,254940,1521965,2536608,"BRA",2029287
1,237.0,"Central Asia",1641293,1641293,0,1233222,2055371,"UZB",1644297
1,237.0,"South-Eastern Asia",1062043,0,1062043,784509,1307516,"IDN",1046013
1,237.0,"Pakistan",1821913,1640235,181678,1369593,2282655,"PAK",1826124
1,237.0,"Southern Africa",126073,0,126073,92154,153591,"ZAF",122873
1,237.0,"Northern Europe",2096474,2065427,31047,1523699,2539498,"GBR",2031599
1,237.0,"Oceania",634325,632657,1668,476475,794125,"NZL",635300
1,237.0,"Central America",506067,0,506067,371225,618708,"MEX",494967
1,237.0,"Eastern Africa",446917,0,446917,332490,554150,"ETH",443320
1,237.0,"China",9005406,8890270,115136,6576264,10960441,"CPR",8768353
1,237.0,"Eastern Europe",2992069,2991659,410,2250557,3750928,"POL",3000743
1,237.0,"India",6476062,6476062,0,4866416,8110693,"IND",6488555
1,237.0,"Middle Africa",117951,0,117951,87425,145708,"AGO",116567
1,237.0,"Western Asia",789869,0,789869,588156,980260,"IRQ",784208
1,237.0,"United States of America",2678884,2519236,159648,1817139,3028565,"USA",2422852
1,237.0,"Western Europe",3716467,3630425,86042,2858886,4764810,"NLD",3811848
1,237.0,"Russian Federation",2359358,2359358,0,1776954,2961591,"RUS",2369273
1,237.0,"Northern Africa",1787126,0,1787126,1316664,2194441,"EGY",1755553
1,237.0,"Eastern Asia",846597,0,846597,614727,1024545,"JPN",819636
1,237.0,"Western Africa",523364,0,523364,387831,646385,"NGA",517108
1,237.0,"Southern Europe",831503,0,831503,615844,1026407,"ITA",821126
1,238.0,"Northern America",478819,474402,4417,375213,625356,"CAN",500285
1,238.0,"Southern Asia",557604,0,557604,414039,690065,"IRN",552052
1,238.0,"South America",1979308,1704162,275146,1521965,2536608,"BRA",2029287
1,238.0,"Central Asia",1613729,1613729,0,1233222,2055371,"UZB",1644297
1,238.0,"South-Eastern Asia",1053751,0,1053751,784509,1307516,"IDN",1046013
1,238.0,"Pakistan",1790080,1614685,175395,1369593,2282655,"PAK",1826124
1,238.0,"Southern Africa",124419,0,124419,92154,153591,"ZAF",122873
1,238.0,"Northern Europe",1987003,1962567,24436,1523699,2539498,"GBR",2031599
1,238.0,"Oceania",624584,624584,0,476475,794125,"NZL",635300
1,238.0,"Central America",501683,0,501683,371225,618708,"MEX",494967
1,238.0,"Eastern Africa",445056,0,445056,332490,554150,"ETH",443320
1,238.0,"China",9038476,8903929,134547,6576264,10960441,"CPR",8768353
1,238.0,"Eastern Europe",2911017,2911017,0,2250557,3750928,"POL",3000743
1,238.0,"India",6354968,6354968,0,4866416,8110693,"IND",6488555
1,238.0,"Middle Africa",117240,0,117240,87425,145708,"AGO",116567
1,238.0,"Western Asia",786941,0,786941,588156,980260,"IRQ",784208
1,238.0,"United States of America",2607764,2449162,158602,1817139,3028565,"USA",2422852
1,238.0,"Western Europe",3775163,3676086,99077,2858886,4764810,"NLD",3811848
1,238.0,"Russian Federation",2273317,2273317,0,1776954,2961591,"RUS",2369273
1,238.0,"Northern Africa",1770789,0,1770789,1316664,2194441,"EGY",1755553
1,238.0,"Eastern Asia",833857,0,833857,614727,1024545,"JPN",819636
1,238.0,"Western Africa",520129,0,520129,387831,646385,"NGA",517108
1,238.0,"Southern Europe",827332,0,827332,615844,1026407,"ITA",821126
1,239.0,"Northern America",488576,485597,2979,375216,625361,"CAN",500289
1,239.0,"Southern Asia",557705,0,557705,414043,690072,"IRN",552058
1,239.0,"South America",1998970,1705951,293019,1521971,2536618,"BRA",2029295
1,239.0,"Central Asia",1626381,1626381,0,1233229,2055382,"UZB",1644306
1,239.0,"South-Eastern Asia",1053892,0,1053892,784512,1307520,"IDN",1046016
1,239.0,"Pakistan",1804616,1632779,171837,1369600,2282667,"PAK",1826134
1,239.0,"Southern Africa",124449,0,124449,92159,153598,"ZAF",122879
1,239.0,"Northern Europe",2007196,1988662,18534,1523707,2539512,"GBR",2031610
1,239.0,"Oceania",629454,629454,0,476476,794127,"NZL",635302
1,239.0,"Central America",501152,0,501152,371232,618721,"MEX",494977
1,239.0,"Eastern Africa",445091,0,445091,332496,554161,"ETH",443329
1,239.0,"China",9042463,8894464,147999,6576266,10960443,"CPR",8768355
1,239.0,"Eastern Europe",2946671,2946671,0,2250558,3750930,"POL",3000744
1,239.0,"India",6413778,6413778,0,4866419,8110698,"IND",6488559
1,239.0,"Middle Africa",117248,0,117248,87426,145711,"AGO",116569
1,239.0,"Western Asia",786991,0,786991,588157,980262,"IRQ",784210
1,239.0,"United States of America",2557982,2398391,159591,1817141,3028568,"USA",2422855
1,239.0,"Western Europe",3811847,3700649,111198,2858887,4764812,"NLD",3811850
1,239.0,"Russian Federation",2310298,2310298,0,1776954,2961591,"RUS",2369273
1,239.0,"Northern Africa",1771068,0,1771068,1316668,2194447,"EGY",1755558
1,239.0,"Eastern Asia",833733,0,833733,614734,1024557,"JPN",819646
1,239.0,"Western Africa",520182,0,520182,387836,646393,"NGA",517115
1,239.0,"Southern Europe",826862,0,826862,615849,1026416,"ITA",821133
1,240.0,"Northern America",480770,479275,1495,489124,815207,"CAN",652166
1,240.0,"Southern Asia",554775,0,554775,357988,596647,"IRN",477318
1,240.0,"South America",2009129,1703533,305596,1669054,2781757,"BRA",2225406
1,240.0,"Central Asia",1615856,1615856,0,1424480,2374133,"UZB",1899307
1,240.0,"South-Eastern Asia",1049880,0,1049880,954939,1591566,"IDN",1273253
1,240.0,"Pakistan",1793006,1625573,167433,1527854,2546423,"PAK",2037139
1,240.0,"Southern Africa",123633,0,123633,132246,220410,"ZAF",176328
1,240.0,"Northern Europe",1991052,1978515,12537,1642345,2737242,"GBR",2189794
1,240.0,"Oceania",625558,625558,0,444324,740541,"NZL",592433
1,240.0,"Central America",498755,0,498755,406210,677017,"MEX",541614
1,240.0,"Eastern Africa",444174,0,444174,431263,718772,"ETH",575018
1,240.0,"China",8779586,8659998,119588,8045973,13409956,"CPR",10727965
1,240.0,"Eastern Europe",2916386,2916386,0,2539092,4231821,"POL",3385457
1,240.0,"India",6366156,6366156,0,5251611,8752685,"IND",7002148
1,240.0,"Middle Africa",116898,0,116898,112264,187107,"AGO",149686
1,240.0,"Western Asia",785550,0,785550,882339,1470565,"IRQ",1176452
1,240.0,"United States of America",2522420,2370726,151694,2042184,3403640,"USA",2722912
1,240.0,"Western Europe",3826521,3704810,121711,3226720,5377867,"NLD",4302294
1,240.0,"Russian Federation",2278380,2278380,0,2109044,3515073,"RUS",2812059
1,240.0,"Northern Africa",1763022,0,1763022,1492954,2488257,"EGY",1990606
1,240.0,"Eastern Asia",826853,0,826853,735293,1225488,"JPN",980391
1,240.0,"Western Africa",518591,0,518591,416706,694511,"NGA",555609
1,240.0,"Southern Europe",824626,0,824626,649815,1083025,"ITA",866420
1,241.0,"Northern America",488581,488581,0,489124,815207,"CAN",652166
1,241.0,"Southern Asia",550880,0,550880,357988,596647,"IRN",477318
1,241.0,"South America",1535893,1222211,313682,1669054,2781757,"BRA",2225406
1,241.0,"Central Asia",1626943,1626481,462,1424480,2374133,"UZB",1899307
1,241.0,"South-Eastern Asia",1044569,0,1044569,954939,1591566,"IDN",1273253
1,241.0,"Pakistan",1806077,1641883,164194,1527854,2546423,"PAK",2037139
1,241.0,"Southern Africa",122555,0,122555,132246,220410,"ZAF",176328
1,241.0,"Northern Europe",2007281,2001236,6045,1642345,2737242,"GBR",2189794
1,241.0,"Oceania",629456,629456,0,444324,740541,"NZL",592433
1,241.0,"Central America",494568,0,494568,406210,677017,"MEX",541614
1,241.0,"Eastern Africa",442964,0,442964,431263,718772,"ETH",575018
1,241.0,"China",8637298,8549955,87343,8045973,13409956,"CPR",10727965
1,241.0,"Eastern Europe",2946996,2946996,0,2539092,4231821,"POL",3385457
1,241.0,"India",6413950,6413950,0,5251611,8752685,"IND",7002148
1,241.0,"Middle Africa",116432,0,116432,112264,187107,"AGO",149686
1,241.0,"Western Asia",783634,0,783634,882339,1470565,"IRQ",1176452
1,241.0,"United States of America",2429968,2289573,140395,2042184,3403640,"USA",2722912
1,241.0,"Western Europe",3826526,3702501,124025,3226720,5377867,"NLD",4302294
1,241.0,"Russian Federation",2310670,2310670,0,2109044,3515073,"RUS",2812059
1,241.0,"Northern Africa",1752311,0,1752311,1492954,2488257,"EGY",1990606
1,241.0,"Eastern Asia",817160,0,817160,735293,1225488,"JPN",980391
1,241.0,"Western Africa",516867,0,516867,416706,694511,"NGA",555609
1,241.0,"Southern Europe",820726,0,820726,649815,1083025,"ITA",866420
1,242.0,"Northern America",533136,533136,0,489124,815207,"CAN",652166
1,242.0,"Southern Asia",422073,0,422073,357988,596647,"IRN",477318
1,242.0,"South America",1577910,1222709,355201,1669054,2781757,"BRA",2225406
1,242.0,"Central Asia",1859994,1859994,0,1424480,2374133,"UZB",1899307
1,242.0,"South-Eastern Asia",1195962,0,1195962,954939,1591566,"IDN",1273253
1,242.0,"Pakistan",1991637,1820105,171532,1527854,2546423,"PAK",2037139
1,242.0,"Southern Africa",160971,0,160971,132246,220410,"ZAF",176328
1,242.0,"Northern Europe",2104643,2104643,0,1642345,2737242,"GBR",2189794
1,242.0,"Oceania",582695,582695,0,444324,740541,"NZL",592433
1,242.0,"Central America",488844,0,488844,406210,677017,"MEX",541614
1,242.0,"Eastern Africa",557765,0,557765,431263,718772,"ETH",575018
1,242.0,"China",8932553,8869974,62579,8045973,13409956,"CPR",10727965
1,242.0,"Eastern Europe",3277901,3277901,0,2539092,4231821,"POL",3385457
1,242.0,"India",6702229,6702229,0,5251611,8752685,"IND",7002148
1,242.0,"Middle Africa",143050,0,143050,112264,187107,"AGO",149686
1,242.0,"Western Asia",1149267,0,1149267,882339,1470565,"IRQ",1176452
1,242.0,"United States of America",2345976,2205073,140903,2042184,3403640,"USA",2722912
1,242.0,"Western Europe",3730017,3609711,120306,3226720,5377867,"NLD",4302294
1,242.0,"Russian Federation",2688750,2688750,0,2109044,3515073,"RUS",2812059
1,242.0,"Northern Africa",1838911,0,1838911,1492954,2488257,"EGY",1990606
1,242.0,"Eastern Asia",846508,0,846508,735293,1225488,"JPN",980391
1,242.0,"Western Africa",525214,0,525214,416706,694511,"NGA",555609
1,242.0,"Southern Europe",817268,0,817268,649815,1083025,"ITA",866420
1,243.0,"Northern America",544845,542697,2148,489124,815207,"CAN",652166
1,243.0,"Southern Asia",425532,0,425532,357988,596647,"IRN",477318
1,243.0,"South America",1617174,1221663,395511,1669054,2781757,"BRA",2225406
1,243.0,"Central Asia",1836749,1836749,0,1424480,2374133,"UZB",1899307
1,243.0,"South-Eastern Asia",1201093,0,1201093,954939,1591566,"IDN",1273253
1,243.0,"Pakistan",1964829,1797000,167829,1527854,2546423,"PAK",2037139
1,243.0,"Southern Africa",161936,0,161936,132246,220410,"ZAF",176328
1,243.0,"Northern Europe",2072210,2072210,0,1642345,2737242,"GBR",2189794
1,243.0,"Oceania",571001,571001,0,444324,740541,"NZL",592433
1,243.0,"Central America",503401,0,503401,406210,677017,"MEX",541614
1,243.0,"Eastern Africa",558853,0,558853,431263,718772,"ETH",575018
1,243.0,"China",8966570,8862162,104408,8045973,13409956,"CPR",10727965
1,243.0,"Eastern Europe",3200560,3200560,0,2539092,4231821,"POL",3385457
1,243.0,"India",6694447,6693266,1181,5251611,8752685,"IND",7002148
1,243.0,"Middle Africa",143467,0,143467,112264,187107,"AGO",149686
1,243.0,"Western Asia",1150977,0,1150977,882339,1470565,"IRQ",1176452
1,243.0,"United States of America",2367312,2224061,143251,2042184,3403640,"USA",2722912
1,243.0,"Western Europe",3803387,3658265,145122,3226720,5377867,"NLD",4302294
1,243.0,"Russian Federation",2612566,2612566,0,2109044,3515073,"RUS",2812059
1,243.0,"Northern Africa",1848447,0,1848447,1492954,2488257,"EGY",1990606
1,243.0,"Eastern Asia",855573,0,855573,735293,1225488,"JPN",980391
1,243.0,"Western Africa",528015,0,528015,416706,694511,"NGA",555609
1,243.0,"Southern Europe",821469,0,821469,649815,1083025,"ITA",866420
1,244.0,"Northern America",560455,556020,4435,489124,815207,"CAN",652166
1,244.0,"Southern Asia",430595,0,430595,357988,596647,"IRN",477318
1,244.0,"South America",1657996,1221652,436344,1669054,2781757,"BRA",2225406
1,244.0,"Central Asia",1855126,1855126,0,1424480,2374133,"UZB",1899307
1,244.0,"South-Eastern Asia",1208740,0,1208740,954939,1591566,"IDN",1273253
1,244.0,"Pakistan",1956812,1791407,165405,1527854,2546423,"PAK",2037139
1,244.0,"Southern Africa",163344,0,163344,132246,220410,"ZAF",176328
1,244.0,"Northern Europe",2051936,2050631,1305,1642345,2737242,"GBR",2189794
1,244.0,"Oceania",577820,577820,0,444324,740541,"NZL",592433
1,244.0,"Central America",508110,0,508110,406210,677017,"MEX",541614
1,244.0,"Eastern Africa",560430,0,560430,431263,718772,"ETH",575018
1,244.0,"China",9013880,8862833,151047,8045973,13409956,"CPR",10727965
1,244.0,"Eastern Europe",3252658,3252658,0,2539092,4231821,"POL",3385457
1,244.0,"India",6730712,6727729,2983,5251611,8752685,"IND",7002148
1,244.0,"Middle Africa",144077,0,144077,112264,187107,"AGO",149686
1,244.0,"Western Asia",1153466,0,1153466,882339,1470565,"IRQ",1176452
1,244.0,"United States of America",2388647,2235476,153171,2042184,3403640,"USA",2722912
1,244.0,"Western Europe",3847408,3678074,169334,3226720,5377867,"NLD",4302294
1,244.0,"Russian Federation",2667584,2667584,0,2109044,3515073,"RUS",2812059
1,244.0,"Northern Africa",1862340,0,1862340,1492954,2488257,"EGY",1990606
1,244.0,"Eastern Asia",881813,0,881813,735293,1225488,"JPN",980391
1,244.0,"Western Africa",530417,0,530417,416706,694511,"NGA",555609
1,244.0,"Southern Europe",825383,0,825383,649815,1083025,"ITA",866420
1,245.0,"Northern America",570211,563413,6798,489124,815207,"CAN",652166
1,245.0,"Southern Asia",438469,0,438469,357988,596647,"IRN",477318
1,245.0,"South America",1704842,1224733,480109,1669054,2781757,"BRA",2225406
1,245.0,"Central Asia",1886350,1886350,0,1424480,2374133,"UZB",1899307
1,245.0,"South-Eastern Asia",1219851,0,1219851,954939,1591566,"IDN",1273253
1,245.0,"Pakistan",1949990,1786752,163238,1527854,2546423,"PAK",2037139
1,245.0,"Southern Africa",165530,0,165530,132246,220410,"ZAF",176328
1,245.0,"Northern Europe",2039771,2031592,8179,1642345,2737242,"GBR",2189794
1,245.0,"Oceania",608016,608016,0,444324,740541,"NZL",592433
1,245.0,"Central America",511534,0,511534,406210,677017,"MEX",541614
1,245.0,"Eastern Africa",562892,0,562892,431263,718772,"ETH",575018
1,245.0,"China",9069681,8859701,209980,8045973,13409956,"CPR",10727965
1,245.0,"Eastern Europe",3320677,3320677,0,2539092,4231821,"POL",3385457
1,245.0,"India",6731258,6725756,5502,5251611,8752685,"IND",7002148
1,245.0,"Middle Africa",145021,0,145021,112264,187107,"AGO",149686
1,245.0,"Western Asia",1157340,0,1157340,882339,1470565,"IRQ",1176452
1,245.0,"United States of America",2424208,2261712,162496,2042184,3403640,"USA",2722912
1,245.0,"Western Europe",3891429,3698095,193334,3226720,5377867,"NLD",4302294
1,245.0,"Russian Federation",2939987,2939987,0,2109044,3515073,"RUS",2812059
1,245.0,"Northern Africa",1883964,0,1883964,1492954,2488257,"EGY",1990606
1,245.0,"Eastern Asia",906340,0,906340,735293,1225488,"JPN",980391
1,245.0,"Western Africa",533701,0,533701,416706,694511,"NGA",555609
1,245.0,"Southern Europe",829474,0,829474,649815,1083025,"ITA",866420
1,246.0,"Northern America",581919,572696,9223,489124,815207,"CAN",652166
1,246.0,"Southern Asia",440690,0,440690,357988,596647,"IRN",477318
1,246.0,"South America",1742876,1222549,520327,1669054,2781757,"BRA",2225406
1,246.0,"Central Asia",1873848,1872096,1752,1424480,2374133,"UZB",1899307
1,246.0,"South-Eastern Asia",1223070,0,1223070,954939,1591566,"IDN",1273253
1,246.0,"Pakistan",2208268,2040750,167518,1527854,2546423,"PAK",2037139
1,246.0,"Southern Africa",166146,0,166146,132246,220410,"ZAF",176328
1,246.0,"Northern Europe",2031662,2016315,15347,1642345,2737242,"GBR",2189794
1,246.0,"Oceania",584643,584643,0,444324,740541,"NZL",592433
1,246.0,"Central America",514830,0,514830,406210,677017,"MEX",541614
1,246.0,"Eastern Africa",563582,0,563582,431263,718772,"ETH",575018
1,246.0,"China",9130810,8866961,263849,8045973,13409956,"CPR",10727965
1,246.0,"Eastern Europe",3284234,3283882,352,2539092,4231821,"POL",3385457
1,246.0,"India",6753867,6728389,25478,5251611,8752685,"IND",7002148
1,246.0,"Middle Africa",145288,0,145288,112264,187107,"AGO",149686
1,246.0,"Western Asia",1158433,0,1158433,882339,1470565,"IRQ",1176452
1,246.0,"United States of America",2452655,2281826,170829,2042184,3403640,"USA",2722912
1,246.0,"Western Europe",3950121,3733193,216928,3226720,5377867,"NLD",4302294
1,246.0,"Russian Federation",2864719,2864719,0,2109044,3515073,"RUS",2812059
1,246.0,"Northern Africa",1890057,0,1890057,1492954,2488257,"EGY",1990606
1,246.0,"Eastern Asia",910843,0,910843,735293,1225488,"JPN",980391
1,246.0,"Western Africa",535699,0,535699,416706,694511,"NGA",555609
1,246.0,"Southern Europe",833855,0,833855,649815,1083025,"ITA",866420
1,247.0,"Northern America",589724,578058,11666,489124,815207,"CAN",652166
1,247.0,"Southern Asia",442092,0,442092,357988,596647,"IRN",477318
1,247.0,"South America",1783372,1226105,557267,1669054,2781757,"BRA",2225406
1,247.0,"Central Asia",1876080,1868567,7513,1424480,2374133,"UZB",1899307
1,247.0,"South-Eastern Asia",1229454,0,1229454,954939,1591566,"IDN",1273253
1,247.0,"Pakistan",2035419,1882111,153308,1527854,2546423,"PAK",2037139
1,247.0,"Southern Africa",166536,0,166536,132246,220410,"ZAF",176328
1,247.0,"Northern Europe",2027608,2004790,22818,1642345,2737242,"GBR",2189794
1,247.0,"Oceania",564182,564182,0,444324,740541,"NZL",592433
1,247.0,"Central America",517516,0,517516,406210,677017,"MEX",541614
1,247.0,"Eastern Africa",564022,0,564022,431263,718772,"ETH",575018
1,247.0,"China",9171044,8857952,313092,8045973,13409956,"CPR",10727965
1,247.0,"Eastern Europe",3265816,3255245,10571,2539092,4231821,"POL",3385457
1,247.0,"India",6779117,6732617,46500,5251611,8752685,"IND",7002148
1,247.0,"Middle Africa",145455,0,145455,112264,187107,"AGO",149686
1,247.0,"Western Asia",1159121,0,1159121,882339,1470565,"IRQ",1176452
1,247.0,"United States of America",2481104,2302736,178368,2042184,3403640,"USA",2722912
1,247.0,"Western Europe",3986806,3747266,239540,3226720,5377867,"NLD",4302294
1,247.0,"Russian Federation",2781289,2781289,0,2109044,3515073,"RUS",2812059
1,247.0,"Northern Africa",1893911,0,1893911,1492954,2488257,"EGY",1990606
1,247.0,"Eastern Asia",912034,0,912034,735293,1225488,"JPN",980391
1,247.0,"Western Africa",536847,0,536847,416706,694511,"NGA",555609
1,247.0,"Southern Europe",837222,0,837222,649815,1083025,"ITA",866420
1,248.0,"Northern America",595578,581450,14128,489124,815207,"CAN",652166
1,248.0,"Southern Asia",443375,0,443375,357988,596647,"IRN",477318
1,248.0,"South America",1813965,1223583,590382,1669054,2781757,"BRA",2225406
1,248.0,"Central Asia",1876176,1862864,13312,1424480,2374133,"UZB",1899307
1,248.0,"South-Eastern Asia",1236702,0,1236702,954939,1591566,"IDN",1273253
1,248.0,"Pakistan",2084352,1937079,147273,1527854,2546423,"PAK",2037139
1,248.0,"Southern Africa",166894,0,166894,132246,220410,"ZAF",176328
1,248.0,"Northern Europe",1857317,1826739,30578,1642345,2737242,"GBR",2189794
1,248.0,"Oceania",558336,558336,0,444324,740541,"NZL",592433
1,248.0,"Central America",518782,0,518782,406210,677017,"MEX",541614
1,248.0,"Eastern Africa",564421,0,564421,431263,718772,"ETH",575018
1,248.0,"China",9214686,8852737,361949,8045973,13409956,"CPR",10727965
1,248.0,"Eastern Europe",3199830,3178730,21100,2539092,4231821,"POL",3385457
1,248.0,"India",6804700,6735943,68757,5251611,8752685,"IND",7002148
1,248.0,"Middle Africa",145609,0,145609,112264,187107,"AGO",149686
1,248.0,"Western Asia",1159752,0,1159752,882339,1470565,"IRQ",1176452
1,248.0,"United States of America",2502439,2317326,185113,2042184,3403640,"USA",2722912
1,248.0,"Western Europe",4016154,3754545,261609,3226720,5377867,"NLD",4302294
1,248.0,"Russian Federation",2731890,2731890,0,2109044,3515073,"RUS",2812059
1,248.0,"Northern Africa",1897430,0,1897430,1492954,2488257,"EGY",1990606
1,248.0,"Eastern Asia",915155,0,915155,735293,1225488,"JPN",980391
1,248.0,"Western Africa",538765,0,538765,416706,694511,"NGA",555609
1,248.0,"Southern Europe",839004,0,839004,649815,1083025,"ITA",866420
1,249.0,"Northern America",572163,555558,16605,489124,815207,"CAN",652166
1,249.0,"Southern Asia",461152,0,461152,357988,596647,"IRN",477318
1,249.0,"South America",1864001,1226881,637120,1669054,2781757,"BRA",2225406
1,249.0,"Central Asia",1876180,1857026,19154,1424480,2374133,"UZB",1899307
1,249.0,"South-Eastern Asia",1261833,0,1261833,954939,1591566,"IDN",1273253
1,249.0,"Pakistan",2036993,1897886,139107,1527854,2546423,"PAK",2037139
1,249.0,"Southern Africa",171833,0,171833,132246,220410,"ZAF",176328
1,249.0,"Northern Europe",1873631,1833416,40215,1642345,2737242,"GBR",2189794
1,249.0,"Oceania",559309,557468,1841,444324,740541,"NZL",592433
1,249.0,"Central America",535565,0,535565,406210,677017,"MEX",541614
1,249.0,"Eastern Africa",569969,0,569969,431263,718772,"ETH",575018
1,249.0,"China",10444069,10031967,412102,8045973,13409956,"CPR",10727965
1,249.0,"Eastern Europe",3187739,3155625,32114,2539092,4231821,"POL",3385457
1,249.0,"India",6829347,6738138,91209,5251611,8752685,"IND",7002148
1,249.0,"Middle Africa",147741,0,147741,112264,187107,"AGO",149686
1,249.0,"Western Asia",1168497,0,1168497,882339,1470565,"IRQ",1176452
1,249.0,"United States of America",2850925,2659662,191263,2042184,3403640,"USA",2722912
1,249.0,"Western Europe",4023490,3740255,283235,3226720,5377867,"NLD",4302294
1,249.0,"Russian Federation",3005298,3005298,0,2109044,3515073,"RUS",2812059
1,249.0,"Northern Africa",1946227,0,1946227,1492954,2488257,"EGY",1990606
1,249.0,"Eastern Asia",957807,0,957807,735293,1225488,"JPN",980391
1,249.0,"Western Africa",548411,0,548411,416706,694511,"NGA",555609
1,249.0,"Southern Europe",854800,0,854800,649815,1083025,"ITA",866420
1,250.0,"Northern America",605333,585948,19385,489124,815207,"CAN",652166
1,250.0,"Southern Asia",463003,0,463003,357988,596647,"IRN",477318
1,250.0,"South America",1904939,1225795,679144,1669054,2781757,"BRA",2225406
1,250.0,"Central Asia",1729522,1704482,25040,1424480,2374133,"UZB",1899307
1,250.0,"South-Eastern Asia",1264389,0,1264389,954939,1591566,"IDN",1273253
1,250.0,"Pakistan",1970872,1837872,133000,1527854,2546423,"PAK",2037139
1,250.0,"Southern Africa",172349,0,172349,132246,220410,"ZAF",176328
1,250.0,"Northern Europe",1893811,1843845,49966,1642345,2737242,"GBR",2189794
1,250.0,"Oceania",571973,568232,3741,444324,740541,"NZL",592433
1,250.0,"Central America",537741,0,537741,406210,677017,"MEX",541614
1,250.0,"Eastern Africa",570547,0,570547,431263,718772,"ETH",575018
1,250.0,"China",10470642,10026739,443903,8045973,13409956,"CPR",10727965
1,250.0,"Eastern Europe",3187010,3143536,43474,2539092,4231821,"POL",3385457
1,250.0,"India",6853978,6740206,113772,5251611,8752685,"IND",7002148
1,250.0,"Middle Africa",147964,0,147964,112264,187107,"AGO",149686
1,250.0,"Western Asia",1169409,0,1169409,882339,1470565,"IRQ",1176452
1,250.0,"United States of America",2758475,2570781,187694,2042184,3403640,"USA",2722912
1,250.0,"Western Europe",4082185,3777160,305025,3226720,5377867,"NLD",4302294
1,250.0,"Russian Federation",2843533,2843533,0,2109044,3515073,"RUS",2812059
1,250.0,"Northern Africa",1951314,0,1951314,1492954,2488257,"EGY",1990606
1,250.0,"Eastern Asia",963815,0,963815,735293,1225488,"JPN",980391
1,250.0,"Western Africa",548891,0,548891,416706,694511,"NGA",555609
1,250.0,"Southern Europe",855474,0,855474,649815,1083025,"ITA",866420
1,251.0,"Northern America",620944,599072,21872,489124,815207,"CAN",652166
1,251.0,"Southern Asia",464103,0,464103,357994,596657,"IRN",477326
1,251.0,"South America",1941875,1224995,716880,1669062,2781770,"BRA",2225416
1,251.0,"Central Asia",1731557,1699111,32446,1424485,2374142,"UZB",1899314
1,251.0,"South-Eastern Asia",1264029,0,1264029,954948,1591580,"IDN",1273264
1,251.0,"Pakistan",1957197,1827676,129521,1527856,2546427,"PAK",2037142
1,251.0,"Southern Africa",172655,0,172655,132249,220416,"ZAF",176333
1,251.0,"Northern Europe",1914083,1854070,60013,1642350,2737251,"GBR",2189801
1,251.0,"Oceania",577819,572189,5630,444324,740541,"NZL",592433
1,251.0,"Central America",536986,0,536986,406215,677026,"MEX",541621
1,251.0,"Eastern Africa",570891,0,570891,431264,718773,"ETH",575019
1,251.0,"China",10517122,10039980,477142,8045979,13409966,"CPR",10727973
1,251.0,"Eastern Europe",3186965,3131845,55120,2539092,4231821,"POL",3385457
1,251.0,"India",6878609,6744553,134056,5251615,8752692,"IND",7002154
1,251.0,"Middle Africa",148098,0,148098,112269,187115,"AGO",149692
1,251.0,"Western Asia",1169950,0,1169950,882339,1470565,"IRQ",1176452
1,251.0,"United States of America",2708691,2521987,186704,2042188,3403647,"USA",2722918
1,251.0,"Western Europe",4126208,3800966,325242,3226722,5377871,"NLD",4302297
1,251.0,"Russian Federation",2719137,2719137,0,2109045,3515075,"RUS",2812060
1,251.0,"Northern Africa",1955018,0,1955018,1492962,2488270,"EGY",1990616
1,251.0,"Eastern Asia",963601,0,963601,735301,1225502,"JPN",980402
1,251.0,"Western Africa",549145,0,549145,416706,694511,"NGA",555609
1,251.0,"Southern Europe",855888,0,855888,649821,1083035,"ITA",866428
1,252.0,"Northern America",628750,604536,24214,471794,786323,"CAN",629059
1,252.0,"Southern Asia",464710,0,464710,538524,897541,"IRN",718033
1,252.0,"South America",1975068,1224737,750331,1479207,2465346,"BRA",1972277
1,252.0,"Central Asia",1751012,1710885,40127,1171911,1953185,"UZB",1562548
1,252.0,"South-Eastern Asia",1263791,0,1263791,973325,1622208,"IDN",1297767
1,252.0,"Pakistan",1953170,1822182,130988,1387656,2312760,"PAK",1850208
1,252.0,"Southern Africa",172822,0,172822,107739,179565,"ZAF",143652
1,252.0,"Northern Europe",1962737,1892561,70176,1479730,2466217,"GBR",1972974
1,252.0,"Oceania",579768,572256,7512,442299,737165,"NZL",589732
1,252.0,"Central America",536536,0,536536,411949,686582,"MEX",549266
1,252.0,"Eastern Africa",571082,0,571082,318222,530371,"ETH",424297
1,252.0,"China",10563214,10052993,510221,7238028,12063381,"CPR",9650705
1,252.0,"Eastern Europe",3186962,3119921,67041,2085708,3476180,"POL",2780944
1,252.0,"India",6891113,6741301,149812,4691154,7818590,"IND",6254872
1,252.0,"Middle Africa",148169,0,148169,105147,175245,"AGO",140196
1,252.0,"Western Asia",1170245,0,1170245,875120,1458533,"IRQ",1166827
1,252.0,"United States of America",2687350,2500251,187099,2179317,3632195,"USA",2905756
1,252.0,"Western Europe",4140881,3809791,331090,2754267,4590445,"NLD",3672356
1,252.0,"Russian Federation",2822564,2822564,0,1730008,2883347,"RUS",2306678
1,252.0,"Northern Africa",1958562,0,1958562,1183118,1971863,"EGY",1577491
1,252.0,"Eastern Asia",963232,0,963232,716114,1193523,"JPN",954819
1,252.0,"Western Africa",549363,0,549363,338753,564588,"NGA",451671
1,252.0,"Southern Europe",856244,0,856244,596781,994636,"ITA",795709
1,253.0,"Northern America",630700,604288,26412,471794,786323,"CAN",629059
1,253.0,"Southern Asia",467892,0,467892,538524,897541,"IRN",718033
1,253.0,"South America",3049932,2268976,780956,1479207,2465346,"BRA",1972277
1,253.0,"Central Asia",1760153,1713380,46773,1171911,1953185,"UZB",1562548
1,253.0,"South-Eastern Asia",1266123,0,1266123,973325,1622208,"IDN",1297767
1,253.0,"Pakistan",1949762,1815482,134280,1387656,2312760,"PAK",1850208
1,253.0,"Southern Africa",173715,0,173715,107739,179565,"ZAF",143652
1,253.0,"Northern Europe",2007345,1928041,79304,1479730,2466217,"GBR",1972974
1,253.0,"Oceania",600224,590831,9393,442299,737165,"NZL",589732
1,253.0,"Central America",535910,0,535910,411949,686582,"MEX",549266
1,253.0,"Eastern Africa",571832,0,571832,318222,530371,"ETH",424297
1,253.0,"China",10592659,10047582,545077,7238028,12063381,"CPR",9650705
1,253.0,"Eastern Europe",3186962,3109594,77368,2085708,3476180,"POL",2780944
1,253.0,"India",6915563,6745536,170027,4691154,7818590,"IND",6254872
1,253.0,"Middle Africa",148463,0,148463,105147,175245,"AGO",140196
1,253.0,"Western Asia",1171430,0,1171430,875120,1458533,"IRQ",1166827
1,253.0,"United States of America",2673131,2485042,188089,2179317,3632195,"USA",2905756
1,253.0,"Western Europe",4155557,3819106,336451,2754267,4590445,"NLD",3672356
1,253.0,"Russian Federation",2726259,2726259,0,1730008,2883347,"RUS",2306678
1,253.0,"Northern Africa",1959385,0,1959385,1183118,1971863,"EGY",1577491
1,253.0,"Eastern Asia",967257,0,967257,716114,1193523,"JPN",954819
1,253.0,"Western Africa",549441,0,549441,338753,564588,"NGA",451671
1,253.0,"Southern Europe",856371,0,856371,596781,994636,"ITA",795709
1,254.0,"Northern America",673940,645663,28277,471794,786323,"CAN",629059
1,254.0,"Southern Asia",739651,0,739651,538524,897541,"IRN",718033
1,254.0,"South America",2926556,2267763,658793,1479207,2465346,"BRA",1972277
1,254.0,"Central Asia",1761927,1713339,48588,1171911,1953185,"UZB",1562548
1,254.0,"South-Eastern Asia",1300586,0,1300586,973325,1622208,"IDN",1297767
1,254.0,"Pakistan",1954354,1823978,130376,1387656,2312760,"PAK",1850208
1,254.0,"Southern Africa",150165,0,150165,107739,179565,"ZAF",143652
1,254.0,"Northern Europe",2070284,1985583,84701,1479730,2466217,"GBR",1972974
1,254.0,"Oceania",593630,582579,11051,442299,737165,"NZL",589732
1,254.0,"Central America",551316,0,551316,411949,686582,"MEX",549266
1,254.0,"Eastern Africa",431289,0,431289,318222,530371,"ETH",424297
1,254.0,"China",10606842,10053663,553179,7238028,12063381,"CPR",9650705
1,254.0,"Eastern Europe",3267678,3186468,81210,2085708,3476180,"POL",2780944
1,254.0,"India",6931970,6752775,179195,4691154,7818590,"IND",6254872
1,254.0,"Middle Africa",142908,0,142908,105147,175245,"AGO",140196
1,254.0,"Western Asia",1177846,0,1177846,875120,1458533,"IRQ",1166827
1,254.0,"United States of America",2891529,2696952,194577,2179317,3632195,"USA",2905756
1,254.0,"Western Europe",4193277,3872876,320401,2754267,4590445,"NLD",3672356
1,254.0,"Russian Federation",2276822,2276822,0,1730008,2883347,"RUS",2306678
1,254.0,"Northern Africa",1652377,0,1652377,1183118,1971863,"EGY",1577491
1,254.0,"Eastern Asia",967812,0,967812,716114,1193523,"JPN",954819
1,254.0,"Western Africa",466008,0,466008,338753,564588,"NGA",451671
1,254.0,"Southern Europe",816380,0,816380,596781,994636,"ITA",795709
1,255.0,"Northern America",675891,646410,29481,471794,786323,"CAN",629059
1,255.0,"Southern Asia",744111,0,744111,538524,897541,"IRN",718033
1,255.0,"South America",2825858,2269050,556808,1479207,2465346,"BRA",1972277
1,255.0,"Central Asia",1775838,1725741,50097,1171911,1953185,"UZB",1562548
1,255.0,"South-Eastern Asia",1311666,0,1311666,973325,1622208,"IDN",1297767
1,255.0,"Pakistan",1954649,1828356,126293,1387656,2312760,"PAK",1850208
1,255.0,"Southern Africa",150785,0,150785,107739,179565,"ZAF",143652
1,255.0,"Northern Europe",2114885,2025846,89039,1479730,2466217,"GBR",1972974
1,255.0,"Oceania",601424,588651,12773,442299,737165,"NZL",589732
1,255.0,"Central America",557609,0,557609,411949,686582,"MEX",549266
1,255.0,"Eastern Africa",432440,0,432440,318222,530371,"ETH",424297
1,255.0,"China",10631501,10069277,562224,7238028,12063381,"CPR",9650705
1,255.0,"Eastern Europe",3288770,3205166,83604,2085708,3476180,"POL",2780944
1,255.0,"India",6932219,6745126,187093,4691154,7818590,"IND",6254872
1,255.0,"Middle Africa",143267,0,143267,105147,175245,"AGO",140196
1,255.0,"Western Asia",1179658,0,1179658,875120,1458533,"IRQ",1166827
1,255.0,"United States of America",2962650,2767678,194972,2179317,3632195,"USA",2905756
1,255.0,"Western Europe",4141917,3838820,303097,2754267,4590445,"NLD",3672356
1,255.0,"Russian Federation",2217919,2217919,0,1730008,2883347,"RUS",2306678
1,255.0,"Northern Africa",1647476,0,1647476,1183118,1971863,"EGY",1577491
1,255.0,"Eastern Asia",980352,0,980352,716114,1193523,"JPN",954819
1,255.0,"Western Africa",465488,0,465488,338753,564588,"NGA",451671
1,255.0,"Southern Europe",818184,0,818184,596781,994636,"ITA",795709
1,256.0,"Northern America",683696,653086,30610,471794,786323,"CAN",629059
1,256.0,"Southern Asia",746289,0,746289,538524,897541,"IRN",718033
1,256.0,"South America",2736723,2266291,470432,1479207,2465346,"BRA",1972277
1,256.0,"Central Asia",1787501,1736435,51066,1171911,1953185,"UZB",1562548
1,256.0,"South-Eastern Asia",1334512,0,1334512,973325,1622208,"IDN",1297767
1,256.0,"Pakistan",1882101,1765273,116828,1387656,2312760,"PAK",1850208
1,256.0,"Southern Africa",151344,0,151344,107739,179565,"ZAF",143652
1,256.0,"Northern Europe",2151374,2058877,92497,1479730,2466217,"GBR",1972974
1,256.0,"Oceania",609216,594837,14379,442299,737165,"NZL",589732
1,256.0,"Central America",561664,0,561664,411949,686582,"MEX",549266
1,256.0,"Eastern Africa",433118,0,433118,318222,530371,"ETH",424297
1,256.0,"China",10634625,10062737,571888,7238028,12063381,"CPR",9650705
1,256.0,"Eastern Europe",3290042,3204921,85121,2085708,3476180,"POL",2780944
1,256.0,"India",6835208,6648346,186862,4691154,7818590,"IND",6254872
1,256.0,"Middle Africa",143632,0,143632,105147,175245,"AGO",140196
1,256.0,"Western Asia",1180729,0,1180729,875120,1458533,"IRQ",1166827
1,256.0,"United States of America",3005327,2811940,193387,2179317,3632195,"USA",2905756
1,256.0,"Western Europe",4075886,3788386,287500,2754267,4590445,"NLD",3672356
1,256.0,"Russian Federation",2369431,2369431,0,1730008,2883347,"RUS",2306678
1,256.0,"Northern Africa",1651683,0,1651683,1183118,1971863,"EGY",1577491
1,256.0,"Eastern Asia",992354,0,992354,716114,1193523,"JPN",954819
1,256.0,"Western Africa",466189,0,466189,338753,564588,"NGA",451671
1,256.0,"Southern Europe",819383,0,819383,596781,994636,"ITA",795709
1,257.0,"Northern America",689550,657993,31557,471794,786323,"CAN",629059
1,257.0,"Southern Asia",748659,0,748659,538524,897541,"IRN",718033
1,257.0,"South America",2667329,2269034,398295,1479207,2465346,"BRA",1972277
1,257.0,"Central Asia",1732656,1681185,51471,1171911,1953185,"UZB",1562548
1,257.0,"South-Eastern Asia",1339099,0,1339099,973325,1622208,"IDN",1297767
1,257.0,"Pakistan",1912186,1802046,110140,1387656,2312760,"PAK",1850208
1,257.0,"Southern Africa",151966,0,151966,107739,179565,"ZAF",143652
1,257.0,"Northern Europe",2183812,2088687,95125,1479730,2466217,"GBR",1972974
1,257.0,"Oceania",617986,602143,15843,442299,737165,"NZL",589732
1,257.0,"Central America",564800,0,564800,411949,686582,"MEX",549266
1,257.0,"Eastern Africa",433860,0,433860,318222,530371,"ETH",424297
1,257.0,"China",10659160,10076230,582930,7238028,12063381,"CPR",9650705
1,257.0,"Eastern Europe",2965746,2895139,70607,2085708,3476180,"POL",2780944
1,257.0,"India",6494165,6334950,159215,4691154,7818590,"IND",6254872
1,257.0,"Middle Africa",143876,0,143876,105147,175245,"AGO",140196
1,257.0,"Western Asia",1181897,0,1181897,875120,1458533,"IRQ",1166827
1,257.0,"United States of America",3040886,2850275,190611,2179317,3632195,"USA",2905756
1,257.0,"Western Europe",4031864,3757768,274096,2754267,4590445,"NLD",3672356
1,257.0,"Russian Federation",2475761,2475761,0,1730008,2883347,"RUS",2306678
1,257.0,"Northern Africa",1655667,0,1655667,1183118,1971863,"EGY",1577491
1,257.0,"Eastern Asia",1003028,0,1003028,716114,1193523,"JPN",954819
1,257.0,"Western Africa",466963,0,466963,338753,564588,"NGA",451671
1,257.0,"Southern Europe",820649,0,820649,596781,994636,"ITA",795709
1,258.0,"Northern America",693453,661111,32342,471794,786323,"CAN",629059
1,258.0,"Southern Asia",749791,0,749791,538524,897541,"IRN",718033
1,258.0,"South America",2603241,2266788,336453,1479207,2465346,"BRA",1972277
1,258.0,"Central Asia",1644532,1600691,43841,1171911,1953185,"UZB",1562548
1,258.0,"South-Eastern Asia",1340488,0,1340488,973325,1622208,"IDN",1297767
1,258.0,"Pakistan",1768973,1666483,102490,1387656,2312760,"PAK",1850208
1,258.0,"Southern Africa",152448,0,152448,107739,179565,"ZAF",143652
1,258.0,"Northern Europe",2212193,2115281,96912,1479730,2466217,"GBR",1972974
1,258.0,"Oceania",622856,605737,17119,442299,737165,"NZL",589732
1,258.0,"Central America",566826,0,566826,411949,686582,"MEX",549266
1,258.0,"Eastern Africa",434213,0,434213,318222,530371,"ETH",424297
1,258.0,"China",10683367,10089764,593603,7238028,12063381,"CPR",9650705
1,258.0,"Eastern Europe",3011048,2950759,60289,2085708,3476180,"POL",2780944
1,258.0,"India",6585965,6448744,137221,4691154,7818590,"IND",6254872
1,258.0,"Middle Africa",144009,0,144009,105147,175245,"AGO",140196
1,258.0,"Western Asia",1182451,0,1182451,875120,1458533,"IRQ",1166827
1,258.0,"United States of America",3062221,2875379,186842,2179317,3632195,"USA",2905756
1,258.0,"Western Europe",3995180,3733026,262154,2754267,4590445,"NLD",3672356
1,258.0,"Russian Federation",2552810,2552810,0,1730008,2883347,"RUS",2306678
1,258.0,"Northern Africa",1662116,0,1662116,1183118,1971863,"EGY",1577491
1,258.0,"Eastern Asia",1019424,0,1019424,716114,1193523,"JPN",954819
1,258.0,"Western Africa",467300,0,467300,338753,564588,"NGA",451671
1,258.0,"Southern Europe",821194,0,821194,596781,994636,"ITA",795709
1,259.0,"Northern America",697354,664368,32986,471794,786323,"CAN",629059
1,259.0,"Southern Asia",750277,0,750277,538524,897541,"IRN",718033
1,259.0,"South America",2551560,2267986,283574,1479207,2465346,"BRA",1972277
1,259.0,"Central Asia",1532847,1494959,37888,1171911,1953185,"UZB",1562548
1,259.0,"South-Eastern Asia",1341026,0,1341026,973325,1622208,"IDN",1297767
1,259.0,"Pakistan",1816638,1705695,110943,1387656,2312760,"PAK",1850208
1,259.0,"Southern Africa",152614,0,152614,107739,179565,"ZAF",143652
1,259.0,"Northern Europe",2232466,2134609,97857,1479730,2466217,"GBR",1972974
1,259.0,"Oceania",623830,607289,16541,442299,737165,"NZL",589732
1,259.0,"Central America",568750,0,568750,411949,686582,"MEX",549266
1,259.0,"Eastern Africa",434364,0,434364,318222,530371,"ETH",424297
1,259.0,"China",10706448,10103743,602705,7238028,12063381,"CPR",9650705
1,259.0,"Eastern Europe",2697519,2647692,49827,2085708,3476180,"POL",2780944
1,259.0,"India",6114413,5999815,114598,4691154,7818590,"IND",6254872
1,259.0,"Middle Africa",144069,0,144069,105147,175245,"AGO",140196
1,259.0,"Western Asia",1182691,0,1182691,875120,1458533,"IRQ",1166827
1,259.0,"United States of America",3076445,2893967,182478,2179317,3632195,"USA",2905756
1,259.0,"Western Europe",3965832,3714401,251431,2754267,4590445,"NLD",3672356
1,259.0,"Russian Federation",2220827,2220827,0,1730008,2883347,"RUS",2306678
1,259.0,"Northern Africa",1666008,0,1666008,1183118,1971863,"EGY",1577491
1,259.0,"Eastern Asia",1029980,0,1029980,716114,1193523,"JPN",954819
1,259.0,"Western Africa",467515,0,467515,338753,564588,"NGA",451671
1,259.0,"Southern Europe",821543,0,821543,596781,994636,"ITA",795709
1,260.0,"Northern America",699307,665827,33480,471794,786323,"CAN",629059
1,260.0,"Southern Asia",748391,0,748391,538524,897541,"IRN",718033
1,260.0,"South America",2504071,2268473,235598,1479207,2465346,"BRA",1972277
1,260.0,"Central Asia",1514237,1480634,33603,1171911,1953185,"UZB",1562548
1,260.0,"South-Eastern Asia",1338458,0,1338458,973325,1622208,"IDN",1297767
1,260.0,"Pakistan",1857533,1739781,117752,1387656,2312760,"PAK",1850208
1,260.0,"Southern Africa",152091,0,152091,107739,179565,"ZAF",143652
1,260.0,"Northern Europe",2224358,2126304,98054,1479730,2466217,"GBR",1972974
1,260.0,"Oceania",608245,594004,14241,442299,737165,"NZL",589732
1,260.0,"Central America",570199,0,570199,411949,686582,"MEX",549266
1,260.0,"Eastern Africa",433775,0,433775,318222,530371,"ETH",424297
1,260.0,"China",10724763,10119325,605438,7238028,12063381,"CPR",9650705
1,260.0,"Eastern Europe",2638050,2595926,42124,2085708,3476180,"POL",2780944
1,260.0,"India",6046562,5949359,97203,4691154,7818590,"IND",6254872
1,260.0,"Middle Africa",143842,0,143842,105147,175245,"AGO",140196
1,260.0,"Western Asia",1181764,0,1181764,875120,1458533,"IRQ",1166827
1,260.0,"United States of America",3083557,2905840,177717,2179317,3632195,"USA",2905756
1,260.0,"Western Europe",3943823,3702139,241684,2754267,4590445,"NLD",3672356
1,260.0,"Russian Federation",2153216,2153216,0,1730008,2883347,"RUS",2306678
1,260.0,"Northern Africa",1660822,0,1660822,1183118,1971863,"EGY",1577491
1,260.0,"Eastern Asia",1025605,0,1025605,716114,1193523,"JPN",954819
1,260.0,"Western Africa",467441,0,467441,338753,564588,"NGA",451671
1,260.0,"Southern Europe",821417,0,821417,596781,994636,"ITA",795709
1,261.0,"Northern America",761746,727893,33853,471794,786323,"CAN",629059
1,261.0,"Southern Asia",732206,0,732206,538524,897541,"IRN",718033
1,261.0,"South America",2456198,2266609,189589,1479207,2465346,"BRA",1972277
1,261.0,"Central Asia",1554948,1525470,29478,1171911,1953185,"UZB",1562548
1,261.0,"South-Eastern Asia",1315707,0,1315707,973325,1622208,"IDN",1297767
1,261.0,"Pakistan",1898002,1774986,123016,1387656,2312760,"PAK",1850208
1,261.0,"Southern Africa",147591,0,147591,107739,179565,"ZAF",143652
1,261.0,"Northern Europe",2248684,2150590,98094,1479730,2466217,"GBR",1972974
1,261.0,"Oceania",587787,575567,12220,442299,737165,"NZL",589732
1,261.0,"Central America",572451,0,572451,411949,686582,"MEX",549266
1,261.0,"Eastern Africa",428722,0,428722,318222,530371,"ETH",424297
1,261.0,"China",10522319,9921870,600449,7238028,12063381,"CPR",9650705
1,261.0,"Eastern Europe",2756101,2721440,34661,2085708,3476180,"POL",2780944
1,261.0,"India",6227430,6147353,80077,4691154,7818590,"IND",6254872
1,261.0,"Middle Africa",141901,0,141901,105147,175245,"AGO",140196
1,261.0,"Western Asia",1173800,0,1173800,875120,1458533,"IRQ",1166827
1,261.0,"United States of America",2998215,2825456,172759,2179317,3632195,"USA",2905756
1,261.0,"Western Europe",3459589,3226922,232667,2754267,4590445,"NLD",3672356
1,261.0,"Russian Federation",2278119,2278119,0,1730008,2883347,"RUS",2306678
1,261.0,"Northern Africa",1616395,0,1616395,1183118,1971863,"EGY",1577491
1,261.0,"Eastern Asia",986129,0,986129,716114,1193523,"JPN",954819
1,261.0,"Western Africa",459882,0,459882,338753,564588,"NGA",451671
1,261.0,"Southern Europe",809005,0,809005,596781,994636,"ITA",795709
1,262.0,"Northern America",703209,670490,32719,471794,786323,"CAN",629059
1,262.0,"Southern Asia",730737,0,730737,538524,897541,"IRN",718033
1,262.0,"South America",2280639,2129673,150966,1479207,2465346,"BRA",1972277
1,262.0,"Central Asia",1578825,1553960,24865,1171911,1953185,"UZB",1562548
1,262.0,"South-Eastern Asia",1313526,0,1313526,973325,1622208,"IDN",1297767
1,262.0,"Pakistan",1903734,1783439,120295,1387656,2312760,"PAK",1850208
1,262.0,"Southern Africa",147185,0,147185,107739,179565,"ZAF",143652
1,262.0,"Northern Europe",2248685,2151507,97178,1479730,2466217,"GBR",1972974
1,262.0,"Oceania",595576,585103,10473,442299,737165,"NZL",589732
1,262.0,"Central America",567724,0,567724,411949,686582,"MEX",549266
1,262.0,"Eastern Africa",428266,0,428266,318222,530371,"ETH",424297
1,262.0,"China",10517151,9914317,602834,7238028,12063381,"CPR",9650705
1,262.0,"Eastern Europe",2828100,2801665,26435,2085708,3476180,"POL",2780944
1,262.0,"India",6327213,6265736,61477,4691154,7818590,"IND",6254872
1,262.0,"Middle Africa",141725,0,141725,105147,175245,"AGO",140196
1,262.0,"Western Asia",1173079,0,1173079,875120,1458533,"IRQ",1166827
1,262.0,"United States of America",3019551,2840783,178768,2179317,3632195,"USA",2905756
1,262.0,"Western Europe",3547627,3296542,251085,2754267,4590445,"NLD",3672356
1,262.0,"Russian Federation",2356528,2356528,0,1730008,2883347,"RUS",2306678
1,262.0,"Northern Africa",1612362,0,1612362,1183118,1971863,"EGY",1577491
1,262.0,"Eastern Asia",992140,0,992140,716114,1193523,"JPN",954819
1,262.0,"Western Africa",458425,0,458425,338753,564588,"NGA",451671
1,262.0,"Southern Europe",806702,0,806702,596781,994636,"ITA",795709
1,263.0,"Northern America",677843,645022,32821,471799,786332,"CAN",629066
1,263.0,"Southern Asia",730510,0,730510,538528,897547,"IRN",718038
1,263.0,"South America",2008608,1884308,124300,1479216,2465360,"BRA",1972288
1,263.0,"Central Asia",1574313,1554264,20049,1171917,1953196,"UZB",1562557
1,263.0,"South-Eastern Asia",1313727,0,1313727,973328,1622213,"IDN",1297771
1,263.0,"Pakistan",1878859,1766106,112753,1387656,2312760,"PAK",1850208
1,263.0,"Southern Africa",147122,0,147122,107745,179576,"ZAF",143661
1,263.0,"Northern Europe",2240577,2144732,95845,1479732,2466221,"GBR",1972977
1,263.0,"Oceania",593631,584982,8649,442303,737172,"NZL",589738
1,263.0,"Central America",564682,0,564682,411954,686590,"MEX",549272
1,263.0,"Eastern Africa",428195,0,428195,318229,530382,"ETH",424306
1,263.0,"China",10538327,9934676,603651,7238028,12063381,"CPR",9650705
1,263.0,"Eastern Europe",2816229,2798286,17943,2085708,3476181,"POL",2780945
1,263.0,"India",6304488,6262077,42411,4691157,7818595,"IND",6254876
1,263.0,"Middle Africa",141698,0,141698,105153,175255,"AGO",140204
1,263.0,"Western Asia",1172966,0,1172966,875123,1458538,"IRQ",1166831
1,263.0,"United States of America",3026661,2842673,183988,2179319,3632198,"USA",2905759
1,263.0,"Western Europe",3620994,3354364,266630,2754267,4590446,"NLD",3672357
1,263.0,"Russian Federation",2344959,2344959,0,1730016,2883360,"RUS",2306688
1,263.0,"Northern Africa",1611732,0,1611732,1183121,1971868,"EGY",1577495
1,263.0,"Eastern Asia",991276,0,991276,716121,1193536,"JPN",954829
1,263.0,"Western Africa",458382,0,458382,338755,564592,"NGA",451674
1,263.0,"Southern Europe",806647,0,806647,596783,994638,"ITA",795711
1,264.0,"Northern America",662232,630243,31989,574107,956846,"CAN",765477
1,264.0,"Southern Asia",728982,0,728982,616301,1027168,"IRN",821735
1,264.0,"South America",1983936,1859018,124918,1819174,3031957,"BRA",2425566
1,264.0,"Central Asia",1563052,1547761,15291,1409299,2348832,"UZB",1879066
1,264.0,"South-Eastern Asia",1313027,0,1313027,997688,1662813,"IDN",1330251
1,264.0,"Pakistan",1852035,1745845,106190,1657396,2762327,"PAK",2209862
1,264.0,"Southern Africa",146696,0,146696,92608,154347,"ZAF",123478
1,264.0,"Northern Europe",2147322,2053032,94290,1693888,2823147,"GBR",2258518
1,264.0,"Oceania",589734,582883,6851,521704,869507,"NZL",695606
1,264.0,"Central America",561488,0,561488,449573,749288,"MEX",599431
1,264.0,"Eastern Africa",427718,0,427718,341898,569831,"ETH",455865
1,264.0,"China",10537989,9936609,601380,8632995,14388326,"CPR",11510661
1,264.0,"Eastern Europe",2783074,2773533,9541,2526639,4211065,"POL",3368852
1,264.0,"India",6255632,6232100,23532,5873450,9789083,"IND",7831267
1,264.0,"Middle Africa",141515,0,141515,134405,224008,"AGO",179207
1,264.0,"Western Asia",1172216,0,1172216,899769,1499616,"IRQ",1199693
1,264.0,"United States of America",3012439,2823624,188815,2315447,3859078,"USA",3087263
1,264.0,"Western Europe",3679691,3400103,279588,3300082,5500137,"NLD",4400110
1,264.0,"Russian Federation",2309483,2309483,0,2360121,3933535,"RUS",3146828
1,264.0,"Northern Africa",1607543,0,1607543,1422706,2371177,"EGY",1896942
1,264.0,"Eastern Asia",984463,0,984463,789603,1316006,"JPN",1052805
1,264.0,"Western Africa",457788,0,457788,459093,765155,"NGA",612124
1,264.0,"Southern Europe",805674,0,805674,445337,742228,"ITA",593783
1,265.0,"Northern America",652483,623539,28944,574107,956846,"CAN",765477
1,265.0,"Southern Asia",726989,0,726989,616301,1027168,"IRN",821735
1,265.0,"South America",1954541,1830185,124356,1819174,3031957,"BRA",2425566
1,265.0,"Central Asia",1540443,1530790,9653,1409299,2348832,"UZB",1879066
1,265.0,"South-Eastern Asia",1310249,0,1310249,997688,1662813,"IDN",1330251
1,265.0,"Pakistan",1825087,1725585,99502,1657396,2762327,"PAK",2209862
1,265.0,"Southern Africa",146150,0,146150,92608,154347,"ZAF",123478
1,265.0,"Northern Europe",1940544,1857548,82996,1693888,2823147,"GBR",2258518
1,265.0,"Oceania",581863,577179,4684,521704,869507,"NZL",695606
1,265.0,"Central America",558606,0,558606,449573,749288,"MEX",599431
1,265.0,"Eastern Africa",427102,0,427102,341898,569831,"ETH",455865
1,265.0,"China",10539124,9934848,604276,8632995,14388326,"CPR",11510661
1,265.0,"Eastern Europe",2716199,2716199,0,2526639,4211065,"POL",3368852
1,265.0,"India",6157832,6157832,0,5873450,9789083,"IND",7831267
1,265.0,"Middle Africa",141281,0,141281,134405,224008,"AGO",179207
1,265.0,"Western Asia",1171238,0,1171238,899769,1499616,"IRQ",1199693
1,265.0,"United States of America",3005329,2810854,194475,2315447,3859078,"USA",3087263
1,265.0,"Western Europe",3723717,3431218,292499,3300082,5500137,"NLD",4400110
1,265.0,"Russian Federation",2237636,2237636,0,2360121,3933535,"RUS",3146828
1,265.0,"Northern Africa",1602063,0,1602063,1422706,2371177,"EGY",1896942
1,265.0,"Eastern Asia",976724,0,976724,789603,1316006,"JPN",1052805
1,265.0,"Western Africa",457164,0,457164,459093,765155,"NGA",612124
1,265.0,"Southern Europe",804650,0,804650,445337,742228,"ITA",593783
1,266.0,"Northern America",664009,635011,28998,574107,956846,"CAN",765477
1,266.0,"Southern Asia",781556,0,781556,616301,1027168,"IRN",821735
1,266.0,"South America",2374503,2227815,146688,1819174,3031957,"BRA",2425566
1,266.0,"Central Asia",1850758,1846200,4558,1409299,2348832,"UZB",1879066
1,266.0,"South-Eastern Asia",1289508,0,1289508,997688,1662813,"IDN",1330251
1,266.0,"Pakistan",1895464,1790299,105165,1657396,2762327,"PAK",2209862
1,266.0,"Southern Africa",112322,0,112322,92608,154347,"ZAF",123478
1,266.0,"Northern Europe",2185532,2101742,83790,1693888,2823147,"GBR",2258518
1,266.0,"Oceania",690716,687785,2931,521704,869507,"NZL",695606
1,266.0,"Central America",574977,0,574977,449573,749288,"MEX",599431
1,266.0,"Eastern Africa",443321,0,443321,341898,569831,"ETH",455865
1,266.0,"China",10572137,9929633,642504,8632995,14388326,"CPR",11510661
1,266.0,"Eastern Europe",3264589,3264589,0,2526639,4211065,"POL",3368852
1,266.0,"India",6970394,6968894,1500,5873450,9789083,"IND",7831267
1,266.0,"Middle Africa",174381,0,174381,134405,224008,"AGO",179207
1,266.0,"Western Asia",1179925,0,1179925,899769,1499616,"IRQ",1199693
1,266.0,"United States of America",2937909,2731276,206633,2315447,3859078,"USA",3087263
1,266.0,"Western Europe",3813160,3479463,333697,3300082,5500137,"NLD",4400110
1,266.0,"Russian Federation",2517497,2517497,0,2360121,3933535,"RUS",3146828
1,266.0,"Northern Africa",1786644,0,1786644,1422706,2371177,"EGY",1896942
1,266.0,"Eastern Asia",992203,0,992203,789603,1316006,"JPN",1052805
1,266.0,"Western Africa",588300,0,588300,459093,765155,"NGA",612124
1,266.0,"Southern Europe",562175,0,562175,445337,742228,"ITA",593783
1,267.0,"Northern America",693277,662169,31108,574107,956846,"CAN",765477
1,267.0,"Southern Asia",788984,0,788984,616301,1027168,"IRN",821735
1,267.0,"South America",2442736,2315132,127604,1819174,3031957,"BRA",2425566
1,267.0,"Central Asia",1897226,1897226,0,1409299,2348832,"UZB",1879066
1,267.0,"South-Eastern Asia",1303727,0,1303727,997688,1662813,"IDN",1330251
1,267.0,"Pakistan",1950524,1824751,125773,1657396,2762327,"PAK",2209862
1,267.0,"Southern Africa",114372,0,114372,92608,154347,"ZAF",123478
1,267.0,"Northern Europe",2173371,2094760,78611,1693888,2823147,"GBR",2258518
1,267.0,"Oceania",706320,705471,849,521704,869507,"NZL",695606
1,267.0,"Central America",579651,0,579651,449573,749288,"MEX",599431
1,267.0,"Eastern Africa",445640,0,445640,341898,569831,"ETH",455865
1,267.0,"China",10580311,9916406,663905,8632995,14388326,"CPR",11510661
1,267.0,"Eastern Europe",3176044,3176044,0,2526639,4211065,"POL",3368852
1,267.0,"India",6995783,6966739,29044,5873450,9789083,"IND",7831267
1,267.0,"Middle Africa",175272,0,175272,134405,224008,"AGO",179207
1,267.0,"Western Asia",1183581,0,1183581,899769,1499616,"IRQ",1199693
1,267.0,"United States of America",2930797,2718882,211915,2315447,3859078,"USA",3087263
1,267.0,"Western Europe",3901201,3529047,372154,3300082,5500137,"NLD",4400110
1,267.0,"Russian Federation",2486058,2475665,10393,2360121,3933535,"RUS",3146828
1,267.0,"Northern Africa",1807035,0,1807035,1422706,2371177,"EGY",1896942
1,267.0,"Eastern Asia",1005590,0,1005590,789603,1316006,"JPN",1052805
1,267.0,"Western Africa",594320,0,594320,459093,765155,"NGA",612124
1,267.0,"Southern Europe",562931,0,562931,445337,742228,"ITA",593783
1,268.0,"Northern America",712789,680181,32608,574107,956846,"CAN",765477
1,268.0,"Southern Asia",794177,0,794177,616301,1027168,"IRN",821735
1,268.0,"South America",2434768,2330338,104430,1819174,3031957,"BRA",2425566
1,268.0,"Central Asia",1794062,1794062,0,1409299,2348832,"UZB",1879066
1,268.0,"South-Eastern Asia",1308603,0,1308603,997688,1662813,"IDN",1330251
1,268.0,"Pakistan",1972043,1827927,144116,1657396,2762327,"PAK",2209862
1,268.0,"Southern Africa",115817,0,115817,92608,154347,"ZAF",123478
1,268.0,"Northern Europe",2169316,2093158,76158,1693888,2823147,"GBR",2258518
1,268.0,"Oceania",702427,702427,0,521704,869507,"NZL",695606
1,268.0,"Central America",583077,0,583077,449573,749288,"MEX",599431
1,268.0,"Eastern Africa",447260,0,447260,341898,569831,"ETH",455865
1,268.0,"China",10623762,9923956,699806,8632995,14388326,"CPR",11510661
1,268.0,"Eastern Europe",3138264,3134118,4146,2526639,4211065,"POL",3368852
1,268.0,"India",7662853,7605069,57784,5873450,9789083,"IND",7831267
1,268.0,"Middle Africa",175898,0,175898,134405,224008,"AGO",179207
1,268.0,"Western Asia",1186134,0,1186134,899769,1499616,"IRQ",1199693
1,268.0,"United States of America",2945022,2727572,217450,2315447,3859078,"USA",3087263
1,268.0,"Western Europe",3981907,3574324,407583,3300082,5500137,"NLD",4400110
1,268.0,"Russian Federation",2470066,2444698,25368,2360121,3933535,"RUS",3146828
1,268.0,"Northern Africa",1821294,0,1821294,1422706,2371177,"EGY",1896942
1,268.0,"Eastern Asia",1013750,0,1013750,789603,1316006,"JPN",1052805
1,268.0,"Western Africa",597145,0,597145,459093,765155,"NGA",612124
1,268.0,"Southern Europe",567966,0,567966,445337,742228,"ITA",593783
1,269.0,"Northern America",722546,688844,33702,574107,956846,"CAN",765477
1,269.0,"Southern Asia",797207,0,797207,616301,1027168,"IRN",821735
1,269.0,"South America",2415973,2326357,89616,1819174,3031957,"BRA",2425566
1,269.0,"Central Asia",1717707,1717707,0,1409299,2348832,"UZB",1879066
1,269.0,"South-Eastern Asia",1310484,0,1310484,997688,1662813,"IDN",1330251
1,269.0,"Pakistan",1988296,1827080,161216,1657396,2762327,"PAK",2209862
1,269.0,"Southern Africa",116659,0,116659,92608,154347,"ZAF",123478
1,269.0,"Northern Europe",2165262,2091744,73518,1693888,2823147,"GBR",2258518
1,269.0,"Oceania",694634,694634,0,521704,869507,"NZL",695606
1,269.0,"Central America",584921,0,584921,449573,749288,"MEX",599431
1,269.0,"Eastern Africa",448206,0,448206,341898,569831,"ETH",455865
1,269.0,"China",10645047,9913148,731899,8632995,14388326,"CPR",11510661
1,269.0,"Eastern Europe",3111655,3103742,7913,2526639,4211065,"POL",3368852
1,269.0,"India",7683416,7600944,82472,5873450,9789083,"IND",7831267
1,269.0,"Middle Africa",176256,0,176256,134405,224008,"AGO",179207
1,269.0,"Western Asia",1187627,0,1187627,899769,1499616,"IRQ",1199693
1,269.0,"United States of America",2952130,2729651,222479,2315447,3859078,"USA",3087263
1,269.0,"Western Europe",4055275,3615256,440019,3300082,5500137,"NLD",4400110
1,269.0,"Russian Federation",2513941,2470941,43000,2360121,3933535,"RUS",3146828
1,269.0,"Northern Africa",1829613,0,1829613,1422706,2371177,"EGY",1896942
1,269.0,"Eastern Asia",1016473,0,1016473,789603,1316006,"JPN",1052805
1,269.0,"Western Africa",598789,0,598789,459093,765155,"NGA",612124
1,269.0,"Southern Europe",571533,0,571533,445337,742228,"ITA",593783
1,270.0,"Northern America",730351,695759,34592,574107,956846,"CAN",765477
1,270.0,"Southern Asia",801074,0,801074,616301,1027168,"IRN",821735
1,270.0,"South America",2417241,2338729,78512,1819174,3031957,"BRA",2425566
1,270.0,"Central Asia",1720680,1714032,6648,1409299,2348832,"UZB",1879066
1,270.0,"South-Eastern Asia",1313013,0,1313013,997688,1662813,"IDN",1330251
1,270.0,"Pakistan",1979712,1801792,177920,1657396,2762327,"PAK",2209862
1,270.0,"Southern Africa",117734,0,117734,92608,154347,"ZAF",123478
1,270.0,"Northern Europe",2165262,2089925,75337,1693888,2823147,"GBR",2258518
1,270.0,"Oceania",694631,694631,0,521704,869507,"NZL",695606
1,270.0,"Central America",586760,0,586760,449573,749288,"MEX",599431
1,270.0,"Eastern Africa",449416,0,449416,341898,569831,"ETH",455865
1,270.0,"China",10667745,9904530,763215,8632995,14388326,"CPR",11510661
1,270.0,"Eastern Europe",3084543,3074903,9640,2526639,4211065,"POL",3368852
1,270.0,"India",7695817,7588558,107259,5873450,9789083,"IND",7831267
1,270.0,"Middle Africa",176725,0,176725,134405,224008,"AGO",179207
1,270.0,"Western Asia",1189528,0,1189528,899769,1499616,"IRQ",1199693
1,270.0,"United States of America",2966357,2739099,227258,2315447,3859078,"USA",3087263
1,270.0,"Western Europe",4121306,3651751,469555,3300082,5500137,"NLD",4400110
1,270.0,"Russian Federation",2560081,2499263,60818,2360121,3933535,"RUS",3146828
1,270.0,"Northern Africa",1840232,0,1840232,1422706,2371177,"EGY",1896942
1,270.0,"Eastern Asia",1020941,0,1020941,789603,1316006,"JPN",1052805
1,270.0,"Western Africa",600893,0,600893,459093,765155,"NGA",612124
1,270.0,"Southern Europe",575047,0,575047,445337,742228,"ITA",593783
1,271.0,"Northern America",734253,698933,35320,574107,956846,"CAN",765477
1,271.0,"Southern Asia",802553,0,802553,616301,1027168,"IRN",821735
1,271.0,"South America",2385155,2317412,67743,1819174,3031957,"BRA",2425566
1,271.0,"Central Asia",1720329,1707229,13100,1409299,2348832,"UZB",1879066
1,271.0,"South-Eastern Asia",1312928,0,1312928,997688,1662813,"IDN",1330251
1,271.0,"Pakistan",1997353,1802800,194553,1657396,2762327,"PAK",2209862
1,271.0,"Southern Africa",118146,0,118146,92608,154347,"ZAF",123478
1,271.0,"Northern Europe",2169317,2092161,77156,1693888,2823147,"GBR",2258518
1,271.0,"Oceania",684889,684889,0,521704,869507,"NZL",695606
1,271.0,"Central America",587821,0,587821,449573,749288,"MEX",599431
1,271.0,"Eastern Africa",449872,0,449872,341898,569831,"ETH",455865
1,271.0,"China",10709631,9918709,790922,8632995,14388326,"CPR",11510661
1,271.0,"Eastern Europe",3075928,3055382,20546,2526639,4211065,"POL",3368852
1,271.0,"India",7719585,7588074,131511,5873450,9789083,"IND",7831267
1,271.0,"Middle Africa",176899,0,176899,134405,224008,"AGO",179207
1,271.0,"Western Asia",1190254,0,1190254,899769,1499616,"IRQ",1199693
1,271.0,"United States of America",2973468,2741935,231533,2315447,3859078,"USA",3087263
1,271.0,"Western Europe",4172664,3676330,496334,3300082,5500137,"NLD",4400110
1,271.0,"Russian Federation",2595748,2519071,76677,2360121,3933535,"RUS",3146828
1,271.0,"Northern Africa",1844285,0,1844285,1422706,2371177,"EGY",1896942
1,271.0,"Eastern Asia",1021014,0,1021014,789603,1316006,"JPN",1052805
1,271.0,"Western Africa",601694,0,601694,459093,765155,"NGA",612124
1,271.0,"Southern Europe",577400,0,577400,445337,742228,"ITA",593783
1,272.0,"Northern America",738156,702189,35967,574107,956846,"CAN",765477
1,272.0,"Southern Asia",803312,0,803312,616301,1027168,"IRN",821735
1,272.0,"South America",2400034,2340481,59553,1819174,3031957,"BRA",2425566
1,272.0,"Central Asia",1742057,1722622,19435,1409299,2348832,"UZB",1879066
1,272.0,"South-Eastern Asia",1313293,0,1313293,997688,1662813,"IDN",1330251
1,272.0,"Pakistan",2013104,1803458,209646,1657396,2762327,"PAK",2209862
1,272.0,"Southern Africa",118354,0,118354,92608,154347,"ZAF",123478
1,272.0,"Northern Europe",1942264,1863368,78896,1693888,2823147,"GBR",2258518
1,272.0,"Oceania",676122,676122,0,521704,869507,"NZL",695606
1,272.0,"Central America",589333,0,589333,449573,749288,"MEX",599431
1,272.0,"Eastern Africa",450112,0,450112,341898,569831,"ETH",455865
1,272.0,"China",10730581,9915982,814599,8632995,14388326,"CPR",11510661
1,272.0,"Eastern Europe",3602513,3570631,31882,2526639,4211065,"POL",3368852
1,272.0,"India",7707193,7575767,131426,5873450,9789083,"IND",7831267
1,272.0,"Middle Africa",176993,0,176993,134405,224008,"AGO",179207
1,272.0,"Western Asia",1190628,0,1190628,899769,1499616,"IRQ",1199693
1,272.0,"United States of America",2987692,2752135,235557,2315447,3859078,"USA",3087263
1,272.0,"Western Europe",4224022,3703117,520905,3300082,5500137,"NLD",4400110
1,272.0,"Russian Federation",2648247,2557443,90804,2360121,3933535,"RUS",3146828
1,272.0,"Northern Africa",1846374,0,1846374,1422706,2371177,"EGY",1896942
1,272.0,"Eastern Asia",1021675,0,1021675,789603,1316006,"JPN",1052805
1,272.0,"Western Africa",602107,0,602107,459093,765155,"NGA",612124
1,272.0,"Southern Europe",578993,0,578993,445337,742228,"ITA",593783
1,273.0,"Northern America",833766,797234,36532,574107,956846,"CAN",765477
1,273.0,"Southern Asia",839317,0,839317,616301,1027168,"IRN",821735
1,273.0,"South America",2424304,2366880,57424,1819174,3031957,"BRA",2425566
1,273.0,"Central Asia",1752599,1728179,24420,1409299,2348832,"UZB",1879066
1,273.0,"South-Eastern Asia",1335859,0,1335859,997688,1662813,"IDN",1330251
1,273.0,"Pakistan",2021085,1799210,221875,1657396,2762327,"PAK",2209862
1,273.0,"Southern Africa",128544,0,128544,92608,154347,"ZAF",123478
1,273.0,"Northern Europe",1966591,1878696,87895,1693888,2823147,"GBR",2258518
1,273.0,"Oceania",645922,645922,0,521704,869507,"NZL",695606
1,273.0,"Central America",608340,0,608340,449573,749288,"MEX",599431
1,273.0,"Eastern Africa",461353,0,461353,341898,569831,"ETH",455865
1,273.0,"China",10678891,9849994,828897,8632995,14388326,"CPR",11510661
1,273.0,"Eastern Europe",3585726,3545030,40696,2526639,4211065,"POL",3368852
1,273.0,"India",7717136,7574175,142961,5873450,9789083,"IND",7831267
1,273.0,"Middle Africa",181307,0,181307,134405,224008,"AGO",179207
1,273.0,"Western Asia",1208458,0,1208458,899769,1499616,"IRQ",1199693
1,273.0,"United States of America",3144155,2905078,239077,2315447,3859078,"USA",3087263
1,273.0,"Western Europe",4818306,4275176,543130,3300082,5500137,"NLD",4400110
1,273.0,"Russian Federation",2836043,2737535,98508,2360121,3933535,"RUS",3146828
1,273.0,"Northern Africa",1945222,0,1945222,1422706,2371177,"EGY",1896942
1,273.0,"Eastern Asia",1060850,0,1060850,789603,1316006,"JPN",1052805
1,273.0,"Western Africa",621679,0,621679,459093,765155,"NGA",612124
1,273.0,"Southern Europe",614154,0,614154,445337,742228,"ITA",593783
1,274.0,"Northern America",804506,769392,35114,574107,956846,"CAN",765477
1,274.0,"Southern Asia",836433,0,836433,616301,1027168,"IRN",821735
1,274.0,"South America",2451162,2398083,53079,1819174,3031957,"BRA",2425566
1,274.0,"Central Asia",1631993,1601765,30228,1409299,2348832,"UZB",1879066
1,274.0,"South-Eastern Asia",1336237,0,1336237,997688,1662813,"IDN",1330251
1,274.0,"Pakistan",2067129,1831749,235380,1657396,2762327,"PAK",2209862
1,274.0,"Southern Africa",127865,0,127865,92608,154347,"ZAF",123478
1,274.0,"Northern Europe",1999025,1898016,101009,1693888,2823147,"GBR",2258518
1,274.0,"Oceania",662477,660290,2187,521704,869507,"NZL",695606
1,274.0,"Central America",607898,0,607898,449573,749288,"MEX",599431
1,274.0,"Eastern Africa",460658,0,460658,341898,569831,"ETH",455865
1,274.0,"China",10703648,9853843,849805,8632995,14388326,"CPR",11510661
1,274.0,"Eastern Europe",3609039,3563357,45682,2526639,4211065,"POL",3368852
1,274.0,"India",7730505,7564721,165784,5873450,9789083,"IND",7831267
1,274.0,"Middle Africa",180846,0,180846,134405,224008,"AGO",179207
1,274.0,"Western Asia",1207391,0,1207391,899769,1499616,"IRQ",1199693
1,274.0,"United States of America",3144162,2907095,237067,2315447,3859078,"USA",3087263
1,274.0,"Western Europe",4752283,4230593,521690,3300082,5500137,"NLD",4400110
1,274.0,"Russian Federation",2895491,2788158,107333,2360121,3933535,"RUS",3146828
1,274.0,"Northern Africa",1936225,0,1936225,1422706,2371177,"EGY",1896942
1,274.0,"Eastern Asia",1063403,0,1063403,789603,1316006,"JPN",1052805
1,274.0,"Western Africa",621954,0,621954,459093,765155,"NGA",612124
1,274.0,"Southern Europe",610099,0,610099,445337,742228,"ITA",593783
1,275.0,"Northern America",788896,754591,34305,574116,956860,"CAN",765488
1,275.0,"Southern Asia",835863,0,835863,616305,1027176,"IRN",821741
1,275.0,"South America",2445213,2399123,46090,1819181,3031968,"BRA",2425575
1,275.0,"Central Asia",1639193,1600445,38748,1409303,2348838,"UZB",1879071
1,275.0,"South-Eastern Asia",1336441,0,1336441,997692,1662821,"IDN",1330257
1,275.0,"Pakistan",2102673,1854555,248118,1657396,2762327,"PAK",2209862
1,275.0,"Southern Africa",127417,0,127417,92611,154352,"ZAF",123482
1,275.0,"Northern Europe",2023353,1909556,113797,1693896,2823161,"GBR",2258529
1,275.0,"Oceania",679040,674635,4405,521706,869511,"NZL",695609
1,275.0,"Central America",606189,0,606189,449574,749290,"MEX",599432
1,275.0,"Eastern Africa",460262,0,460262,341904,569841,"ETH",455873
1,275.0,"China",10731197,9856662,874535,8632995,14388326,"CPR",11510661
1,275.0,"Eastern Europe",3561794,3517648,44146,2526643,4211072,"POL",3368858
1,275.0,"India",7743916,7554218,189698,5873454,9789090,"IND",7831272
1,275.0,"Middle Africa",180900,0,180900,134413,224022,"AGO",179218
1,275.0,"Western Asia",1206605,0,1206605,899770,1499617,"IRQ",1199694
1,275.0,"United States of America",3144161,2909105,235056,2315455,3859092,"USA",3087274
1,275.0,"Western Europe",4700924,4197289,503635,3300082,5500137,"NLD",4400110
1,275.0,"Russian Federation",2980131,2853274,126857,2360126,3933543,"RUS",3146835
1,275.0,"Northern Africa",1939639,0,1939639,1422708,2371181,"EGY",1896945
1,275.0,"Eastern Asia",1064076,0,1064076,789604,1316007,"JPN",1052806
1,275.0,"Western Africa",620289,0,620289,459096,765160,"NGA",612128
1,275.0,"Southern Europe",607078,0,607078,445342,742237,"ITA",593790
1,276.0,"Northern America",781090,747270,33820,712305,1187176,"CAN",949741
1,276.0,"Southern Asia",834294,0,834294,325048,541747,"IRN",433398
1,276.0,"South America",2412602,2372765,39837,1676506,2794177,"BRA",2235342
1,276.0,"Central Asia",1648077,1600263,47814,1116564,1860941,"UZB",1488753
1,276.0,"South-Eastern Asia",1336318,0,1336318,969194,1615323,"IDN",1292259
1,276.0,"Pakistan",2133634,1873937,259697,1540483,2567472,"PAK",2053978
1,276.0,"Southern Africa",126977,0,126977,125496,209161,"ZAF",167329
1,276.0,"Northern Europe",2047681,1921335,126346,1641240,2735401,"GBR",2188321
1,276.0,"Oceania",685860,679272,6588,523754,872923,"NZL",698339
1,276.0,"Central America",605126,0,605126,381239,635398,"MEX",508319
1,276.0,"Eastern Africa",459773,0,459773,365953,609922,"ETH",487938
1,276.0,"China",10756730,9855864,900866,7926789,13211315,"CPR",10569052
1,276.0,"Eastern Europe",3445403,3412315,33088,2219920,3699867,"POL",2959894
1,276.0,"India",7768805,7554798,214007,5457369,9095616,"IND",7276493
1,276.0,"Middle Africa",180713,0,180713,107690,179483,"AGO",143587
1,276.0,"Western Asia",1205834,0,1205834,574432,957387,"IRQ",765910
1,276.0,"United States of America",3144163,2911117,233046,2102022,3503370,"USA",2802696
1,276.0,"Western Europe",4656903,4168690,488213,3160221,5267036,"NLD",4213629
1,276.0,"Russian Federation",3053313,2909919,143394,2260715,3767858,"RUS",3014287
1,276.0,"Northern Africa",1936071,0,1936071,1448138,2413563,"EGY",1930851
1,276.0,"Eastern Asia",1063928,0,1063928,673410,1122350,"JPN",897880
1,276.0,"Western Africa",619055,0,619055,467672,779453,"NGA",623563
1,276.0,"Southern Europe",605065,0,605065,631939,1053232,"ITA",842586
1,277.0,"Northern America",777198,743700,33498,712305,1187176,"CAN",949741
1,277.0,"Southern Asia",811126,0,811126,325048,541747,"IRN",433398
1,277.0,"South America",821923,787099,34824,1676506,2794177,"BRA",2235342
1,277.0,"Central Asia",1697169,1645185,51984,1116564,1860941,"UZB",1488753
1,277.0,"South-Eastern Asia",1305730,0,1305730,969194,1615323,"IDN",1292259
1,277.0,"Pakistan",2143971,1891380,252591,1540483,2567472,"PAK",2053978
1,277.0,"Southern Africa",120543,0,120543,125496,209161,"ZAF",167329
1,277.0,"Northern Europe",2063909,1925554,138355,1641240,2735401,"GBR",2188321
1,277.0,"Oceania",492989,484231,8758,523754,872923,"NZL",698339
1,277.0,"Central America",604566,0,604566,381239,635398,"MEX",508319
1,277.0,"Eastern Africa",452553,0,452553,365953,609922,"ETH",487938
1,277.0,"China",10733660,9853316,880344,7926789,13211315,"CPR",10569052
1,277.0,"Eastern Europe",3332945,3309012,23933,2219920,3699867,"POL",2959894
1,277.0,"India",7780509,7557071,223438,5457369,9095616,"IND",7276493
1,277.0,"Middle Africa",177947,0,177947,107690,179483,"AGO",143587
1,277.0,"Western Asia",1194439,0,1194439,574432,957387,"IRQ",765910
1,277.0,"United States of America",3144173,2913137,231036,2102022,3503370,"USA",2802696
1,277.0,"Western Europe",4620220,4145171,475049,3160221,5267036,"NLD",4213629
1,277.0,"Russian Federation",3043264,2934964,108300,2260715,3767858,"RUS",3014287
1,277.0,"Northern Africa",1931374,0,1931374,1448138,2413563,"EGY",1930851
1,277.0,"Eastern Asia",1010855,0,1010855,673410,1122350,"JPN",897880
1,277.0,"Western Africa",618179,0,618179,467672,779453,"NGA",623563
1,277.0,"Southern Europe",603644,0,603644,631939,1053232,"ITA",842586
1,278.0,"Northern America",930223,893138,37085,712305,1187176,"CAN",949741
1,278.0,"Southern Asia",458799,0,458799,325048,541747,"IRN",433398
1,278.0,"South America",1008027,840925,167102,1676506,2794177,"BRA",2235342
1,278.0,"Central Asia",1797485,1745691,51794,1116564,1860941,"UZB",1488753
1,278.0,"South-Eastern Asia",1305170,0,1305170,969194,1615323,"IDN",1292259
1,278.0,"Pakistan",2184154,1934662,249492,1540483,2567472,"PAK",2053978
1,278.0,"Southern Africa",172784,0,172784,125496,209161,"ZAF",167329
1,278.0,"Northern Europe",2058574,1917007,141567,1641240,2735401,"GBR",2188321
1,278.0,"Oceania",649715,639246,10469,523754,872923,"NZL",698339
1,278.0,"Central America",534787,0,534787,381239,635398,"MEX",508319
1,278.0,"Eastern Africa",494464,0,494464,365953,609922,"ETH",487938
1,278.0,"China",10760136,9876085,884051,7926789,13211315,"CPR",10569052
1,278.0,"Eastern Europe",3250078,3235871,14207,2219920,3699867,"POL",2959894
1,278.0,"India",7765088,7554140,210948,5457369,9095616,"IND",7276493
1,278.0,"Middle Africa",146382,0,146382,107690,179483,"AGO",143587
1,278.0,"Western Asia",778348,0,778348,574432,957387,"IRQ",765910
1,278.0,"United States of America",3080065,2861109,218956,2102022,3503370,"USA",2802696
1,278.0,"Western Europe",4617159,4162956,454203,3160221,5267036,"NLD",4213629
1,278.0,"Russian Federation",3072721,2977685,95036,2260715,3767858,"RUS",3014287
1,278.0,"Northern Africa",2005243,0,2005243,1448138,2413563,"EGY",1930851
1,278.0,"Eastern Asia",934930,0,934930,673410,1122350,"JPN",897880
1,278.0,"Western Africa",637774,0,637774,467672,779453,"NGA",623563
1,278.0,"Southern Europe",861885,0,861885,631939,1053232,"ITA",842586
1,279.0,"Northern America",947786,910297,37489,712305,1187176,"CAN",949741
1,279.0,"Southern Asia",451574,0,451574,325048,541747,"IRN",433398
1,279.0,"South America",1310217,989770,320447,1676506,2794177,"BRA",2235342
1,279.0,"Central Asia",1794007,1750478,43529,1116564,1860941,"UZB",1488753
1,279.0,"South-Eastern Asia",1314286,0,1314286,969194,1615323,"IDN",1292259
1,279.0,"Pakistan",2177299,1935802,241497,1540483,2567472,"PAK",2053978
1,279.0,"Southern Africa",172379,0,172379,125496,209161,"ZAF",167329
1,279.0,"Northern Europe",2062629,1917711,144918,1641240,2735401,"GBR",2188321
1,279.0,"Oceania",690540,679691,10849,523754,872923,"NZL",698339
1,279.0,"Central America",519946,0,519946,381239,635398,"MEX",508319
1,279.0,"Eastern Africa",493577,0,493577,365953,609922,"ETH",487938
1,279.0,"China",10765589,9874311,891278,7926789,13211315,"CPR",10569052
1,279.0,"Eastern Europe",3099096,3094015,5081,2219920,3699867,"POL",2959894
1,279.0,"India",7767616,7566140,201476,5457369,9095616,"IND",7276493
1,279.0,"Middle Africa",145765,0,145765,107690,179483,"AGO",143587
1,279.0,"Western Asia",774781,0,774781,574432,957387,"IRQ",765910
1,279.0,"United States of America",2952050,2742906,209144,2102022,3503370,"USA",2802696
1,279.0,"Western Europe",4529116,4095603,433513,3160221,5267036,"NLD",4213629
1,279.0,"Russian Federation",3098166,2993430,104736,2260715,3767858,"RUS",3014287
1,279.0,"Northern Africa",1986032,0,1986032,1448138,2413563,"EGY",1930851
1,279.0,"Eastern Asia",921503,0,921503,673410,1122350,"JPN",897880
1,279.0,"Western Africa",633765,0,633765,467672,779453,"NGA",623563
1,279.0,"Southern Europe",859105,0,859105,631939,1053232,"ITA",842586
1,280.0,"Northern America",953642,916114,37528,712305,1187176,"CAN",949741
1,280.0,"Southern Asia",448530,0,448530,325048,541747,"IRN",433398
1,280.0,"South America",1536787,1093078,443709,1676506,2794177,"BRA",2235342
1,280.0,"Central Asia",1790791,1755779,35012,1116564,1860941,"UZB",1488753
1,280.0,"South-Eastern Asia",1313144,0,1313144,969194,1615323,"IDN",1292259
1,280.0,"Pakistan",2184710,1941142,243568,1540483,2567472,"PAK",2053978
1,280.0,"Southern Africa",171546,0,171546,125496,209161,"ZAF",167329
1,280.0,"Northern Europe",2066684,1918520,148164,1641240,2735401,"GBR",2188321
1,280.0,"Oceania",714896,703988,10908,523754,872923,"NZL",698339
1,280.0,"Central America",515009,0,515009,381239,635398,"MEX",508319
1,280.0,"Eastern Africa",492646,0,492646,365953,609922,"ETH",487938
1,280.0,"China",10764891,9867482,897409,7926789,13211315,"CPR",10569052
1,280.0,"Eastern Europe",2960209,2960209,0,2219920,3699867,"POL",2959894
1,280.0,"India",8157343,7963760,193583,5457369,9095616,"IND",7276493
1,280.0,"Middle Africa",145401,0,145401,107690,179483,"AGO",143587
1,280.0,"Western Asia",773304,0,773304,574432,957387,"IRQ",765910
1,280.0,"United States of America",2888043,2684181,203862,2102022,3503370,"USA",2802696
1,280.0,"Western Europe",4448412,4031074,417338,3160221,5267036,"NLD",4213629
1,280.0,"Russian Federation",3132766,3012626,120140,2260715,3767858,"RUS",3014287
1,280.0,"Northern Africa",1969484,0,1969484,1448138,2413563,"EGY",1930851
1,280.0,"Eastern Asia",918757,0,918757,673410,1122350,"JPN",897880
1,280.0,"Western Africa",630584,0,630584,467672,779453,"NGA",623563
1,280.0,"Southern Europe",853994,0,853994,631939,1053232,"ITA",842586
1,281.0,"Northern America",955597,918149,37448,712305,1187176,"CAN",949741
1,281.0,"Southern Asia",446473,0,446473,325048,541747,"IRN",433398
1,281.0,"South America",1684694,1146319,538375,1676506,2794177,"BRA",2235342
1,281.0,"Central Asia",1789346,1758581,30765,1116564,1860941,"UZB",1488753
1,281.0,"South-Eastern Asia",1310391,0,1310391,969194,1615323,"IDN",1292259
1,281.0,"Pakistan",2189168,1942218,246950,1540483,2567472,"PAK",2053978
1,281.0,"Southern Africa",170973,0,170973,125496,209161,"ZAF",167329
1,281.0,"Northern Europe",2070738,1919433,151305,1641240,2735401,"GBR",2188321
1,281.0,"Oceania",730489,719709,10780,523754,872923,"NZL",698339
1,281.0,"Central America",512585,0,512585,381239,635398,"MEX",508319
1,281.0,"Eastern Africa",492004,0,492004,365953,609922,"ETH",487938
1,281.0,"China",10786598,9883219,903379,7926789,13211315,"CPR",10569052
1,281.0,"Eastern Europe",2895040,2895040,0,2219920,3699867,"POL",2959894
1,281.0,"India",8151489,7974051,177438,5457369,9095616,"IND",7276493
1,281.0,"Middle Africa",145156,0,145156,107690,179483,"AGO",143587
1,281.0,"Western Asia",772305,0,772305,574432,957387,"IRQ",765910
1,281.0,"United States of America",2852481,2651637,200844,2102022,3503370,"USA",2802696
1,281.0,"Western Europe",4389718,3984416,405302,3160221,5267036,"NLD",4213629
1,281.0,"Russian Federation",3193912,3059749,134163,2260715,3767858,"RUS",3014287
1,281.0,"Northern Africa",1958351,0,1958351,1448138,2413563,"EGY",1930851
1,281.0,"Eastern Asia",922758,0,922758,673410,1122350,"JPN",897880
1,281.0,"Western Africa",628474,0,628474,467672,779453,"NGA",623563
1,281.0,"Southern Europe",850564,0,850564,631939,1053232,"ITA",842586
1,282.0,"Northern America",955596,918268,37328,712305,1187176,"CAN",949741
1,282.0,"Southern Asia",444722,0,444722,325048,541747,"IRN",433398
1,282.0,"South America",1807422,1192950,614472,1676506,2794177,"BRA",2235342
1,282.0,"Central Asia",1790692,1761294,29398,1116564,1860941,"UZB",1488753
1,282.0,"South-Eastern Asia",1307965,0,1307965,969194,1615323,"IDN",1292259
1,282.0,"Pakistan",2368462,2125342,243120,1540483,2567472,"PAK",2053978
1,282.0,"Southern Africa",170487,0,170487,125496,209161,"ZAF",167329
1,282.0,"Northern Europe",2074793,1920452,154341,1641240,2735401,"GBR",2188321
1,282.0,"Oceania",735359,724661,10698,523754,872923,"NZL",698339
1,282.0,"Central America",511475,0,511475,381239,635398,"MEX",508319
1,282.0,"Eastern Africa",491461,0,491461,365953,609922,"ETH",487938
1,282.0,"China",10788510,9878835,909675,7926789,13211315,"CPR",10569052
1,282.0,"Eastern Europe",2866767,2866767,0,2219920,3699867,"POL",2959894
1,282.0,"India",7230075,7086299,143776,5457369,9095616,"IND",7276493
1,282.0,"Middle Africa",144946,0,144946,107690,179483,"AGO",143587
1,282.0,"Western Asia",771445,0,771445,574432,957387,"IRQ",765910
1,282.0,"United States of America",2838260,2639174,199086,2102022,3503370,"USA",2802696
1,282.0,"Western Europe",4345695,3949420,396275,3160221,5267036,"NLD",4213629
1,282.0,"Russian Federation",3255251,3111718,143533,2260715,3767858,"RUS",3014287
1,282.0,"Northern Africa",1951573,0,1951573,1448138,2413563,"EGY",1930851
1,282.0,"Eastern Asia",925152,0,925152,673410,1122350,"JPN",897880
1,282.0,"Western Africa",627197,0,627197,467672,779453,"NGA",623563
1,282.0,"Southern Europe",848494,0,848494,631939,1053232,"ITA",842586
1,283.0,"Northern America",955597,918389,37208,712305,1187176,"CAN",949741
1,283.0,"Southern Asia",442864,0,442864,325048,541747,"IRN",433398
1,283.0,"South America",1913912,1235772,678140,1676506,2794177,"BRA",2235342
1,283.0,"Central Asia",1688371,1657941,30430,1116564,1860941,"UZB",1488753
1,283.0,"South-Eastern Asia",1305385,0,1305385,969194,1615323,"IDN",1292259
1,283.0,"Pakistan",2348769,2124398,224371,1540483,2567472,"PAK",2053978
1,283.0,"Southern Africa",169969,0,169969,125496,209161,"ZAF",167329
1,283.0,"Northern Europe",2078846,1921574,157272,1641240,2735401,"GBR",2188321
1,283.0,"Oceania",733411,720970,12441,523754,872923,"NZL",698339
1,283.0,"Central America",510931,0,510931,381239,635398,"MEX",508319
1,283.0,"Eastern Africa",490882,0,490882,365953,609922,"ETH",487938
1,283.0,"China",10812304,9894599,917705,7926789,13211315,"CPR",10569052
1,283.0,"Eastern Europe",2832617,2832617,0,2219920,3699867,"POL",2959894
1,283.0,"India",7350975,7226016,124959,5457369,9095616,"IND",7276493
1,283.0,"Middle Africa",144722,0,144722,107690,179483,"AGO",143587
1,283.0,"Western Asia",770537,0,770537,574432,957387,"IRQ",765910
1,283.0,"United States of America",2831147,2637772,193375,2102022,3503370,"USA",2802696
1,283.0,"Western Europe",4309012,3919506,389506,3160221,5267036,"NLD",4213629
1,283.0,"Russian Federation",3315946,3168458,147488,2260715,3767858,"RUS",3014287
1,283.0,"Northern Africa",1946787,0,1946787,1448138,2413563,"EGY",1930851
1,283.0,"Eastern Asia",920720,0,920720,673410,1122350,"JPN",897880
1,283.0,"Western Africa",626295,0,626295,467672,779453,"NGA",623563
1,283.0,"Southern Europe",847026,0,847026,631939,1053232,"ITA",842586
1,284.0,"Northern America",957549,920460,37089,712305,1187176,"CAN",949741
1,284.0,"Southern Asia",440813,0,440813,325048,541747,"IRN",433398
1,284.0,"South America",1995862,1259885,735977,1676506,2794177,"BRA",2235342
1,284.0,"Central Asia",1525825,1501798,24027,1116564,1860941,"UZB",1488753
1,284.0,"South-Eastern Asia",1302536,0,1302536,969194,1615323,"IDN",1292259
1,284.0,"Pakistan",2332531,2125125,207406,1540483,2567472,"PAK",2053978
1,284.0,"Southern Africa",169398,0,169398,125496,209161,"ZAF",167329
1,284.0,"Northern Europe",3007329,2847231,160098,1641240,2735401,"GBR",2188321
1,284.0,"Oceania",725619,711473,14146,523754,872923,"NZL",698339
1,284.0,"Central America",510676,0,510676,381239,635398,"MEX",508319
1,284.0,"Eastern Africa",490244,0,490244,365953,609922,"ETH",487938
1,284.0,"China",10807116,9888305,918811,7926789,13211315,"CPR",10569052
1,284.0,"Eastern Europe",3300890,3294711,6179,2219920,3699867,"POL",2959894
1,284.0,"India",7400588,7296564,104024,5457369,9095616,"IND",7276493
1,284.0,"Middle Africa",144478,0,144478,107690,179483,"AGO",143587
1,284.0,"Western Asia",769532,0,769532,574432,957387,"IRQ",765910
1,284.0,"United States of America",2824036,2637018,187018,2102022,3503370,"USA",2802696
1,284.0,"Western Europe",4279664,3895047,384617,3160221,5267036,"NLD",4213629
1,284.0,"Russian Federation",3367191,3222009,145182,2260715,3767858,"RUS",3014287
1,284.0,"Northern Africa",1943358,0,1943358,1448138,2413563,"EGY",1930851
1,284.0,"Eastern Asia",915769,0,915769,673410,1122350,"JPN",897880
1,284.0,"Western Africa",628331,0,628331,467672,779453,"NGA",623563
1,284.0,"Southern Europe",850380,0,850380,631939,1053232,"ITA",842586
1,285.0,"Northern America",811206,774277,36929,712305,1187176,"CAN",949741
1,285.0,"Southern Asia",424267,0,424267,325048,541747,"IRN",433398
1,285.0,"South America",2051193,1283691,767502,1676506,2794177,"BRA",2235342
1,285.0,"Central Asia",1515405,1496136,19269,1116564,1860941,"UZB",1488753
1,285.0,"South-Eastern Asia",1279488,0,1279488,969194,1615323,"IDN",1292259
1,285.0,"Pakistan",2323217,2127615,195602,1540483,2567472,"PAK",2053978
1,285.0,"Southern Africa",164803,0,164803,125496,209161,"ZAF",167329
1,285.0,"Northern Europe",2987067,2848122,138945,1641240,2735401,"GBR",2188321
1,285.0,"Oceania",720746,704854,15892,523754,872923,"NZL",698339
1,285.0,"Central America",486574,0,486574,381239,635398,"MEX",508319
1,285.0,"Eastern Africa",485083,0,485083,365953,609922,"ETH",487938
1,285.0,"China",11419444,10500577,918867,7926789,13211315,"CPR",10569052
1,285.0,"Eastern Europe",3053515,3053515,0,2219920,3699867,"POL",2959894
1,285.0,"India",7388801,7306416,82385,5457369,9095616,"IND",7276493
1,285.0,"Middle Africa",142491,0,142491,107690,179483,"AGO",143587
1,285.0,"Western Asia",761401,0,761401,574432,957387,"IRQ",765910
1,285.0,"United States of America",2653349,2467045,186304,2102022,3503370,"USA",2802696
1,285.0,"Western Europe",4580475,4199242,381233,3160221,5267036,"NLD",4213629
1,285.0,"Russian Federation",4528188,4380547,147641,2260715,3767858,"RUS",3014287
1,285.0,"Northern Africa",1899319,0,1899319,1448138,2413563,"EGY",1930851
1,285.0,"Eastern Asia",875774,0,875774,673410,1122350,"JPN",897880
1,285.0,"Western Africa",619637,0,619637,467672,779453,"NGA",623563
1,285.0,"Southern Europe",836081,0,836081,631939,1053232,"ITA",842586
1,286.0,"Northern America",881384,841634,39750,712305,1187176,"CAN",949741
1,286.0,"Southern Asia",430824,0,430824,325048,541747,"IRN",433398
1,286.0,"South America",2106542,1307792,798750,1676506,2794177,"BRA",2235342
1,286.0,"Central Asia",1542584,1527942,14642,1116564,1860941,"UZB",1488753
1,286.0,"South-Eastern Asia",1288726,0,1288726,969194,1615323,"IDN",1292259
1,286.0,"Pakistan",2308623,2125737,182886,1540483,2567472,"PAK",2053978
1,286.0,"Southern Africa",167641,0,167641,125496,209161,"ZAF",167329
1,286.0,"Northern Europe",2958685,2840370,118315,1641240,2735401,"GBR",2188321
1,286.0,"Oceania",723670,706007,17663,523754,872923,"NZL",698339
1,286.0,"Central America",502517,0,502517,381239,635398,"MEX",508319
1,286.0,"Eastern Africa",488468,0,488468,365953,609922,"ETH",487938
1,286.0,"China",11400879,10492593,908286,7926789,13211315,"CPR",10569052
1,286.0,"Eastern Europe",3119637,3119637,0,2219920,3699867,"POL",2959894
1,286.0,"India",7510110,7448823,61287,5457369,9095616,"IND",7276493
1,286.0,"Middle Africa",143650,0,143650,107690,179483,"AGO",143587
1,286.0,"Western Asia",764669,0,764669,574432,957387,"IRQ",765910
1,286.0,"United States of America",2710237,2518914,191323,2102022,3503370,"USA",2802696
1,286.0,"Western Europe",4441075,4078651,362424,3160221,5267036,"NLD",4213629
1,286.0,"Russian Federation",4501402,4395389,106013,2260715,3767858,"RUS",3014287
1,286.0,"Northern Africa",1925730,0,1925730,1448138,2413563,"EGY",1930851
1,286.0,"Eastern Asia",891696,0,891696,673410,1122350,"JPN",897880
1,286.0,"Western Africa",622813,0,622813,467672,779453,"NGA",623563
1,286.0,"Southern Europe",841402,0,841402,631939,1053232,"ITA",842586
1,287.0,"Northern America",926319,882201,44118,712313,1187188,"CAN",949751
1,287.0,"Southern Asia",437461,0,437461,325052,541753,"IRN",433403
1,287.0,"South America",2144857,1319213,825644,1676506,2794177,"BRA",2235342
1,287.0,"Central Asia",1543864,1533915,9949,1116569,1860948,"UZB",1488759
1,287.0,"South-Eastern Asia",1296932,0,1296932,969201,1615335,"IDN",1292268
1,287.0,"Pakistan",2298775,2124922,173853,1540488,2567480,"PAK",2053984
1,287.0,"Southern Africa",168481,0,168481,125505,209175,"ZAF",167340
1,287.0,"Northern Europe",2780285,2676627,103658,1641248,2735413,"GBR",2188331
1,287.0,"Oceania",715876,696528,19348,523759,872932,"NZL",698346
1,287.0,"Central America",509980,0,509980,381240,635400,"MEX",508320
1,287.0,"Eastern Africa",489231,0,489231,365961,609935,"ETH",487948
1,287.0,"China",11411088,10502801,908287,7926790,13211317,"CPR",10569054
1,287.0,"Eastern Europe",3123830,3123639,191,2219928,3699881,"POL",2959905
1,287.0,"India",7511217,7472126,39091,5457375,9095626,"IND",7276501
1,287.0,"Middle Africa",144088,0,144088,107696,179493,"AGO",143595
1,287.0,"Western Asia",767756,0,767756,574432,957387,"IRQ",765910
1,287.0,"United States of America",2745798,2551369,194429,2102029,3503382,"USA",2802706
1,287.0,"Western Europe",4360369,4009606,350763,3160226,5267043,"NLD",4213635
1,287.0,"Russian Federation",4193098,4098217,94881,2260720,3767867,"RUS",3014294
1,287.0,"Northern Africa",1936637,0,1936637,1448139,2413565,"EGY",1930852
1,287.0,"Eastern Asia",903469,0,903469,673410,1122351,"JPN",897881
1,287.0,"Western Africa",624724,0,624724,467678,779463,"NGA",623571
1,287.0,"Southern Europe",844505,0,844505,631941,1053235,"ITA",842588
1,288.0,"Northern America",951689,904168,47521,696204,1160340,"CAN",928272
1,288.0,"Southern Asia",437668,0,437668,574011,956686,"IRN",765349
1,288.0,"South America",2177584,1329656,847928,1482404,2470673,"BRA",1976539
1,288.0,"Central Asia",1580050,1574543,5507,1140768,1901280,"UZB",1521024
1,288.0,"South-Eastern Asia",1298203,0,1298203,990856,1651427,"IDN",1321142
1,288.0,"Pakistan",2291190,2125578,165612,1439473,2399122,"PAK",1919298
1,288.0,"Southern Africa",168519,0,168519,179822,299703,"ZAF",239763
1,288.0,"Northern Europe",2318070,2236060,82010,1559760,2599600,"GBR",2079680
1,288.0,"Oceania",713928,692799,21129,466524,777540,"NZL",622032
1,288.0,"Central America",510775,0,510775,388438,647397,"MEX",517918
1,288.0,"Eastern Africa",489273,0,489273,338517,564196,"ETH",451357
1,288.0,"China",11417123,10504618,912505,7791810,12986351,"CPR",10389081
1,288.0,"Eastern Europe",3230099,3229308,791,2156298,3593830,"POL",2875064
1,288.0,"India",7668753,7651521,17232,5172716,8621193,"IND",6896955
1,288.0,"Middle Africa",144061,0,144061,113941,189902,"AGO",151922
1,288.0,"Western Asia",768012,0,768012,472707,787846,"IRQ",630277
1,288.0,"United States of America",2767131,2570793,196338,2042478,3404130,"USA",2723304
1,288.0,"Western Europe",4323685,3968075,355610,3006224,5010373,"NLD",4008299
1,288.0,"Russian Federation",3381504,3310283,71221,2438927,4064878,"RUS",3251903
1,288.0,"Northern Africa",1937999,0,1937999,1229260,2048767,"EGY",1639014
1,288.0,"Eastern Asia",908192,0,908192,658962,1098271,"JPN",878617
1,288.0,"Western Africa",624966,0,624966,447191,745318,"NGA",596255
1,288.0,"Southern Europe",844877,0,844877,599652,999421,"ITA",799537
1,289.0,"Northern America",963413,913154,50259,696204,1160340,"CAN",928272
1,289.0,"Southern Asia",442606,0,442606,574011,956686,"IRN",765349
1,289.0,"South America",2609466,1739277,870189,1482404,2470673,"BRA",1976539
1,289.0,"Central Asia",1568658,1566858,1800,1140768,1901280,"UZB",1521024
1,289.0,"South-Eastern Asia",1305093,0,1305093,990856,1651427,"IDN",1321142
1,289.0,"Pakistan",2249607,2091929,157678,1439473,2399122,"PAK",1919298
1,289.0,"Southern Africa",169899,0,169899,179822,299703,"ZAF",239763
1,289.0,"Northern Europe",2297805,2225088,72717,1559760,2599600,"GBR",2079680
1,289.0,"Oceania",743157,720466,22691,466524,777540,"NZL",622032
1,289.0,"Central America",512395,0,512395,388438,647397,"MEX",517918
1,289.0,"Eastern Africa",490825,0,490825,338517,564196,"ETH",451357
1,289.0,"China",11423470,10502480,920990,7791810,12986351,"CPR",10389081
1,289.0,"Eastern Europe",3195671,3195160,511,2156298,3593830,"POL",2875064
1,289.0,"India",7612192,7610347,1845,5172716,8621193,"IND",6896955
1,289.0,"Middle Africa",144702,0,144702,113941,189902,"AGO",151922
1,289.0,"Western Asia",770441,0,770441,472707,787846,"IRQ",630277
1,289.0,"United States of America",2788479,2590947,197532,2042478,3404130,"USA",2723304
1,289.0,"Western Europe",4301680,3940088,361592,3006224,5010373,"NLD",4008299
1,289.0,"Russian Federation",3276131,3218595,57536,2438927,4064878,"RUS",3251903
1,289.0,"Northern Africa",1942659,0,1942659,1229260,2048767,"EGY",1639014
1,289.0,"Eastern Asia",920130,0,920130,658962,1098271,"JPN",878617
1,289.0,"Western Africa",625892,0,625892,447191,745318,"NGA",596255
1,289.0,"Southern Europe",846383,0,846383,599652,999421,"ITA",799537
1,290.0,"Northern America",975107,922991,52116,696204,1160340,"CAN",928272
1,290.0,"Southern Asia",789305,0,789305,574011,956686,"IRN",765349
1,290.0,"South America",2557480,1738325,819155,1482404,2470673,"BRA",1976539
1,290.0,"Central Asia",1483572,1481739,1833,1140768,1901280,"UZB",1521024
1,290.0,"South-Eastern Asia",1354534,0,1354534,990856,1651427,"IDN",1321142
1,290.0,"Pakistan",1893675,1758118,135557,1439473,2399122,"PAK",1919298
1,290.0,"Southern Africa",246416,0,246416,179822,299703,"ZAF",239763
1,290.0,"Northern Europe",2018864,1957081,61783,1559760,2599600,"GBR",2079680
1,290.0,"Oceania",671722,649728,21994,466524,777540,"NZL",622032
1,290.0,"Central America",535346,0,535346,388438,647397,"MEX",517918
1,290.0,"Eastern Africa",458840,0,458840,338517,564196,"ETH",451357
1,290.0,"China",11436374,10505253,931121,7791810,12986351,"CPR",10389081
1,290.0,"Eastern Europe",2772737,2772737,0,2156298,3593830,"POL",2875064
1,290.0,"India",6727970,6726615,1355,5172716,8621193,"IND",6896955
1,290.0,"Middle Africa",154790,0,154790,113941,189902,"AGO",151922
1,290.0,"Western Asia",642068,0,642068,472707,787846,"IRQ",630277
1,290.0,"United States of America",2815762,2620419,195343,2042478,3404130,"USA",2723304
1,290.0,"Western Europe",4257754,3900786,356968,3006224,5010373,"NLD",4008299
1,290.0,"Russian Federation",3123900,3076334,47566,2438927,4064878,"RUS",3251903
1,290.0,"Northern Africa",1700843,0,1700843,1229260,2048767,"EGY",1639014
1,290.0,"Eastern Asia",936555,0,936555,658962,1098271,"JPN",878617
1,290.0,"Western Africa",606999,0,606999,447191,745318,"NGA",596255
1,290.0,"Southern Europe",816811,0,816811,599652,999421,"ITA",799537
1,291.0,"Northern America",986816,933219,53597,696204,1160340,"CAN",928272
1,291.0,"Southern Asia",791025,0,791025,574011,956686,"IRN",765349
1,291.0,"South America",2516780,1740736,776044,1482404,2470673,"BRA",1976539
1,291.0,"Central Asia",1532639,1530378,2261,1140768,1901280,"UZB",1521024
1,291.0,"South-Eastern Asia",1356926,0,1356926,990856,1651427,"IDN",1321142
1,291.0,"Pakistan",1936357,1799218,137139,1439473,2399122,"PAK",1919298
1,291.0,"Southern Africa",246898,0,246898,179822,299703,"ZAF",239763
1,291.0,"Northern Europe",2095896,2039176,56720,1559760,2599600,"GBR",2079680
1,291.0,"Oceania",665873,643153,22720,466524,777540,"NZL",622032
1,291.0,"Central America",538184,0,538184,388438,647397,"MEX",517918
1,291.0,"Eastern Africa",459371,0,459371,338517,564196,"ETH",451357
1,291.0,"China",11433598,10497581,936017,7791810,12986351,"CPR",10389081
1,291.0,"Eastern Europe",2901337,2901337,0,2156298,3593830,"POL",2875064
1,291.0,"India",6946123,6942754,3369,5172716,8621193,"IND",6896955
1,291.0,"Middle Africa",155009,0,155009,113941,189902,"AGO",151922
1,291.0,"Western Asia",642910,0,642910,472707,787846,"IRQ",630277
1,291.0,"United States of America",2844211,2651974,192237,2042478,3404130,"USA",2723304
1,291.0,"Western Europe",4228407,3874047,354360,3006224,5010373,"NLD",4008299
1,291.0,"Russian Federation",3276738,3238023,38715,2438927,4064878,"RUS",3251903
1,291.0,"Northern Africa",1699816,0,1699816,1229260,2048767,"EGY",1639014
1,291.0,"Eastern Asia",940686,0,940686,658962,1098271,"JPN",878617
1,291.0,"Western Africa",608076,0,608076,447191,745318,"NGA",596255
1,291.0,"Southern Europe",818392,0,818392,599652,999421,"ITA",799537
1,292.0,"Northern America",992667,938002,54665,696204,1160340,"CAN",928272
1,292.0,"Southern Asia",790151,0,790151,574011,956686,"IRN",765349
1,292.0,"South America",2480064,1743149,736915,1482404,2470673,"BRA",1976539
1,292.0,"Central Asia",1495714,1493872,1842,1140768,1901280,"UZB",1521024
1,292.0,"South-Eastern Asia",1355706,0,1355706,990856,1651427,"IDN",1321142
1,292.0,"Pakistan",1896542,1758261,138281,1439473,2399122,"PAK",1919298
1,292.0,"Southern Africa",246658,0,246658,179822,299703,"ZAF",239763
1,292.0,"Northern Europe",2039136,1988934,50202,1559760,2599600,"GBR",2079680
1,292.0,"Oceania",660026,636529,23497,466524,777540,"NZL",622032
1,292.0,"Central America",538043,0,538043,388438,647397,"MEX",517918
1,292.0,"Eastern Africa",459102,0,459102,338517,564196,"ETH",451357
1,292.0,"China",11450513,10515883,934630,7791810,12986351,"CPR",10389081
1,292.0,"Eastern Europe",2797245,2795554,1691,2156298,3593830,"POL",2875064
1,292.0,"India",6503532,6497532,6000,5172716,8621193,"IND",6896955
1,292.0,"Middle Africa",154903,0,154903,113941,189902,"AGO",151922
1,292.0,"Western Asia",642478,0,642478,472707,787846,"IRQ",630277
1,292.0,"United States of America",2851323,2663148,188175,2042478,3404130,"USA",2723304
1,292.0,"Western Europe",4199060,3846024,353036,3006224,5010373,"NLD",4008299
1,292.0,"Russian Federation",3176589,3138403,38186,2438927,4064878,"RUS",3251903
1,292.0,"Northern Africa",1707092,0,1707092,1229260,2048767,"EGY",1639014
1,292.0,"Eastern Asia",938577,0,938577,658962,1098271,"JPN",878617
1,292.0,"Western Africa",609739,0,609739,447191,745318,"NGA",596255
1,292.0,"Southern Europe",818221,0,818221,599652,999421,"ITA",799537
1,293.0,"Northern America",994621,939156,55465,696204,1160340,"CAN",928272
1,293.0,"Southern Asia",783574,0,783574,574011,956686,"IRN",765349
1,293.0,"South America",2437754,1742060,695694,1482404,2470673,"BRA",1976539
1,293.0,"Central Asia",1496735,1495008,1727,1140768,1901280,"UZB",1521024
1,293.0,"South-Eastern Asia",1346542,0,1346542,990856,1651427,"IDN",1321142
1,293.0,"Pakistan",1892339,1755899,136440,1439473,2399122,"PAK",1919298
1,293.0,"Southern Africa",244830,0,244830,179822,299703,"ZAF",239763
1,293.0,"Northern Europe",2043189,1998615,44574,1559760,2599600,"GBR",2079680
1,293.0,"Oceania",657107,632761,24346,466524,777540,"NZL",622032
1,293.0,"Central America",532075,0,532075,388438,647397,"MEX",517918
1,293.0,"Eastern Africa",457049,0,457049,338517,564196,"ETH",451357
1,293.0,"China",11432182,10520263,911919,7791810,12986351,"CPR",10389081
1,293.0,"Eastern Europe",2797419,2797419,0,2156298,3593830,"POL",2875064
1,293.0,"India",6519009,6510076,8933,5172716,8621193,"IND",6896955
1,293.0,"Middle Africa",154115,0,154115,113941,189902,"AGO",151922
1,293.0,"Western Asia",639247,0,639247,472707,787846,"IRQ",630277
1,293.0,"United States of America",2865545,2681414,184131,2042478,3404130,"USA",2723304
1,293.0,"Western Europe",3978955,3647418,331537,3006224,5010373,"NLD",4008299
1,293.0,"Russian Federation",3176203,3139532,36671,2438927,4064878,"RUS",3251903
1,293.0,"Northern Africa",1689041,0,1689041,1229260,2048767,"EGY",1639014
1,293.0,"Eastern Asia",922672,0,922672,658962,1098271,"JPN",878617
1,293.0,"Western Africa",606161,0,606161,447191,745318,"NGA",596255
1,293.0,"Southern Europe",812641,0,812641,599652,999421,"ITA",799537
1,294.0,"Northern America",986816,930713,56103,696204,1160340,"CAN",928272
1,294.0,"Southern Asia",783566,0,783566,574011,956686,"IRN",765349
1,294.0,"South America",2401887,1742307,659580,1482404,2470673,"BRA",1976539
1,294.0,"Central Asia",1527334,1525511,1823,1140768,1901280,"UZB",1521024
1,294.0,"South-Eastern Asia",1346534,0,1346534,990856,1651427,"IDN",1321142
1,294.0,"Pakistan",1927685,1792043,135642,1439473,2399122,"PAK",1919298
1,294.0,"Southern Africa",244829,0,244829,179822,299703,"ZAF",239763
1,294.0,"Northern Europe",2087788,2048980,38808,1559760,2599600,"GBR",2079680
1,294.0,"Oceania",653208,631596,21612,466524,777540,"NZL",622032
1,294.0,"Central America",532336,0,532336,388438,647397,"MEX",517918
1,294.0,"Eastern Africa",457045,0,457045,338517,564196,"ETH",451357
1,294.0,"China",11412849,10521184,891665,7791810,12986351,"CPR",10389081
1,294.0,"Eastern Europe",2888488,2886631,1857,2156298,3593830,"POL",2875064
1,294.0,"India",6568242,6536484,31758,5172716,8621193,"IND",6896955
1,294.0,"Middle Africa",154112,0,154112,113941,189902,"AGO",151922
1,294.0,"Western Asia",639241,0,639241,472707,787846,"IRQ",630277
1,294.0,"United States of America",2858433,2671133,187300,2042478,3404130,"USA",2723304
1,294.0,"Western Europe",4022971,3701500,321471,3006224,5010373,"NLD",4008299
1,294.0,"Russian Federation",3272429,3236379,36050,2438927,4064878,"RUS",3251903
1,294.0,"Northern Africa",1689021,0,1689021,1229260,2048767,"EGY",1639014
1,294.0,"Eastern Asia",922657,0,922657,658962,1098271,"JPN",878617
1,294.0,"Western Africa",606158,0,606158,447191,745318,"NGA",596255
1,294.0,"Southern Europe",812925,0,812925,599652,999421,"ITA",799537
1,295.0,"Northern America",982912,926014,56898,696204,1160340,"CAN",928272
1,295.0,"Southern Asia",784170,0,784170,574011,956686,"IRN",765349
1,295.0,"South America",2373144,1744764,628380,1482404,2470673,"BRA",1976539
1,295.0,"Central Asia",1562022,1560031,1991,1140768,1901280,"UZB",1521024
1,295.0,"South-Eastern Asia",1347372,0,1347372,990856,1651427,"IDN",1321142
1,295.0,"Pakistan",1961446,1828153,133293,1439473,2399122,"PAK",1919298
1,295.0,"Southern Africa",244996,0,244996,179822,299703,"ZAF",239763
1,295.0,"Northern Europe",2136444,2103963,32481,1559760,2599600,"GBR",2079680
1,295.0,"Oceania",637622,618580,19042,466524,777540,"NZL",622032
1,295.0,"Central America",534573,0,534573,388438,647397,"MEX",517918
1,295.0,"Eastern Africa",457234,0,457234,338517,564196,"ETH",451357
1,295.0,"China",11371529,10527120,844409,7791810,12986351,"CPR",10389081
1,295.0,"Eastern Europe",2994274,2989394,4880,2156298,3593830,"POL",2875064
1,295.0,"India",6642190,6583486,58704,5172716,8621193,"IND",6896955
1,295.0,"Middle Africa",154186,0,154186,113941,189902,"AGO",151922
1,295.0,"Western Asia",639538,0,639538,472707,787846,"IRQ",630277
1,295.0,"United States of America",2851323,2660811,190512,2042478,3404130,"USA",2723304
1,295.0,"Western Europe",4111018,3802079,308939,3006224,5010373,"NLD",4008299
1,295.0,"Russian Federation",3383340,3348378,34962,2438927,4064878,"RUS",3251903
1,295.0,"Northern Africa",1690675,0,1690675,1229260,2048767,"EGY",1639014
1,295.0,"Eastern Asia",924115,0,924115,658962,1098271,"JPN",878617
1,295.0,"Western Africa",606485,0,606485,447191,745318,"NGA",596255
1,295.0,"Southern Europe",815017,0,815017,599652,999421,"ITA",799537
1,296.0,"Northern America",980960,923225,57735,696204,1160340,"CAN",928272
1,296.0,"Southern Asia",784857,0,784857,574011,956686,"IRN",765349
1,296.0,"South America",2344478,1743207,601271,1482404,2470673,"BRA",1976539
1,296.0,"Central Asia",1571638,1569765,1873,1140768,1901280,"UZB",1521024
1,296.0,"South-Eastern Asia",1348331,0,1348331,990856,1651427,"IDN",1321142
1,296.0,"Pakistan",1934932,1805558,129374,1439473,2399122,"PAK",1919298
1,296.0,"Southern Africa",245187,0,245187,179822,299703,"ZAF",239763
1,296.0,"Northern Europe",2148608,2122865,25743,1559760,2599600,"GBR",2079680
1,296.0,"Oceania",638596,621736,16860,466524,777540,"NZL",622032
1,296.0,"Central America",535182,0,535182,388438,647397,"MEX",517918
1,296.0,"Eastern Africa",457450,0,457450,338517,564196,"ETH",451357
1,296.0,"China",11328758,10531498,797260,7791810,12986351,"CPR",10389081
1,296.0,"Eastern Europe",3024271,3019901,4370,2156298,3593830,"POL",2875064
1,296.0,"India",6716405,6630236,86169,5172716,8621193,"IND",6896955
1,296.0,"Middle Africa",154268,0,154268,113941,189902,"AGO",151922
1,296.0,"Western Asia",639875,0,639875,472707,787846,"IRQ",630277
1,296.0,"United States of America",2851321,2657538,193783,2042478,3404130,"USA",2723304
1,296.0,"Western Europe",4133026,3841226,291800,3006224,5010373,"NLD",4008299
1,296.0,"Russian Federation",3416299,3383694,32605,2438927,4064878,"RUS",3251903
1,296.0,"Northern Africa",1692564,0,1692564,1229260,2048767,"EGY",1639014
1,296.0,"Eastern Asia",925778,0,925778,658962,1098271,"JPN",878617
1,296.0,"Western Africa",606860,0,606860,447191,745318,"NGA",596255
1,296.0,"Southern Europe",815739,0,815739,599652,999421,"ITA",799537
1,297.0,"Northern America",1189743,1131192,58551,696204,1160340,"CAN",928272
1,297.0,"Southern Asia",807751,0,807751,574011,956686,"IRN",765349
1,297.0,"South America",2344117,1744058,600059,1482404,2470673,"BRA",1976539
1,297.0,"Central Asia",1522184,1520310,1874,1140768,1901280,"UZB",1521024
1,297.0,"South-Eastern Asia",1380239,0,1380239,990856,1651427,"IDN",1321142
1,297.0,"Pakistan",1929066,1805688,123378,1439473,2399122,"PAK",1919298
1,297.0,"Southern Africa",251548,0,251548,179822,299703,"ZAF",239763
1,297.0,"Northern Europe",2075626,2056581,19045,1559760,2599600,"GBR",2079680
1,297.0,"Oceania",621061,606367,14694,466524,777540,"NZL",622032
1,297.0,"Central America",558903,0,558903,388438,647397,"MEX",517918
1,297.0,"Eastern Africa",464596,0,464596,338517,564196,"ETH",451357
1,297.0,"China",10790075,10050714,739361,7791810,12986351,"CPR",10389081
1,297.0,"Eastern Europe",2882817,2875556,7261,2156298,3593830,"POL",2875064
1,297.0,"India",6797732,6676769,120963,5172716,8621193,"IND",6896955
1,297.0,"Middle Africa",157015,0,157015,113941,189902,"AGO",151922
1,297.0,"Western Asia",651138,0,651138,472707,787846,"IRQ",630277
1,297.0,"United States of America",2965114,2768266,196848,2042478,3404130,"USA",2723304
1,297.0,"Western Europe",4000965,3727187,273778,3006224,5010373,"NLD",4008299
1,297.0,"Russian Federation",3266297,3232391,33906,2438927,4064878,"RUS",3251903
1,297.0,"Northern Africa",1755410,0,1755410,1229260,2048767,"EGY",1639014
1,297.0,"Eastern Asia",981126,0,981126,658962,1098271,"JPN",878617
1,297.0,"Western Africa",619301,0,619301,447191,745318,"NGA",596255
1,297.0,"Southern Europe",837590,0,837590,599652,999421,"ITA",799537
1,298.0,"Northern America",926336,879877,46459,696204,1160340,"CAN",928272
1,298.0,"Southern Asia",778592,0,778592,574011,956686,"IRN",765349
1,298.0,"South America",2312252,1742313,569939,1482404,2470673,"BRA",1976539
1,298.0,"Central Asia",1518304,1518304,0,1140768,1901280,"UZB",1521024
1,298.0,"South-Eastern Asia",1339601,0,1339601,990856,1651427,"IDN",1321142
1,298.0,"Pakistan",1928851,1811903,116948,1439473,2399122,"PAK",1919298
1,298.0,"Southern Africa",243446,0,243446,179822,299703,"ZAF",239763
1,298.0,"Northern Europe",2075625,2062801,12824,1559760,2599600,"GBR",2079680
1,298.0,"Oceania",621056,608214,12842,466524,777540,"NZL",622032
1,298.0,"Central America",531680,0,531680,388438,647397,"MEX",517918
1,298.0,"Eastern Africa",455493,0,455493,338517,564196,"ETH",451357
1,298.0,"China",10377128,9691459,685669,7791810,12986351,"CPR",10389081
1,298.0,"Eastern Europe",2867389,2867389,0,2156298,3593830,"POL",2875064
1,298.0,"India",6892757,6748204,144553,5172716,8621193,"IND",6896955
1,298.0,"Middle Africa",153517,0,153517,113941,189902,"AGO",151922
1,298.0,"Western Asia",636793,0,636793,472707,787846,"IRQ",630277
1,298.0,"United States of America",2965112,2770139,194973,2042478,3404130,"USA",2723304
1,298.0,"Western Europe",4000961,3738549,262412,3006224,5010373,"NLD",4008299
1,298.0,"Russian Federation",3243610,3220119,23491,2438927,4064878,"RUS",3251903
1,298.0,"Northern Africa",1675362,0,1675362,1229260,2048767,"EGY",1639014
1,298.0,"Eastern Asia",910628,0,910628,658962,1098271,"JPN",878617
1,298.0,"Western Africa",603454,0,603454,447191,745318,"NGA",596255
1,298.0,"Southern Europe",812126,0,812126,599652,999421,"ITA",799537
1,299.0,"Northern America",941929,898191,43738,696204,1160340,"CAN",928272
1,299.0,"Southern Asia",778835,0,778835,574017,956695,"IRN",765356
1,299.0,"South America",2286412,1742445,543967,1482404,2470673,"BRA",1976539
1,299.0,"Central Asia",1544531,1540286,4245,1140768,1901280,"UZB",1521024
1,299.0,"South-Eastern Asia",1339937,0,1339937,990861,1651436,"IDN",1321149
1,299.0,"Pakistan",1906008,1793258,112750,1439479,2399132,"PAK",1919306
1,299.0,"Southern Africa",243516,0,243516,179830,299717,"ZAF",239774
1,299.0,"Northern Europe",2108060,2101466,6594,1559763,2599605,"GBR",2079684
1,299.0,"Oceania",628848,617861,10987,466527,777545,"NZL",622036
1,299.0,"Central America",530402,0,530402,388446,647411,"MEX",517929
1,299.0,"Eastern Africa",455569,0,455569,338525,564208,"ETH",451367
1,299.0,"China",10576606,9887074,689532,7791816,12986361,"CPR",10389089
1,299.0,"Eastern Europe",2933337,2931399,1938,2156304,3593840,"POL",2875072
1,299.0,"India",6977793,6804364,173429,5172719,8621198,"IND",6896959
1,299.0,"Middle Africa",153543,0,153543,113948,189913,"AGO",151931
1,299.0,"Western Asia",636914,0,636914,472710,787851,"IRQ",630281
1,299.0,"United States of America",2886881,2701952,184929,2042478,3404130,"USA",2723304
1,299.0,"Western Europe",4059656,3808625,251031,3006224,5010373,"NLD",4008299
1,299.0,"Russian Federation",3314795,3298192,16603,2438930,4064883,"RUS",3251907
1,299.0,"Northern Africa",1676027,0,1676027,1229265,2048775,"EGY",1639020
1,299.0,"Eastern Asia",911214,0,911214,658965,1098275,"JPN",878620
1,299.0,"Western Africa",603587,0,603587,447192,745320,"NGA",596256
1,299.0,"Southern Europe",811116,0,811116,599654,999423,"ITA",799539
1,300.0,"Northern America",953641,913113,40528,815799,1359666,"CAN",1087733
1,300.0,"Southern Asia",779933,0,779933,556167,926945,"IRN",741556
1,300.0,"South America",2264670,1742458,522212,1768392,2947321,"BRA",2357857
1,300.0,"Central Asia",1563011,1557884,5127,1281025,2135042,"UZB",1708034
1,300.0,"South-Eastern Asia",1341467,0,1341467,1104151,1840252,"IDN",1472202
1,300.0,"Pakistan",1916383,1797434,118949,1593169,2655282,"PAK",2124226
1,300.0,"Southern Africa",243817,0,243817,110946,184910,"ZAF",147928
1,300.0,"Northern Europe",2132390,2132038,352,1693697,2822828,"GBR",2258263
1,300.0,"Oceania",634698,625653,9045,526623,877706,"NZL",702165
1,300.0,"Central America",530795,0,530795,418850,698083,"MEX",558467
1,300.0,"Eastern Africa",455911,0,455911,414669,691116,"ETH",552893
1,300.0,"China",10710733,10030099,680634,8760971,14601618,"CPR",11681295
1,300.0,"Eastern Europe",2990905,2983731,7174,2153070,3588450,"POL",2870760
1,300.0,"India",7051221,6850630,200591,5739038,9565063,"IND",7652051
1,300.0,"Middle Africa",153676,0,153676,131555,219258,"AGO",175407
1,300.0,"Western Asia",637452,0,637452,872015,1453358,"IRQ",1162687
1,300.0,"United States of America",2844211,2668208,176003,2319513,3865855,"USA",3092684
1,300.0,"Western Europe",4103679,3866630,237049,3219997,5366662,"NLD",4293330
1,300.0,"Russian Federation",3379802,3361839,17963,2766478,4610797,"RUS",3688638
1,300.0,"Northern Africa",1679042,0,1679042,2081997,3469995,"EGY",2775996
1,300.0,"Eastern Asia",913870,0,913870,737760,1229600,"JPN",983680
1,300.0,"Western Africa",604183,0,604183,517837,863062,"NGA",690450
1,300.0,"Southern Europe",812012,0,812012,257773,429622,"ITA",343698
1,301.0,"Northern America",955592,919057,36535,815799,1359666,"CAN",1087733
1,301.0,"Southern Asia",780528,0,780528,556167,926945,"IRN",741556
1,301.0,"South America",2734667,2229933,504734,1768392,2947321,"BRA",2357857
1,301.0,"Central Asia",1565896,1561244,4652,1281025,2135042,"UZB",1708034
1,301.0,"South-Eastern Asia",1342296,0,1342296,1104151,1840252,"IDN",1472202
1,301.0,"Pakistan",1931014,1800075,130939,1593169,2655282,"PAK",2124226
1,301.0,"Southern Africa",243992,0,243992,110946,184910,"ZAF",147928
1,301.0,"Northern Europe",2136448,2136448,0,1693697,2822828,"GBR",2258263
1,301.0,"Oceania",635676,628845,6831,526623,877706,"NZL",702165
1,301.0,"Central America",532085,0,532085,418850,698083,"MEX",558467
1,301.0,"Eastern Africa",456106,0,456106,414669,691116,"ETH",552893
1,301.0,"China",10734194,10074367,659827,8760971,14601618,"CPR",11681295
1,301.0,"Eastern Europe",3001834,2994874,6960,2153070,3588450,"POL",2870760
1,301.0,"India",7100090,6872094,227996,5739038,9565063,"IND",7652051
1,301.0,"Middle Africa",153757,0,153757,131555,219258,"AGO",175407
1,301.0,"Western Asia",637746,0,637746,872015,1453358,"IRQ",1162687
1,301.0,"United States of America",2844210,2677424,166786,2319513,3865855,"USA",3092684
1,301.0,"Western Europe",4111016,3890521,220495,3219997,5366662,"NLD",4293330
1,301.0,"Russian Federation",3400475,3374562,25913,2766478,4610797,"RUS",3688638
1,301.0,"Northern Africa",1680666,0,1680666,2081997,3469995,"EGY",2775996
1,301.0,"Eastern Asia",915297,0,915297,737760,1229600,"JPN",983680
1,301.0,"Western Africa",604505,0,604505,517837,863062,"NGA",690450
1,301.0,"Southern Europe",813078,0,813078,257773,429622,"ITA",343698
1,302.0,"Northern America",1081869,1045131,36738,815799,1359666,"CAN",1087733
1,302.0,"Southern Asia",712558,0,712558,556167,926945,"IRN",741556
1,302.0,"South America",2661911,2230670,431241,1768392,2947321,"BRA",2357857
1,302.0,"Central Asia",1696509,1695032,1477,1281025,2135042,"UZB",1708034
1,302.0,"South-Eastern Asia",1431768,0,1431768,1104151,1840252,"IDN",1472202
1,302.0,"Pakistan",1929005,1798003,131002,1593169,2655282,"PAK",2124226
1,302.0,"Southern Africa",139875,0,139875,110946,184910,"ZAF",147928
1,302.0,"Northern Europe",2246098,2246098,0,1693697,2822828,"GBR",2258263
1,302.0,"Oceania",630073,624952,5121,526623,877706,"NZL",702165
1,302.0,"Central America",537837,0,537837,418850,698083,"MEX",558467
1,302.0,"Eastern Africa",543837,0,543837,414669,691116,"ETH",552893
1,302.0,"China",11578759,10922372,656387,8760971,14601618,"CPR",11681295
1,302.0,"Eastern Europe",2853329,2853329,0,2153070,3588450,"POL",2870760
1,302.0,"India",7125323,6873973,251350,5739038,9565063,"IND",7652051
1,302.0,"Middle Africa",171910,0,171910,131555,219258,"AGO",175407
1,302.0,"Western Asia",1148417,0,1148417,872015,1453358,"IRQ",1162687
1,302.0,"United States of America",2751307,2580070,171237,2319513,3865855,"USA",3092684
1,302.0,"Western Europe",4271318,4056226,215092,3219997,5366662,"NLD",4293330
1,302.0,"Russian Federation",3650566,3629625,20941,2766478,4610797,"RUS",3688638
1,302.0,"Northern Africa",2696369,0,2696369,2081997,3469995,"EGY",2775996
1,302.0,"Eastern Asia",913551,0,913551,737760,1229600,"JPN",983680
1,302.0,"Western Africa",674682,0,674682,517837,863062,"NGA",690450
1,302.0,"Southern Europe",332485,0,332485,257773,429622,"ITA",343698
1,303.0,"Northern America",1064317,1030703,33614,815799,1359666,"CAN",1087733
1,303.0,"Southern Asia",720051,0,720051,556167,926945,"IRN",741556
1,303.0,"South America",2604075,2229377,374698,1768392,2947321,"BRA",2357857
1,303.0,"Central Asia",1674455,1674455,0,1281025,2135042,"UZB",1708034
1,303.0,"South-Eastern Asia",1442227,0,1442227,1104151,1840252,"IDN",1472202
1,303.0,"Pakistan",1930005,1791437,138568,1593169,2655282,"PAK",2124226
1,303.0,"Southern Africa",141949,0,141949,110946,184910,"ZAF",147928
1,303.0,"Northern Europe",2209608,2209608,0,1693697,2822828,"GBR",2258263
1,303.0,"Oceania",677805,669972,7833,526623,877706,"NZL",702165
1,303.0,"Central America",540050,0,540050,418850,698083,"MEX",558467
1,303.0,"Eastern Africa",546178,0,546178,414669,691116,"ETH",552893
1,303.0,"China",11395420,10789740,605680,8760971,14601618,"CPR",11681295
1,303.0,"Eastern Europe",2772530,2772530,0,2153070,3588450,"POL",2870760
1,303.0,"India",7166205,6886764,279441,5739038,9565063,"IND",7652051
1,303.0,"Middle Africa",172822,0,172822,131555,219258,"AGO",175407
1,303.0,"Western Asia",1152106,0,1152106,872015,1453358,"IRQ",1162687
1,303.0,"United States of America",2865097,2670629,194468,2319513,3865855,"USA",3092684
1,303.0,"Western Europe",4205287,4001955,203332,3219997,5366662,"NLD",4293330
1,303.0,"Russian Federation",3579934,3572551,7383,2766478,4610797,"RUS",3688638
1,303.0,"Northern Africa",2716964,0,2716964,2081997,3469995,"EGY",2775996
1,303.0,"Eastern Asia",931689,0,931689,737760,1229600,"JPN",983680
1,303.0,"Western Africa",678759,0,678759,517837,863062,"NGA",690450
1,303.0,"Southern Europe",326750,0,326750,257773,429622,"ITA",343698
1,304.0,"Northern America",1074071,1043216,30855,815799,1359666,"CAN",1087733
1,304.0,"Southern Asia",728804,0,728804,556167,926945,"IRN",741556
1,304.0,"South America",2563764,2229347,334417,1768392,2947321,"BRA",2357857
1,304.0,"Central Asia",1687576,1687576,0,1281025,2135042,"UZB",1708034
1,304.0,"South-Eastern Asia",1454427,0,1454427,1104151,1840252,"IDN",1472202
1,304.0,"Pakistan",1939962,1790277,149685,1593169,2655282,"PAK",2124226
1,304.0,"Southern Africa",144382,0,144382,110946,184910,"ZAF",147928
1,304.0,"Northern Europe",2229881,2229881,0,1693697,2822828,"GBR",2258263
1,304.0,"Oceania",698265,688067,10198,526623,877706,"NZL",702165
1,304.0,"Central America",546277,0,546277,418850,698083,"MEX",558467
1,304.0,"Eastern Africa",548910,0,548910,414669,691116,"ETH",552893
1,304.0,"China",11514574,10937857,576717,8760971,14601618,"CPR",11681295
1,304.0,"Eastern Europe",2808826,2808826,0,2153070,3588450,"POL",2870760
1,304.0,"India",8214377,7902074,312303,5739038,9565063,"IND",7652051
1,304.0,"Middle Africa",173870,0,173870,131555,219258,"AGO",175407
1,304.0,"Western Asia",1156411,0,1156411,872015,1453358,"IRQ",1162687
1,304.0,"United States of America",2936219,2722727,213492,2319513,3865855,"USA",3092684
1,304.0,"Western Europe",4241971,4048155,193816,3219997,5366662,"NLD",4293330
1,304.0,"Russian Federation",3621546,3621546,0,2766478,4610797,"RUS",3688638
1,304.0,"Northern Africa",2740994,0,2740994,2081997,3469995,"EGY",2775996
1,304.0,"Eastern Asia",952852,0,952852,737760,1229600,"JPN",983680
1,304.0,"Western Africa",683518,0,683518,517837,863062,"NGA",690450
1,304.0,"Southern Europe",332432,0,332432,257773,429622,"ITA",343698
1,305.0,"Northern America",1068217,1040363,27854,815799,1359666,"CAN",1087733
1,305.0,"Southern Asia",732513,0,732513,556167,926945,"IRN",741556
1,305.0,"South America",2535137,2231689,303448,1768392,2947321,"BRA",2357857
1,305.0,"Central Asia",1679700,1679700,0,1281025,2135042,"UZB",1708034
1,305.0,"South-Eastern Asia",1459598,0,1459598,1104151,1840252,"IDN",1472202
1,305.0,"Pakistan",1990406,1823872,166534,1593169,2655282,"PAK",2124226
1,305.0,"Southern Africa",145412,0,145412,110946,184910,"ZAF",147928
1,305.0,"Northern Europe",2217717,2217717,0,1693697,2822828,"GBR",2258263
1,305.0,"Oceania",708008,695655,12353,526623,877706,"NZL",702165
1,305.0,"Central America",548928,0,548928,418850,698083,"MEX",558467
1,305.0,"Eastern Africa",550066,0,550066,414669,691116,"ETH",552893
1,305.0,"China",11449709,10909495,540214,8760971,14601618,"CPR",11681295
1,305.0,"Eastern Europe",2786408,2786408,0,2153070,3588450,"POL",2870760
1,305.0,"India",8180535,7893657,286878,5739038,9565063,"IND",7652051
1,305.0,"Middle Africa",174318,0,174318,131555,219258,"AGO",175407
1,305.0,"Western Asia",1158237,0,1158237,872015,1453358,"IRQ",1162687
1,305.0,"United States of America",3007339,2777578,229761,2319513,3865855,"USA",3092684
1,305.0,"Western Europe",4219960,4037051,182909,3219997,5366662,"NLD",4293330
1,305.0,"Russian Federation",3598060,3598060,0,2766478,4610797,"RUS",3688638
1,305.0,"Northern Africa",2751179,0,2751179,2081997,3469995,"EGY",2775996
1,305.0,"Eastern Asia",961824,0,961824,737760,1229600,"JPN",983680
1,305.0,"Western Africa",685535,0,685535,517837,863062,"NGA",690450
1,305.0,"Southern Europe",334866,0,334866,257773,429622,"ITA",343698
1,306.0,"Northern America",1079926,1055003,24923,815799,1359666,"CAN",1087733
1,306.0,"Southern Asia",736968,0,736968,556167,926945,"IRN",741556
1,306.0,"South America",2504801,2229770,275031,1768392,2947321,"BRA",2357857
1,306.0,"Central Asia",1696047,1696047,0,1281025,2135042,"UZB",1708034
1,306.0,"South-Eastern Asia",1465810,0,1465810,1104151,1840252,"IDN",1472202
1,306.0,"Pakistan",2169850,1988414,181436,1593169,2655282,"PAK",2124226
1,306.0,"Southern Africa",146650,0,146650,110946,184910,"ZAF",147928
1,306.0,"Northern Europe",2242044,2242044,0,1693697,2822828,"GBR",2258263
1,306.0,"Oceania",700217,687939,12278,526623,877706,"NZL",702165
1,306.0,"Central America",554073,0,554073,418850,698083,"MEX",558467
1,306.0,"Eastern Africa",551457,0,551457,414669,691116,"ETH",552893
1,306.0,"China",11542018,11029929,512089,8760971,14601618,"CPR",11681295
1,306.0,"Eastern Europe",2833885,2833885,0,2153070,3588450,"POL",2870760
1,306.0,"India",8163330,7893604,269726,5739038,9565063,"IND",7652051
1,306.0,"Middle Africa",174853,0,174853,131555,219258,"AGO",175407
1,306.0,"Western Asia",1160429,0,1160429,872015,1453358,"IRQ",1162687
1,306.0,"United States of America",3050009,2807004,243005,2319513,3865855,"USA",3092684
1,306.0,"Western Europe",4263981,4091428,172553,3219997,5366662,"NLD",4293330
1,306.0,"Russian Federation",3648600,3648600,0,2766478,4610797,"RUS",3688638
1,306.0,"Northern Africa",2763413,0,2763413,2081997,3469995,"EGY",2775996
1,306.0,"Eastern Asia",972598,0,972598,737760,1229600,"JPN",983680
1,306.0,"Western Africa",687954,0,687954,517837,863062,"NGA",690450
1,306.0,"Southern Europe",339657,0,339657,257773,429622,"ITA",343698
1,307.0,"Northern America",1101390,1079615,21775,815799,1359666,"CAN",1087733
1,307.0,"Southern Asia",744185,0,744185,556167,926945,"IRN",741556
1,307.0,"South America",2488953,2231021,257932,1768392,2947321,"BRA",2357857
1,307.0,"Central Asia",1679974,1679974,0,1281025,2135042,"UZB",1708034
1,307.0,"South-Eastern Asia",1475871,0,1475871,1104151,1840252,"IDN",1472202
1,307.0,"Pakistan",2200237,2013628,186609,1593169,2655282,"PAK",2124226
1,307.0,"Southern Africa",148653,0,148653,110946,184910,"ZAF",147928
1,307.0,"Northern Europe",2286643,2286643,0,1693697,2822828,"GBR",2258263
1,307.0,"Oceania",699242,686939,12303,526623,877706,"NZL",702165
1,307.0,"Central America",561182,0,561182,418850,698083,"MEX",558467
1,307.0,"Eastern Africa",553713,0,553713,414669,691116,"ETH",552893
1,307.0,"China",11510935,11020361,490574,8760971,14601618,"CPR",11681295
1,307.0,"Eastern Europe",2925584,2925584,0,2153070,3588450,"POL",2870760
1,307.0,"India",8154107,7898008,256099,5739038,9565063,"IND",7652051
1,307.0,"Middle Africa",175721,0,175721,131555,219258,"AGO",175407
1,307.0,"Western Asia",1163977,0,1163977,872015,1453358,"IRQ",1162687
1,307.0,"United States of America",3085568,2831228,254340,2319513,3865855,"USA",3092684
1,307.0,"Western Europe",4344686,4183886,160800,3219997,5366662,"NLD",4293330
1,307.0,"Russian Federation",3746847,3746847,0,2766478,4610797,"RUS",3688638
1,307.0,"Northern Africa",2783225,0,2783225,2081997,3469995,"EGY",2775996
1,307.0,"Eastern Asia",990044,0,990044,737760,1229600,"JPN",983680
1,307.0,"Western Africa",691878,0,691878,517837,863062,"NGA",690450
1,307.0,"Southern Europe",346270,0,346270,257773,429622,"ITA",343698
1,308.0,"Northern America",1085784,1067443,18341,815799,1359666,"CAN",1087733
1,308.0,"Southern Asia",741085,0,741085,556167,926945,"IRN",741556
1,308.0,"South America",2462438,2227042,235396,1768392,2947321,"BRA",2357857
1,308.0,"Central Asia",1715427,1710240,5187,1281025,2135042,"UZB",1708034
1,308.0,"South-Eastern Asia",1471547,0,1471547,1104151,1840252,"IDN",1472202
1,308.0,"Pakistan",2204169,2017993,186176,1593169,2655282,"PAK",2124226
1,308.0,"Southern Africa",147805,0,147805,110946,184910,"ZAF",147928
1,308.0,"Northern Europe",1909576,1909576,0,1693697,2822828,"GBR",2258263
1,308.0,"Oceania",704111,689659,14452,526623,877706,"NZL",702165
1,308.0,"Central America",557876,0,557876,418850,698083,"MEX",558467
1,308.0,"Eastern Africa",552751,0,552751,414669,691116,"ETH",552893
1,308.0,"China",11502742,11039306,463436,8760971,14601618,"CPR",11681295
1,308.0,"Eastern Europe",2865536,2865536,0,2153070,3588450,"POL",2870760
1,308.0,"India",7973716,7750325,223391,5739038,9565063,"IND",7652051
1,308.0,"Middle Africa",175353,0,175353,131555,219258,"AGO",175407
1,308.0,"Western Asia",1162459,0,1162459,872015,1453358,"IRQ",1162687
1,308.0,"United States of America",3121129,2857157,263972,2319513,3865855,"USA",3092684
1,308.0,"Western Europe",4285995,4139097,146898,3219997,5366662,"NLD",4293330
1,308.0,"Russian Federation",3683457,3683457,0,2766478,4610797,"RUS",3688638
1,308.0,"Northern Africa",2774697,0,2774697,2081997,3469995,"EGY",2775996
1,308.0,"Eastern Asia",983522,0,983522,737760,1229600,"JPN",983680
1,308.0,"Western Africa",690194,0,690194,517837,863062,"NGA",690450
1,308.0,"Southern Europe",343126,0,343126,257773,429622,"ITA",343698
1,309.0,"Northern America",1085781,1070683,15098,815799,1359666,"CAN",1087733
1,309.0,"Southern Asia",708771,0,708771,556167,926945,"IRN",741556
1,309.0,"South America",2323085,2140914,182171,1768392,2947321,"BRA",2357857
1,309.0,"Central Asia",1719344,1711430,7914,1281025,2135042,"UZB",1708034
1,309.0,"South-Eastern Asia",1426494,0,1426494,1104151,1840252,"IDN",1472202
1,309.0,"Pakistan",2188531,2018979,169552,1593169,2655282,"PAK",2124226
1,309.0,"Southern Africa",138813,0,138813,110946,184910,"ZAF",147928
1,309.0,"Northern Europe",1962280,1954726,7554,1693697,2822828,"GBR",2258263
1,309.0,"Oceania",703753,688717,15036,526623,877706,"NZL",702165
1,309.0,"Central America",538243,0,538243,418850,698083,"MEX",558467
1,309.0,"Eastern Africa",542655,0,542655,414669,691116,"ETH",552893
1,309.0,"China",11304656,10858226,446430,8760971,14601618,"CPR",11681295
1,309.0,"Eastern Europe",2862375,2862375,0,2153070,3588450,"POL",2870760
1,309.0,"India",7643996,7449754,194242,5739038,9565063,"IND",7652051
1,309.0,"Middle Africa",171471,0,171471,131555,219258,"AGO",175407
1,309.0,"Western Asia",1146556,0,1146556,872015,1453358,"IRQ",1162687
1,309.0,"United States of America",3455397,3192846,262551,2319513,3865855,"USA",3092684
1,309.0,"Western Europe",2730577,2596386,134191,3219997,5366662,"NLD",4293330
1,309.0,"Russian Federation",3679671,3679671,0,2766478,4610797,"RUS",3688638
1,309.0,"Northern Africa",2685992,0,2685992,2081997,3469995,"EGY",2775996
1,309.0,"Eastern Asia",921141,0,921141,737760,1229600,"JPN",983680
1,309.0,"Western Africa",672630,0,672630,517837,863062,"NGA",690450
1,309.0,"Southern Europe",314336,0,314336,257773,429622,"ITA",343698
1,310.0,"Northern America",1072122,1060272,11850,815799,1359666,"CAN",1087733
1,310.0,"Southern Asia",703729,0,703729,556167,926945,"IRN",741556
1,310.0,"South America",2298876,2151889,146987,1768392,2947321,"BRA",2357857
1,310.0,"Central Asia",1708401,1705624,2777,1281025,2135042,"UZB",1708034
1,310.0,"South-Eastern Asia",1438627,0,1438627,1104151,1840252,"IDN",1472202
1,310.0,"Pakistan",2191386,2018299,173087,1593169,2655282,"PAK",2124226
1,310.0,"Southern Africa",137413,0,137413,110946,184910,"ZAF",147928
1,310.0,"Northern Europe",1978499,1970283,8216,1693697,2822828,"GBR",2258263
1,310.0,"Oceania",682685,667672,15013,526623,877706,"NZL",702165
1,310.0,"Central America",560155,0,560155,418850,698083,"MEX",558467
1,310.0,"Eastern Africa",541087,0,541087,414669,691116,"ETH",552893
1,310.0,"China",11384524,10893972,490552,8760971,14601618,"CPR",11681295
1,310.0,"Eastern Europe",2805444,2805444,0,2153070,3588450,"POL",2870760
1,310.0,"India",7559656,7383510,176146,5739038,9565063,"IND",7652051
1,310.0,"Middle Africa",170863,0,170863,131555,219258,"AGO",175407
1,310.0,"Western Asia",1144079,0,1144079,872015,1453358,"IRQ",1162687
1,310.0,"United States of America",3227815,2983408,244407,2319513,3865855,"USA",3092684
1,310.0,"Western Europe",3082746,2895266,187480,3219997,5366662,"NLD",4293330
1,310.0,"Russian Federation",3618845,3618845,0,2766478,4610797,"RUS",3688638
1,310.0,"Northern Africa",2672160,0,2672160,2081997,3469995,"EGY",2775996
1,310.0,"Eastern Asia",983490,0,983490,737760,1229600,"JPN",983680
1,310.0,"Western Africa",670095,0,670095,517837,863062,"NGA",690450
1,310.0,"Southern Europe",311409,0,311409,257773,429622,"ITA",343698
1,311.0,"Northern America",1103341,1094663,8678,815799,1359666,"CAN",1087733
1,311.0,"Southern Asia",708373,0,708373,556167,926945,"IRN",741556
1,311.0,"South America",2370404,2222984,147420,1768392,2947321,"BRA",2357857
1,311.0,"Central Asia",1730183,1730183,0,1281025,2135042,"UZB",1708034
1,311.0,"South-Eastern Asia",1470749,0,1470749,1104151,1840252,"IDN",1472202
1,311.0,"Pakistan",2185544,2011608,173936,1593169,2655282,"PAK",2124226
1,311.0,"Southern Africa",138806,0,138806,110946,184910,"ZAF",147928
1,311.0,"Northern Europe",2002826,1987606,15220,1693697,2822828,"GBR",2258263
1,311.0,"Oceania",680742,665425,15317,526623,877706,"NZL",702165
1,311.0,"Central America",560976,0,560976,418850,698083,"MEX",558467
1,311.0,"Eastern Africa",542562,0,542562,414669,691116,"ETH",552893
1,311.0,"China",11435070,10896243,538827,8760971,14601618,"CPR",11681295
1,311.0,"Eastern Europe",2932197,2932197,0,2153070,3588450,"POL",2870760
1,311.0,"India",7749677,7593348,156329,5739038,9565063,"IND",7652051
1,311.0,"Middle Africa",171431,0,171431,131555,219258,"AGO",175407
1,311.0,"Western Asia",1146406,0,1146406,872015,1453358,"IRQ",1162687
1,311.0,"United States of America",3128246,2893113,235133,2319513,3865855,"USA",3092684
1,311.0,"Western Europe",3295516,3061703,233813,3219997,5366662,"NLD",4293330
1,311.0,"Russian Federation",3753727,3753727,0,2766478,4610797,"RUS",3688638
1,311.0,"Northern Africa",2685150,0,2685150,2081997,3469995,"EGY",2775996
1,311.0,"Eastern Asia",986963,0,986963,737760,1229600,"JPN",983680
1,311.0,"Western Africa",673365,0,673365,517837,863062,"NGA",690450
1,311.0,"Southern Europe",315777,0,315777,257773,429622,"ITA",343698
1,312.0,"Northern America",1058466,1053108,5358,815799,1359666,"CAN",1087733
1,312.0,"Southern Asia",709368,0,709368,556167,926945,"IRN",741556
1,312.0,"South America",2317840,2183326,134514,1768392,2947321,"BRA",2357857
1,312.0,"Central Asia",1667245,1667245,0,1281025,2135042,"UZB",1708034
1,312.0,"South-Eastern Asia",1465305,0,1465305,1104151,1840252,"IDN",1472202
1,312.0,"Pakistan",2174453,2007412,167041,1593169,2655282,"PAK",2124226
1,312.0,"Southern Africa",138961,0,138961,110946,184910,"ZAF",147928
1,312.0,"Northern Europe",2031207,2007791,23416,1693697,2822828,"GBR",2258263
1,312.0,"Oceania",691460,673655,17805,526623,877706,"NZL",702165
1,312.0,"Central America",554160,0,554160,418850,698083,"MEX",558467
1,312.0,"Eastern Africa",542570,0,542570,414669,691116,"ETH",552893
1,312.0,"China",11515928,10938280,577648,8760971,14601618,"CPR",11681295
1,312.0,"Eastern Europe",2752354,2752354,0,2153070,3588450,"POL",2870760
1,312.0,"India",7471321,7339224,132097,5739038,9565063,"IND",7652051
1,312.0,"Middle Africa",171434,0,171434,131555,219258,"AGO",175407
1,312.0,"Western Asia",1146558,0,1146558,872015,1453358,"IRQ",1162687
1,312.0,"United States of America",3085575,2853936,231639,2319513,3865855,"USA",3092684
1,312.0,"Western Europe",3478938,3203153,275785,3219997,5366662,"NLD",4293330
1,312.0,"Russian Federation",3562668,3562668,0,2766478,4610797,"RUS",3688638
1,312.0,"Northern Africa",2685214,0,2685214,2081997,3469995,"EGY",2775996
1,312.0,"Eastern Asia",972474,0,972474,737760,1229600,"JPN",983680
1,312.0,"Western Africa",672794,0,672794,517837,863062,"NGA",690450
1,312.0,"Southern Europe",314802,0,314802,257773,429622,"ITA",343698
1,313.0,"Northern America",1083828,1081692,2136,815799,1359666,"CAN",1087733
1,313.0,"Southern Asia",703399,0,703399,556167,926945,"IRN",741556
1,313.0,"South America",1697345,1569934,127411,1768392,2947321,"BRA",2357857
1,313.0,"Central Asia",1701177,1701177,0,1281025,2135042,"UZB",1708034
1,313.0,"South-Eastern Asia",1449979,0,1449979,1104151,1840252,"IDN",1472202
1,313.0,"Pakistan",2170373,2004721,165652,1593169,2655282,"PAK",2124226
1,313.0,"Southern Africa",141165,0,141165,110946,184910,"ZAF",147928
1,313.0,"Northern Europe",2051481,2019661,31820,1693697,2822828,"GBR",2258263
1,313.0,"Oceania",593068,572944,20124,526623,877706,"NZL",702165
1,313.0,"Central America",553731,0,553731,418850,698083,"MEX",558467
1,313.0,"Eastern Africa",540734,0,540734,414669,691116,"ETH",552893
1,313.0,"China",11566507,10948131,618376,8760971,14601618,"CPR",11681295
1,313.0,"Eastern Europe",2848311,2848311,0,2153070,3588450,"POL",2870760
1,313.0,"India",7625623,7514528,111095,5739038,9565063,"IND",7652051
1,313.0,"Middle Africa",170656,0,170656,131555,219258,"AGO",175407
1,313.0,"Western Asia",1144004,0,1144004,872015,1453358,"IRQ",1162687
1,313.0,"United States of America",3042898,2816662,226236,2319513,3865855,"USA",3092684
1,313.0,"Western Europe",3618337,3304819,313518,3219997,5366662,"NLD",4293330
1,313.0,"Russian Federation",3663801,3663801,0,2766478,4610797,"RUS",3688638
1,313.0,"Northern Africa",2673260,0,2673260,2081997,3469995,"EGY",2775996
1,313.0,"Eastern Asia",944640,0,944640,737760,1229600,"JPN",983680
1,313.0,"Western Africa",675554,0,675554,517837,863062,"NGA",690450
1,313.0,"Southern Europe",319337,0,319337,257773,429622,"ITA",343698
